*	template	example	explanation
indicative	\bubble{\scene}\n2{ğŸ§‘\g2\c2}\rspeech\n1{ğŸ§‘\g1\c1}		
subjunctive	\bubble{\box{\scene}â†’â€¦}\n2{ğŸ§‘\g2\c2}\rthought\n1{ğŸ¤·\c1\g1}	[even if]	Event is considered unlikely (mainly used in dependent clauses)
conditional	\bubble{â€¦â†’\box{\scene}}\n2{ğŸ§‘\g2\c2}\rthought\n1{ğŸ¤·\c1\g1}	[if so, then]	Event depends upon another condition.
optative	\bubble{\scene}\n2{ğŸ§‘\g2\c2}\rspeech\n1{\raised{ğŸ¤\c1}ğŸ§‘\g1\c1}	[may it be]	Event is hoped, expected, or awaited.
benedictive	\bubble{\scene}\n2{ğŸ§‘\g2\c2}\rspeech\n1{\lowered{ğŸ™\c1}ğŸ§‘\g1\c1}	[may it be]	Event is blessed by the speaker
jussive	\bubble{\scene}\n2{ğŸ§‘\g2\c2}\rspeech\n1{ğŸ™‡\c1\g1}	[it should be]	Event is pleaded, implored or asked.
potential	\bubble{\scene}\n2{ğŸ§‘\g2\c2}\rthought\n1{ğŸ§‘\g1\c1}	[it's likely]	Event is probable or considered likely.
imperative	\bubble{\scene}\n2{ğŸ§‘\g2\c2}\rspeech\n1{ğŸ¤´\g1\c1}	[I command that]	Event is directly ordered or requested by the speaker.
prohibitive	\forbidden{\scene}\n2{ğŸ§‘\g2\c2}\rspeech\n1{ğŸ¤´\g1\c1}	[I forbid that]	Event is directly prohibited by the speaker.
desiderative	\bubble{\nx{\raised{ğŸ¤\cx}ğŸ§‘\gx\cx}:\box{\scene}}\n2{ğŸ§‘\g2\c2}\rspeech\n1{ğŸ§‘\g1\c1}		Event is desired/wished by the subject
dubitative	\bubble{\scene}\n2{ğŸ§‘\g2\c2}\rspeech\n1{ğŸ¤·\c1\g1}	[maybe]	Event is uncertain, doubtful, dubious.
hypothetical	\bubble{âˆƒ\box{\scene}}\n2{ğŸ§‘\g2\c2}\rspeech\n1{ğŸ¤·\c1\g1}	[it's at least possible]	Event is hypothetical, or it is counterfactual, but possible.
presumptive	\bubble{âŠ¦\box{\scene}}\n2{ğŸ§‘\g2\c2}\rspeech\n1{ğŸ¤·\c1\g1}	[suppose that]	Event is assumed, presupposed by the speaker.
permissive	\bubble{\scene}\n2{ğŸ§‘\g2\c2}\rspeech\n1{\chestlevel{\mirror{ğŸ‘\c1}}ğŸ§‘\g1\c1}	[I'm fine that]	Event is permitted by the speaker.
admirative	\bubble{\scene!}\n2{ğŸ§‘\g2\c2}\rspeech\n1{ğŸ§‘\g1\c1}	[wow!]	Event is genuinely surprising or amazing
ironic-admirative	\bubble{\scene!}\n2{ğŸ§‘\g2\c2}\rspeech\n1{ğŸ™\c1\g1}	[gee!]	Event is surprising or amazing, in irony or sarcasm
hortative	\bubble{\scene!}\n2{ğŸ§‘\g2\c2}\rspeech\n1{\raised{âœŠ\c1}ğŸ§‘\g1\c1}	[may it be]	Event is exhorted, implored, insisted or encouraged by speaker.
eventitive	\bubble{â€¦â†’\box{\scene}}\n2{ğŸ§‘\g2\c2}\rspeech\n1{ğŸ§‘\g1\c1}	[if so, it's likely]	Event is likely but depends upon a condition. 
precative	\bubble{\scene?}\n2{ğŸ§‘\g2\c2}\rspeech\n1{\lowered{\flip{ğŸ¤²\c1}}ğŸ§‘\g1\c1}	[please, can it be that]	Event is requested by the speaker.
volitive	\bubble{\scene}\n2{ğŸ§‘\g2\c2}\rspeech\n1{\raised{ğŸ¤\c1}ğŸ™\c1\g1}	[if only]	Event is desired, wished or feared by the speaker.
involutive	\forbidden{\scene}\n2{ğŸ§‘\g2\c2}\rspeech\n1{\raised{ğŸ¤\c1}ğŸ™\c1\g1}	[heaven forbid]	Event is feared by the speaker.
inferential	\bubble{\scene}\lspeech\n2{ğŸ§‘\g2\c2}\n1{ğŸ’\c1\g1}	[it is said that]	Event is nonwitnessed, and not confirmed.
necessitative	\bubble{\scene!}\n2{ğŸ§‘\g2\c2}\rspeech\n1{ğŸ™‡\c1\g1}	[it is imperative that]	Event is necessary, or it is both desired and encouraged. 
interrogative	\bubble{\scene?}\n2{ğŸ§‘\g2\c2}\rspeech\n1{ğŸ¤·\c1\g1}	[is it true that]	Event is asked or questioned by the speaker 
injunctive	\bubble{\scene}\n2{ğŸ§‘\g2\c2}\rspeech\n1{ğŸ§‘\g1\c1\âš–ï¸}	[I intend]	Event is intended by the speaker
suggestive	\bubble{\scene}\n2{ğŸ§‘\g2\c2}\rspeech\n1{\raised{â˜\c1}ğŸ§‘\g1\c1}	[I suggest]	Event is proposed by the speaker
comissive	\bubble{\scene}\n2{ğŸ§‘\g2\c2}\rspeech\n1{\raised{âœ‹\c1}ğŸ§‘\g1\c1}	[I vow]	Event is committed to by the speaker, such as by promise or threat
deliberative	\bubble{\scene?}\n2{ğŸ§‘\g2\c2}\rspeech\n1{ğŸ’\c1\g1}	[shall it be]	Event is considered by the speaker, asking for confirmation
propositive	\bubble{\scene?}\n2{ğŸ§‘\g2\c2}\rspeech\n1{ğŸ¤·\c1\g1}	[should it be]	Event is proposed by the speaker, asking for consideration
dynamic	\bubble{\nx{\chestlevel{ğŸ’ª\cx}ğŸ§‘\gx\cx}:\box{\scene}}\n2{ğŸ§‘\g2\c2}\rspeech\n1{ğŸ§‘\g1\c1}		Event is able to be done by the subject
