die	pronoun	der
bot	verb	bieten
new	adjective	neu
beige	verb	beigen
bat	verb	bitten
bring	verb	bringen
bog	verb	biegen
belief	verb	belaufen
worden	verb	werden
band	verb	binden
lies	verb	lesen
fast	verb	fasen
las	verb	lesen
ne	interjection	nee
der	pronoun	der
das	pronoun	der
das	conjunction	dass
strafe	verb	strafen
respective	adverb	respektive
dis	pronoun	dies
westen	noun	Weste
westen	noun	West
sein	pronoun	er
sein	pronoun	es
seine	pronoun	seiner
seine	determiner	sein
ihr	pronoun	sie
wieg	verb	wiegen
meine	pronoun	meiner
meine	determiner	mein
meine	verb	meinen
lüfte	noun	Luft
paare	noun	Paar
sachen	noun	Sache
wen	pronoun	wer
aschen	noun	Asche
augen	noun	Auge
berge	noun	Berg
berges	noun	Berg
zuviel	adverb	zu viel
darf	verb	dürfen
decke	verb	decken
dein	pronoun	du
dein	determiner	dein
dem	pronoun	der
rappen	noun	Rappe
reben	noun	Rebe
grub	verb	graben
polen	noun	Pole
gel	adjective	gehl
esse	verb	essen
den	pronoun	der
kam	verb	kommen
belog	verb	belügen
engels	noun	Engel
japans	noun	Japan
dir	pronoun	du
ward	verb	werden
keulen	noun	Keule
alpes	noun	Alp
reifen	noun	Reif
sorg	verb	sorgen
inn	preposition	in
eis	noun	Ei
jeden	pronoun	jeder
such	verb	suchen
alps	noun	Alp
h-dur	noun	H-Dur
afrikaners	noun	Afrikaner
bey	preposition	bei
chic	adjective	schick
mir	pronoun	ich
gang	verb	gehen
lack	verb	lacken
lest	verb	lesen
liege	verb	liegen
dich	pronoun	du
100	numeral	hundert
bayern	noun	Bayer
sinti	noun	Sinto
alle	pronoun	all
alle	determiner	all
dero	pronoun	der
miss	verb	messen
hinge	verb	hängen
eukaryota	noun	Eukaryot
läuft	verb	laufen
isst	verb	essen
junge	noun	Junges
wessen	pronoun	wer
wem	pronoun	wer
mäuse	noun	Maus
meere	noun	Meer
menschen	noun	Mensch
dieses	pronoun	dieser
jene	pronoun	jener
eins	pronoun	einer
schlangen	noun	Schlange
farben	noun	Farbe
füße	noun	Fuß
bären	noun	Bär
köpfe	noun	Kopf
oasen	noun	Oase
nasen	noun	Nase
probleme	noun	Problem
psalms	noun	Psalm
mich	pronoun	ich
prang	verb	prangen
romans	noun	Roman
sone	pronoun	son
transcendental	adjective	transzendental
kan	verb	kann
erdnuß	noun	Erdnuss
saxofone	noun	Saxofon
ginge	verb	gehen
aase	noun	Aas
aasen	noun	Aas
ablative	noun	Ablativ
acne	noun	Akne
administrators	noun	Administrator
albums	noun	Album
alter	noun	Alte
apartments	noun	Apartment
arbeiten	noun	Arbeit
archive	noun	Archiv
archives	noun	Archiv
arguments	noun	Argument
arme	noun	Armer
arme	noun	Arm
attribute	noun	Attribut
backen	noun	Backe
bande	noun	Band
banjos	noun	Banjo
baritone	noun	Bariton
bars	noun	Bar
bastarde	noun	Bastard
benzine	noun	Benzin
billet	noun	Billett
boots	noun	Boot
borne	noun	Born
cellulose	noun	Zellulose
centimeter	noun	Zentimeter
chips	noun	Chip
codes	noun	Code
collagen	noun	Kollagen
collagen	noun	Collage
dative	noun	Dativ
decke	noun	Deck
details	noun	Detail
deutsche	noun	Deutscher
deutsche	noun	Deutsch
deutscher	noun	Deutsche
disaster	noun	Desaster
dispute	noun	Disput
disputes	noun	Disput
dragée	noun	Dragee
eggen	noun	Egge
egos	noun	Ego
ellen	noun	Elle
email	noun	E-Mail
essen	noun	Esse
exile	noun	Exil
experiments	noun	Experiment
exposé	noun	Exposee
fallen	noun	Falle
falls	noun	Fall
fans	noun	Fan
films	noun	Film
flore	noun	Flor
futons	noun	Futon
garden	noun	Garde
gene	noun	Gen
genitive	noun	Genitiv
ghetto	noun	Getto
glauben	noun	Glaube
gluten	noun	Glut
grade	noun	Grad
granite	noun	Granit
grate	noun	Grat
gross	noun	Gros
groß	noun	Gros
guts	noun	Gut
hackers	noun	Hacker
hertz	noun	Herz
homosexuelle	noun	Homosexueller
ideale	noun	Ideal
importe	noun	Import
incubus	noun	Inkubus
institute	noun	Institut
instruments	noun	Instrument
jak	noun	Yak
jobs	noun	Job
jungen	noun	Junge
kinder	noun	Kind
klub	noun	Club
knackers	noun	Knacker
kraken	noun	Krake
lactose	noun	Laktose
lemmata	noun	Lemma
limos	noun	Limo
listen	noun	Liste
lose	noun	Los
machos	noun	Macho
macron	noun	Makron
magazine	noun	Magazin
male	noun	Mal
mandate	noun	Mandat
massive	noun	Massiv
masters	noun	Master
matrices	noun	Matrix
mieten	noun	Miete
ministers	noun	Minister
misses	noun	Miss
mitochondrion	noun	Mitochondrium
mitten	noun	Mitte
models	noun	Model
monde	noun	Mond
montage	noun	Montag
moose	noun	Moos
mop	noun	Mopp
morpheme	noun	Morphem
motive	noun	Motiv
mute	noun	Mut
namen	noun	Name
nerven	noun	Nerv
nirvana	noun	Nirwana
nominative	noun	Nominativ
nymphen	noun	Nymphe
opiate	noun	Opiat
opiates	noun	Opiat
paragraf	noun	Paragraph
parks	noun	Park
passes	noun	Pass
patente	noun	Patent
pflanzen	noun	Pflanze
pharaoh	noun	Pharao
photo	noun	Foto
pique	noun	Pik
plans	noun	Plan
pole	noun	Pol
portrait	noun	Porträt
portraits	noun	Portrait
pos	noun	Po
postulate	noun	Postulat
potential	noun	Potenzial
problems	noun	Problem
profile	noun	Profil
programme	noun	Programm
quartiere	noun	Quartier
raison	noun	Räson
range	noun	Rang
ranges	noun	Rang
rechts	noun	Recht
reden	noun	Rede
reis	noun	Real
rotten	noun	Rotte
samen	noun	Same
sande	noun	Sand
sarge	noun	Sarg
saxophone	noun	Saxophon
seen	noun	See
sees	noun	See
seismograph	noun	Seismograf
senate	noun	Senat
siege	noun	Sieg
smaragde	noun	Smaragd
spalte	noun	Spalt
standards	noun	Standard
stands	noun	Stand
stare	noun	Star
stars	noun	Star
stile	noun	Stil
strafen	noun	Strafe
studios	noun	Studio
substantive	noun	Substantiv
sulfide	noun	Sulfid
superlative	noun	Superlativ
synonyme	noun	Synonym
synonyms	noun	Synonym
systems	noun	System
tafeln	noun	Tafel
tales	noun	Tal
tests	noun	Test
throne	noun	Thron
tone	noun	Ton
tore	noun	Tor
tornados	noun	Tornado
trainers	noun	Trainer
trampoline	noun	Trampolin
trapeze	noun	Trapez
uds	noun	Ud
ufo	noun	UFO
vampire	noun	Vampir
vasen	noun	Vase
venen	noun	Vene
verse	noun	Vers
vespers	noun	Vesper
visa	noun	Visum
wage	noun	Waage
wagon	noun	Waggon
wale	noun	Wal
wägen	noun	Wagen
yacht	noun	Jacht
zahlen	noun	Zahl
piers	noun	Pier
abarten	noun	Abart
äpfel	noun	Apfel
arten	noun	Art
hebe	verb	heben
mach	verb	machen
aas	noun	Aa
mafiosi	noun	Mafioso
deklinationen	noun	Deklination
klassen	noun	Klasse
moore	noun	Moor
graf	noun	Graph
packet	verb	packen
banken	noun	Bank
bänke	noun	Bank
daten	noun	Datum
wecken	noun	Wecke
wecken	noun	Weck
eine	numeral	ein
eine	pronoun	einer
einer	numeral	ein
einer	pronoun	einer
lichter	noun	Licht
lichte	noun	Licht
vögel	noun	Vogel
vögeln	noun	Vogel
hüte	noun	Hut
hutes	noun	Hut
hütten	noun	Hütte
herde	noun	Herd
falle	noun	Fall
töpfen	noun	Topf
pronomen	noun	Pronom
blätter	noun	Blatt
uns	pronoun	wir
läuse	noun	Laus
blitze	noun	Blitz
kommt	verb	kommen
schale	noun	Schal
stahl	verb	stehlen
lappen	noun	Lappe
muskatnuß	noun	Muskatnuss
mein	pronoun	ich
idioten	noun	Idiot
taube	noun	Tauber
säle	noun	Saal
kasten	noun	Kaste
ungarn	noun	Ungar
ihrer	pronoun	sie
ihrer	determiner	ihr
darren	noun	Darre
kost	verb	kosen
emirate	noun	Emirat
lese	verb	lesen
halden	noun	Halde
germans	noun	German
eide	noun	Eid
kare	noun	Kar
blicke	noun	Blick
leere	noun	Lehre
steigen	noun	Steig
trug	verb	tragen
bäume	noun	Baum
achter	numeral	achte
maffia	noun	Mafia
butte	noun	Butt
jasmine	noun	Jasmin
kosten	verb	kosen
diese	pronoun	dieser
maas	noun	Maß
seiner	pronoun	er
seiner	pronoun	es
seiner	determiner	sein
eines	numeral	ein
eines	pronoun	einer
marinen	noun	Marine
kuß	noun	Kuss
liebe	verb	lieben
höhen	noun	Höhe
götter	noun	Gott
wes	pronoun	wer
laut	verb	lauten
kos	verb	kosen
achten	numeral	achte
tons	noun	Ton
reise	noun	Reis
holmes	noun	Holm
pfeffernüsse	noun	Pfeffernuss
gottes	noun	Gott
ihn	pronoun	er
octans	noun	Octan
hunts	noun	Hunt
allen	pronoun	alles
ursprachen	noun	Ursprache
hing	verb	hängen
polonaise	noun	Polonäse
haß	noun	Hass
faß	noun	Fass
guß	noun	Guss
biß	noun	Biss
trew	adjective	treu
handels	noun	Handel
manche	pronoun	manch
buche	noun	Buch
genuß	noun	Genuss
cowboys	noun	Cowboy
terrors	noun	Terror
saus	verb	sausen
lieder	noun	Lied
zeitgeists	noun	Zeitgeist
nazis	noun	Nazi
schiß	noun	Schiss
hammers	noun	Hammer
ihre	determiner	ihr
radien	noun	Radius
herren	noun	Herr
fram	verb	framen
becken	noun	Beck
häuser	noun	Haus
hauses	noun	Haus
abfluß	noun	Abfluss
abflußleitung	noun	Abflussleitung
ablaß	noun	Ablass
roß	noun	Ross
riß	noun	Riss
ganges	noun	Gang
katzen	noun	Katze
denkt	verb	denken
schütze	noun	Schütz
alte	noun	Alter
fächer	noun	Fach
feige	noun	Feiger
fön	noun	Föhn
haselnuß	noun	Haselnuss
fische	noun	Fisch
knicks	noun	Knick
krem	noun	Creme
laken	noun	Lake
lumpen	noun	Lump
meinen	determiner	mein
schuppen	noun	Schuppe
stengel	noun	Stängel
sprosse	noun	Spross
rauh	adjective	rau
seines	pronoun	seiner
seines	determiner	sein
euer	pronoun	ihr
seinen	determiner	sein
stunden	noun	Stunde
nahe	adjective	nah
trügen	verb	tragen
ersten	numeral	erste
ihrem	determiner	ihr
beiden	determiner	beide
beiden	pronoun	beide
ihren	determiner	ihr
jahren	noun	Jahr
millionen	noun	Million
damen	noun	Dame
brennschlüsse	noun	Brennschluß
protestants	noun	Protestant
getroffen	verb	treffen
jets	noun	Jet
juden	noun	Jude
gier	verb	gieren
moors	noun	Moor
delphine	noun	Delphin
deismen	noun	Deismus
pandeismen	noun	Pandeismus
mißbrauch	noun	Missbrauch
mußten	verb	mussten
krauts	noun	Kraut
hamburgers	noun	Hamburger
titans	noun	Titan
manches	pronoun	manch
russes	noun	Russ
radfahren	verb	Rad fahren
verloren	verb	verlieren
deisten	noun	Deist
pandeisten	noun	Pandeist
schlepp	verb	schleppen
euros	noun	Euro
augusts	noun	August
dodos	noun	Dodo
psalmen	noun	Psalm
deine	pronoun	deiner
deine	determiner	dein
brachte	verb	bringen
östrogene	noun	Östrogen
breche	verb	brechen
zog	verb	ziehen
ihnen	pronoun	sie
ihnen	pronoun	Sie
ihrer	pronoun	Sie
ihrer	pronoun	Ihr
elfen	noun	Elfe
zeuge	noun	Zeug
tablette	noun	Tablett
außerirdische	noun	Außerirdischer
jogurt	noun	Joghurt
abkommen	noun	Abkomme
asse	noun	As
stelle	verb	stellen
fase	verb	fasen
leds	noun	LED
reims	noun	Reim
pan-theisten	noun	Pan-theist
pan-theisten	noun	Pantheisten
pan-deisten	noun	Pandeisten
säkulär	adjective	säkular
bette	noun	Bett
jaden	noun	Jade
zeitgeister	noun	Zeitgeist
liechtensteiners	noun	Liechtensteiner
hessen	noun	Hesse
sachsen	noun	Sachse
beamers	noun	Beamer
seitenwinderklapperschlange	noun	Seitenwinder-Klapperschlange
spie	verb	speien
poltergeister	noun	Poltergeist
imbiß	noun	Imbiss
leinen	noun	Leine
leinen	noun	Lein
bestanden	verb	bestehen
eszett	letter	Eszett
untermenschen	noun	Untermensch
platten	noun	Platte
ungläubige	noun	Ungläubiger
planen	noun	Plane
klan	noun	Clan
protuberanzen	noun	Protuberanz
zugrunderichten	verb	zugrunde richten
biographie	noun	Biografie
schrecken	noun	Schrecke
beamte	noun	Beamter
arms	noun	Arm
kränze	noun	Kranz
spitzen	noun	Spitze
ahlen	noun	Ahle
ketten	noun	Kette
laurits	noun	Laurit
unparteiische	noun	Unparteiischer
unparteiischer	noun	Unparteiische
abszeß	noun	Abszess
christen	noun	Christ
dummejungenstreich	noun	Dumme-Jungen-Streich
pumas	noun	Puma
kreme	noun	Creme
tropen	noun	Tropus
tropen	noun	Trope
kosmetika	noun	Kosmetikum
cds	noun	CD
brownies	noun	Brownie
ufos	noun	UFO
hummers	noun	Hummer
sekte	noun	Sekt
thore	noun	Thor
rollladen	noun	Rolllade
scharm	noun	Charme
karren	noun	Karre
gänse	noun	Gans
hunde	noun	Hund
frisör	noun	Friseur
freiwillige	noun	Freiwilliger
nugat	noun	Nougat
manieren	noun	Manier
erb	verb	erben
schick	verb	schicken
bilder	noun	Bild
männer	noun	Mann
astronauten	noun	Astronaut
flöten	noun	Flöte
bullen	noun	Bulle
planeten	noun	Planet
stiere	noun	Stier
autos	noun	Auto
täler	noun	Tal
tage	noun	Tag
wölfe	noun	Wolf
riesen	noun	Riese
bälle	noun	Ball
lämmer	noun	Lamm
straßen	noun	Straße
brillen	noun	Brille
wikis	noun	Wiki
mauern	noun	Mauer
wände	noun	Wand
globen	noun	Globus
spiele	noun	Spiel
länder	noun	Land
schulen	noun	Schule
anzüge	noun	Anzug
formen	noun	Form
mönche	noun	Mönch
boxen	noun	Box
vandalen	noun	Vandale
chinesen	noun	Chinese
züge	noun	Zug
etikette	noun	Etikett
wahlen	noun	Wahl
palmen	noun	Palme
teile	noun	Teil
hexen	noun	Hexe
soufflee	noun	Soufflé
träume	noun	Traum
lippen	noun	Lippe
robben	noun	Robbe
kristalle	noun	Kristall
wurzeln	noun	Wurzel
drogen	noun	Droge
spagetti	noun	Spaghetti
drainage	noun	Dränage
bücher	noun	Buch
loren	noun	Lore
tränken	verb	trinken
hink	verb	hinken
iren	noun	Ire
krähen	noun	Krähe
laute	noun	Laut
wiesen	noun	Wiese
beiget	verb	beigen
vulkans	noun	Vulkan
erster	numeral	erste
dachböden	noun	Dachboden
scherenschnitte	noun	Scherenschnitt
spinnen	noun	Spinne
krokodile	noun	Krokodil
rehe	noun	Reh
hasen	noun	Hase
elefanten	noun	Elefant
zebras	noun	Zebra
falken	noun	Falke
schafe	noun	Schaf
giraffen	noun	Giraffe
tauben	noun	Taube
tauben	noun	Tauber
treppen	noun	Treppe
plätze	noun	Platz
süchte	noun	Sucht
küchen	noun	Küche
diamanten	noun	Diamant
rubine	noun	Rubin
präsidenten	noun	Präsident
hosen	noun	Hose
sterne	noun	Stern
schiffe	noun	Schiff
boote	noun	Boot
tiere	noun	Tier
bananen	noun	Banane
aprikosen	noun	Aprikose
feigen	noun	Feige
feigen	noun	Feiger
orangen	noun	Orange
quitten	noun	Quitte
nektarinen	noun	Nektarine
melonen	noun	Melone
mandarinen	noun	Mandarine
mangos	noun	Mango
kiwis	noun	Kiwi
papayas	noun	Papaya
ananasse	noun	Ananas
märkte	noun	Markt
brüste	noun	Brust
hände	noun	Hand
schultern	noun	Schulter
fliegen	noun	Fliege
wespen	noun	Wespe
pyramiden	noun	Pyramide
gabeln	noun	Gabel
extremisten	noun	Extremist
kämpfe	noun	Kampf
überstunden	noun	Überstunde
zeilen	noun	Zeile
spalten	noun	Spalte
gräser	noun	Gras
antennen	noun	Antenne
säfte	noun	Saft
wüsten	noun	Wüste
möhren	noun	Möhre
karten	noun	Karte
stifte	noun	Stift
ringe	noun	Ring
beiträge	noun	Beitrag
briefe	noun	Brief
fragen	noun	Frage
sprachen	noun	Sprache
strände	noun	Strand
franken	noun	Franke
borgs	noun	Borg
farmers	noun	Farmer
tasers	noun	Taser
antworten	noun	Antwort
flüsse	noun	Fluss
enten	noun	Ente
alligatoren	noun	Alligator
kupee	noun	Coupé
schreie	noun	Schrei
sünden	noun	Sünde
eier	noun	Ei
couvert	noun	Kuvert
kusine	noun	Cousine
äxte	noun	Axt
geographie	noun	Geografie
steine	noun	Stein
sonnen	noun	Sonne
küsse	noun	Kuss
haare	noun	Haar
möwen	noun	Möwe
sanktionen	noun	Sanktion
pfiffe	noun	Pfiff
tomaten	noun	Tomate
salze	noun	Salz
ställe	noun	Stall
rosinen	noun	Rosine
boten	noun	Bote
quarkonia	noun	Quarkonium
mixe	noun	Mix
brote	noun	Brot
séparée	noun	Separee
negligé	noun	Negligee
varieté	noun	Varietee
barts	noun	Bart
zweiter	numeral	zweite
verträge	noun	Vertrag
verletzte	noun	Verletzter
verletzter	noun	Verletzte
entrée	noun	Entree
avancen	noun	Avance
türme	noun	Turm
lkw	noun	LKW
pkw	noun	PKW
verwandte	noun	Verwandter
verwandter	noun	Verwandte
berufe	noun	Beruf
kupon	noun	Coupon
viren	noun	Virus
ratten	noun	Ratte
mumien	noun	Mumie
freiwilliger	noun	Freiwillige
friteuse	noun	Fritteuse
frotté	noun	Frottee
scheine	noun	Schein
reihen	noun	Reihe
flocken	noun	Flocke
flammen	noun	Flamme
pumpen	noun	Pumpe
büros	noun	Büro
hugenotten	noun	Hugenotte
russen	noun	Russe
türken	noun	Türke
mutanten	noun	Mutant
mutanten	noun	Mutante
koteletten	noun	Kotelett
matinée	noun	Matinee
süperb	adjective	superb
agent provocateur	noun	Agent Provocateur
devisen	noun	Devise
lampen	noun	Lampe
insekten	noun	Insekt
größenwahnsinnige	noun	Größenwahnsinniger
größenwahnsinniger	noun	Größenwahnsinnige
nicotin	noun	Nikotin
schmiede	noun	Schmied
gierst	verb	gieren
minima	noun	Minimum
maxima	noun	Maximum
muses	noun	Mus
gruppen	noun	Gruppe
puppen	noun	Puppe
sporen	noun	Spore
sporen	noun	Sporn
kalk	verb	kalken
martinis	noun	Martini
berliners	noun	Berliner
neugeborene	noun	Neugeborenes
thales	noun	Thal
fantasien	noun	Fantasie
revolutionäre	noun	Revolutionär
rügen	noun	Rüge
projekte	noun	Projekt
rene	noun	Ren
merkt	verb	merken
milliarden	noun	Milliarde
vierten	numeral	vierte
roma	noun	Rom
romane	noun	Roman
köche	noun	Koch
croupiers	noun	Croupier
warte	verb	warten
astronomen	noun	Astronom
kapern	noun	Kaper
aams	noun	Aam
dosen	noun	Dose
dosen	noun	Dosis
obers	noun	Ober
negligees	noun	Negligee
welches	pronoun	welcher
kelten	noun	Kelte
vorwürfe	noun	Vorwurf
sekunden	noun	Sekunde
sekunden	noun	Sekunda
minuten	noun	Minute
jahre	noun	Jahr
massen	noun	Masse
tach	noun	Tag
büffels	noun	Büffel
nachkommen	noun	Nachkomme
kufen	noun	Kufe
abbaue	noun	Abbau
abbauen	noun	Abbau
abfälle	noun	Abfall
abgaben	noun	Abgabe
amputierte	noun	Amputierter
eingeweihte	noun	Eingeweihter
eingeweihter	noun	Eingeweihte
herzen	noun	Herz
trompeten	noun	Trompete
briefkästen	noun	Briefkasten
wellen	noun	Welle
särge	noun	Sarg
noten	noun	Note
fotos	noun	Foto
salate	noun	Salat
auberginen	noun	Aubergine
angriffe	noun	Angriff
öle	noun	Öl
fette	noun	Fett
veränderungen	noun	Veränderung
flüge	noun	Flug
mütter	noun	Mutter
väter	noun	Vater
tanten	noun	Tante
nichten	noun	Nichte
tänze	noun	Tanz
heuern	noun	Heuer
kindergärten	noun	Kindergarten
buddhisten	noun	Buddhist
bange	adjective	bang
öfen	noun	Ofen
biere	noun	Bier
einträge	noun	Eintrag
löwen	noun	Löwe
leoparden	noun	Leopard
terroristen	noun	Terrorist
kriege	noun	Krieg
pfeifen	noun	Pfeife
röcke	noun	Rock
stöcke	noun	Stock
äste	noun	Ast
eichen	noun	Eiche
buchen	noun	Buche
administratoren	noun	Administrator
formate	noun	Format
fotzen	noun	Fotze
runden	noun	Runde
ebenen	noun	Ebene
zugaben	noun	Zugabe
sphären	noun	Sphäre
debatten	noun	Debatte
sekten	noun	Sekte
kanonen	noun	Kanone
putsche	noun	Putsch
atombomben	noun	Atombombe
töchter	noun	Tochter
gase	noun	Gas
pistolen	noun	Pistole
hefte	noun	Heft
soldaten	noun	Soldat
bärte	noun	Bart
tassen	noun	Tasse
pässe	noun	Pass
grenzen	noun	Grenze
mooses	noun	Moos
händen	noun	Hand
explosionen	noun	Explosion
gänge	noun	Gang
gassen	noun	Gasse
ideen	noun	Idee
kängurus	noun	Känguru
winde	noun	Wind
stürme	noun	Sturm
pisten	noun	Piste
vulkane	noun	Vulkan
rinnen	noun	Rinne
gründe	noun	Grund
paläste	noun	Palast
hallen	noun	Halle
regionen	noun	Region
legionen	noun	Legion
tücher	noun	Tuch
fabriken	noun	Fabrik
flöhe	noun	Floh
zecken	noun	Zecke
sandkästen	noun	Sandkasten
feiern	noun	Feier
abreisen	noun	Abreise
iota	noun	Jota
föten	noun	Fötus
huren	noun	Hure
familien	noun	Familie
nägel	noun	Nagel
demokraten	noun	Demokrat
kommunisten	noun	Kommunist
nationalisten	noun	Nationalist
anarchisten	noun	Anarchist
lokomotiven	noun	Lokomotive
bremsen	noun	Bremse
mücken	noun	Mücke
akten	noun	Akte
gorillas	noun	Gorilla
büsche	noun	Busch
bahnen	noun	Bahn
kartons	noun	Karton
figuren	noun	Figur
würfe	noun	Wurf
armeen	noun	Armee
schlachten	noun	Schlacht
völker	noun	Volk
zaren	noun	Zar
hologramme	noun	Hologramm
mongolen	noun	Mongole
hunnen	noun	Hunne
revolutionen	noun	Revolution
stärken	noun	Stärke
fackeln	noun	Fackel
mächte	noun	Macht
attentate	noun	Attentat
invasionen	noun	Invasion
dienste	noun	Dienst
rohre	noun	Rohr
termine	noun	Termin
internierte	noun	Internierter
trugen	verb	tragen
tragen	noun	Trage
visionen	noun	Vision
seelen	noun	Seele
morde	noun	Mord
hinweise	noun	Hinweis
tonnen	noun	Tonne
sadisten	noun	Sadist
bootes	noun	Boot
narren	noun	Narr
genoß	verb	genoss
karikaturen	noun	Karikatur
instrumente	noun	Instrument
situationen	noun	Situation
korallen	noun	Koralle
vielfache	noun	Vielfaches
sitze	noun	Sitz
personen	noun	Person
werke	noun	Werk
koordinaten	noun	Koordinate
regeln	noun	Regel
quellen	noun	Quelle
lügen	noun	Lüge
därme	noun	Darm
dämme	noun	Damm
kameras	noun	Kamera
filme	noun	Film
journalisten	noun	Journalist
produkte	noun	Produkt
tasten	noun	Taste
religionen	noun	Religion
zelte	noun	Zelt
granaten	noun	Granate
fäuste	noun	Faust
rechte	noun	Recht
rechte	noun	Rechter
juwelen	noun	Juwel
düfte	noun	Duft
gazellen	noun	Gazelle
pillen	noun	Pille
weisen	noun	Weise
weisen	noun	Weiser
kredite	noun	Kredit
penisse	noun	Penis
betten	noun	Bett
pauken	noun	Pauke
grösse	noun	Größe
effekte	noun	Effekt
kandidaten	noun	Kandidat
tüten	noun	Tüte
horden	noun	Horde
deren	pronoun	der
denen	pronoun	der
schmäuse	noun	Schmaus
ausweise	noun	Ausweis
fesseln	noun	Fessel
trupps	noun	Trupp
kontrollen	noun	Kontrolle
systeme	noun	System
säuren	noun	Säure
ziele	noun	Ziel
bühnen	noun	Bühne
weine	noun	Wein
gärten	noun	Garten
krisen	noun	Krise
pakete	noun	Paket
delfin	noun	Delphin
interessen	noun	Interesse
varianten	noun	Variante
orte	noun	Ort
begriffe	noun	Begriff
studien	noun	Studium
studien	noun	Studie
objekte	noun	Objekt
angaben	noun	Angabe
windeln	noun	Windel
dobermanns	noun	Dobermann
auf teufel-komm-raus	adverb	auf Teufel komm raus
ablässe	noun	Ablass
aprils	noun	April
novembers	noun	November
rüben	noun	Rübe
larven	noun	Larve
suppen	noun	Suppe
stellen	noun	Stelle
weiden	noun	Weide
kreuze	noun	Kreuz
kreise	noun	Kreis
quadrate	noun	Quadrat
punkte	noun	Punkt
altäre	noun	Altar
spione	noun	Spion
räder	noun	Rad
schlösser	noun	Schloss
hotels	noun	Hotel
rosen	noun	Rose
tulpen	noun	Tulpe
avocados	noun	Avocado
privilegien	noun	Privileg
brüder	noun	Bruder
lupen	noun	Lupe
grüße	noun	Gruß
joints	noun	Joint
schotten	noun	Schotte
schotten	noun	Schott
aktivisten	noun	Aktivist
jägers	noun	Jäger
jägermeisters	noun	Jägermeister
meisters	noun	Meister
mörders	noun	Mörder
kobolds	noun	Kobold
kardinäle	noun	Kardinal
telefone	noun	Telefon
finnen	noun	Finne
koste	verb	kosen
magna	noun	Magnum
olefine	noun	Olefin
goten	noun	Gote
schwarzer	noun	Schwarze
egoisten	noun	Egoist
kapitalisten	noun	Kapitalist
episoden	noun	Episode
kreiden	noun	Kreide
ritzen	noun	Ritze
katakomben	noun	Katakombe
plagiate	noun	Plagiat
planken	noun	Planke
ohrfeigen	noun	Ohrfeige
asbeste	noun	Asbest
augäpfel	noun	Augapfel
antriebe	noun	Antrieb
visiten	noun	Visite
russinnen	noun	Russin
olympiaden	noun	Olympiade
hymnen	noun	Hymne
aktien	noun	Aktie
schalen	noun	Schale
kästen	noun	Kasten
clowns	noun	Clown
kugeln	noun	Kugel
murmeln	noun	Murmel
recke	noun	Reck
recken	noun	Recke
bretter	noun	Brett
eliten	noun	Elite
zwänge	noun	Zwang
schmieden	noun	Schmiede
schleudern	noun	Schleuder
parlamente	noun	Parlament
knarren	noun	Knarre
schimpansen	noun	Schimpanse
drosseln	noun	Drossel
finken	noun	Fink
latten	noun	Latte
mösen	noun	Möse
nutten	noun	Nutte
fähren	noun	Fähre
flüche	noun	Fluch
böden	noun	Boden
gitarren	noun	Gitarre
kometen	noun	Komet
deppen	noun	Depp
läden	noun	Laden
sinne	noun	Sinn
blüten	noun	Blüte
lagen	noun	Lage
decken	noun	Decke
griffe	noun	Griff
spiralen	noun	Spirale
regale	noun	Regal
hämmer	noun	Hammer
chirurgen	noun	Chirurg
rassen	noun	Rasse
anomalien	noun	Anomalie
pianisten	noun	Pianist
organisten	noun	Organist
gitarristen	noun	Gitarrist
artisten	noun	Artist
violinisten	noun	Violinist
humanisten	noun	Humanist
separatisten	noun	Separatist
juristen	noun	Jurist
kontaktlinsen	noun	Kontaktlinse
börsen	noun	Börse
gynäkologien	noun	Gynäkologie
gläser	noun	Glas
kämpfers	noun	Kämpfer
marmore	noun	Marmor
marmors	noun	Marmor
interesses	noun	Interesse
interessenten	noun	Interessent
biograph	noun	Biograf
biografen	noun	Biograf
biografien	noun	Biografie
buches	noun	Buch
tags	noun	Tag
tages	noun	Tag
triumphe	noun	Triumph
triumphes	noun	Triumph
pleiten	noun	Pleite
briefs	noun	Brief
motten	noun	Motte
versionen	noun	Version
bonusses	noun	Bonus
boni	noun	Bonus
sofas	noun	Sofa
reglements	noun	Reglement
pfennige	noun	Pfennig
pfennigs	noun	Pfennig
kitsches	noun	Kitsch
verstöße	noun	Verstoß
registers	noun	Register
hurras	noun	Hurra
vorstöße	noun	Vorstoß
therapeuten	noun	Therapeut
bäder	noun	Bad
komikers	noun	Komiker
zonen	noun	Zone
bitumens	noun	Bitumen
bitumina	noun	Bitumen
schnäuzers	noun	Schnäuzer
mannes	noun	Mann
zweiten	numeral	zweite
vogels	noun	Vogel
bäckers	noun	Bäcker
rindes	noun	Rind
teams	noun	Team
reserven	noun	Reserve
matten	noun	Matte
fußabstreifers	noun	Fußabstreifer
facetten	noun	Facette
kinds	noun	Kind
kindes	noun	Kind
weißer	noun	Weiße
operationen	noun	Operation
fache	verb	fachen
messers	noun	Messer
trojaners	noun	Trojaner
linke	noun	Linker
melassen	noun	Melasse
weck	verb	wecken
weichen	noun	Weiche
hänge	noun	Hang
krokodils	noun	Krokodil
kunden	noun	Kunde
öls	noun	Öl
öles	noun	Öl
fetts	noun	Fett
fettes	noun	Fett
hundes	noun	Hund
hunds	noun	Hund
bieres	noun	Bier
biers	noun	Bier
kuhdorfs	noun	Kuhdorf
kuhdorfes	noun	Kuhdorf
türen	noun	Tür
bögen	noun	Bogen
bogens	noun	Bogen
basken	noun	Baske
pudels	noun	Pudel
disketten	noun	Diskette
vogelspinnen	noun	Vogelspinne
mythen	noun	Mythos
türkise	noun	Türkis
krabben	noun	Krabbe
moskitos	noun	Moskito
poeten	noun	Poet
ritters	noun	Ritter
trommeln	noun	Trommel
seminare	noun	Seminar
hausfrauen	noun	Hausfrau
oboen	noun	Oboe
sektionen	noun	Sektion
pausen	noun	Pause
verlangens	noun	Verlangen
bergs	noun	Berg
hormone	noun	Hormon
projektionen	noun	Projektion
mandeln	noun	Mandel
schäden	noun	Schaden
motoren	noun	Motor
motors	noun	Motor
dinosauriers	noun	Dinosaurier
ernten	noun	Ernte
enklaven	noun	Enklave
heten	noun	Hete
panzers	noun	Panzer
korans	noun	Koran
sturmvogels	noun	Sturmvogel
parlaments	noun	Parlament
katalanen	noun	Katalane
statisten	noun	Statist
beweise	noun	Beweis
salärs	noun	Salär
saläre	noun	Salär
wolken	noun	Wolke
ordners	noun	Ordner
afghanen	noun	Afghane
hexers	noun	Hexer
kennend	verb	kennen
mögend	verb	mögen
wendend	verb	wenden
spatzen	noun	Spatz
speers	noun	Speer
drillings	noun	Drilling
aals	noun	Aal
aales	noun	Aal
aale	noun	Aal
agnostikers	noun	Agnostiker
aggressors	noun	Aggressor
agitators	noun	Agitator
akrobaten	noun	Akrobat
abstürze	noun	Absturz
aktionen	noun	Aktion
aluminiumfolien	noun	Aluminiumfolie
altruisten	noun	Altruist
alphorns	noun	Alphorn
partys	noun	Party
ackers	noun	Acker
äcker	noun	Acker
abflüge	noun	Abflug
amplituden	noun	Amplitude
optimisten	noun	Optimist
biwaksäcke	noun	Biwaksack
prinzips	noun	Prinzip
ingenieurs	noun	Ingenieur
horrorfilms	noun	Horrorfilm
berichte	noun	Bericht
verzehre	noun	Verzehr
fraktals	noun	Fraktal
fraktales	noun	Fraktal
fraktale	noun	Fraktal
telegrammes	noun	Telegramm
telegramme	noun	Telegramm
monteurs	noun	Monteur
anagrammes	noun	Anagramm
anagramme	noun	Anagramm
schutzes	noun	Schutz
bodyguards	noun	Bodyguard
adrenalins	noun	Adrenalin
alchemisten	noun	Alchemist
algeriers	noun	Algerier
amphibien	noun	Amphibie
anisettes	noun	Anisette
ansprachen	noun	Ansprache
antibiotikums	noun	Antibiotikum
antibiotika	noun	Antibiotikum
antonymes	noun	Antonym
antonyme	noun	Antonym
argumentationen	noun	Argumentation
assassinen	noun	Assassine
atomkerne	noun	Atomkern
atriums	noun	Atrium
attentats	noun	Attentat
attentates	noun	Attentat
ausbeuten	noun	Ausbeute
ausgaben	noun	Ausgabe
automobils	noun	Automobil
automobile	noun	Automobil
heere	noun	Heer
schwarzen	noun	Schwarzer
schwarzen	noun	Schwarze
schwarze	noun	Schwarzer
baseballs	noun	Baseball
baskische	noun	Baskisch
bastards	noun	Bastard
depots	noun	Depot
berbers	noun	Berber
broms	noun	Brom
sitars	noun	Sitar
kulturen	noun	Kultur
module	noun	Modul
säge	verb	sägen
curcuma	noun	Kurkuma
omelettes	noun	Omelett
modells	noun	Modell
modelle	noun	Modell
privileges	noun	Privileg
postulats	noun	Postulat
postulates	noun	Postulat
respekts	noun	Respekt
amateurs	noun	Amateur
amateure	noun	Amateur
alkoholikers	noun	Alkoholiker
alkohols	noun	Alkohol
alkohole	noun	Alkohol
alibis	noun	Alibi
angeln	noun	Angel
anglers	noun	Angler
anfängers	noun	Anfänger
anfangs	noun	Anfang
anfänge	noun	Anfang
androiden	noun	Android
animateurs	noun	Animateur
amerikaners	noun	Amerikaner
ambitionen	noun	Ambition
anekdoten	noun	Anekdote
anatomes	noun	Anatom
albinos	noun	Albino
amnesien	noun	Amnesie
alleen	noun	Allee
ammen	noun	Amme
amputierten	noun	Amputierter
amputierten	noun	Amputierte
amts	noun	Amt
ämter	noun	Amt
alligators	noun	Alligator
akronyms	noun	Akronym
aktivismen	noun	Aktivismus
akupunkturen	noun	Akupunktur
akustiken	noun	Akustik
alarms	noun	Alarm
alarme	noun	Alarm
algen	noun	Alge
allergens	noun	Allergen
allergene	noun	Allergen
allergien	noun	Allergie
alphabets	noun	Alphabet
alphabetes	noun	Alphabet
alphabete	noun	Alphabet
amalgams	noun	Amalgam
ammoniaks	noun	Ammoniak
amethysts	noun	Amethyst
amethystes	noun	Amethyst
amethyste	noun	Amethyst
amuletts	noun	Amulett
amulettes	noun	Amulett
amulette	noun	Amulett
amöben	noun	Amöbe
analysen	noun	Analyse
anbauten	noun	Anbau
anzeigen	noun	Anzeige
aristokraten	noun	Aristokrat
anlässe	noun	Anlass
ankerplätze	noun	Ankerplatz
annahmen	noun	Annahme
anreisen	noun	Anreise
anrufe	noun	Anruf
apothekers	noun	Apotheker
appartements	noun	Appartement
asiaten	noun	Asiate
aspekte	noun	Aspekt
artefakts	noun	Artefakt
außerirdischen	noun	Außerirdische
attacken	noun	Attacke
ausbruchs	noun	Ausbruch
ausgleiche	noun	Ausgleich
auktionen	noun	Auktion
attraktionen	noun	Attraktion
ausdrücke	noun	Ausdruck
autors	noun	Autor
autopsien	noun	Autopsie
ausserirdischen	noun	Außerirdischen
yachten	noun	Yacht
ypsilons	noun	Ypsilon
yetis	noun	Yeti
zahnes	noun	Zahn
zahlungen	noun	Zahlung
zankäpfel	noun	Zankapfel
zanders	noun	Zander
zangen	noun	Zange
zombies	noun	Zombie
zoologen	noun	Zoologe
zeppelins	noun	Zeppelin
zentralen	noun	Zentrale
zelts	noun	Zelt
zugvögel	noun	Zugvogel
zuckers	noun	Zucker
zufalls	noun	Zufall
zebrafinken	noun	Zebrafink
jetons	noun	Jeton
adamsäpfel	noun	Adamsapfel
administrationen	noun	Administration
abends	noun	Abend
additionen	noun	Addition
adoptionen	noun	Adoption
adressen	noun	Adresse
affären	noun	Affäre
agenten	noun	Agent
abstiege	noun	Abstieg
abstraktionen	noun	Abstraktion
afters	noun	After
akkus	noun	Akku
akademien	noun	Akademie
archipels	noun	Archipel
barrieren	noun	Barriere
barrikaden	noun	Barrikade
befehle	noun	Befehl
baggers	noun	Bagger
bagatellen	noun	Bagatelle
bakterien	noun	Bakterium
barsches	noun	Barsch
barsche	noun	Barsch
bände	noun	Band
bänder	noun	Band
bands	noun	Band
bandes	noun	Band
bataillons	noun	Bataillon
bastionen	noun	Bastion
babys	noun	Baby
babysitters	noun	Babysitter
garantien	noun	Garantie
abszesse	noun	Abszess
abszesses	noun	Abszess
armbrüste	noun	Armbrust
banners	noun	Banner
beichtväter	noun	Beichtvater
beichten	noun	Beichte
baums	noun	Baum
baumes	noun	Baum
bildungsromans	noun	Bildungsroman
bildungsromane	noun	Bildungsroman
asteroide	noun	Asteroid
asteroiden	noun	Asteroid
astronoms	noun	Astronom
assistenten	noun	Assistent
aufstände	noun	Aufstand
aufstiege	noun	Aufstieg
ausschüsse	noun	Ausschuss
autopiloten	noun	Autopilot
billets	noun	Billet
billetes	noun	Billet
bescheide	noun	Bescheid
bioläden	noun	Bioladen
bibliotheken	noun	Bibliothek
blasen	noun	Blase
binden	noun	Binde
betriebe	noun	Betrieb
besuche	noun	Besuch
blicks	noun	Blick
blockaden	noun	Blockade
blocks	noun	Block
bonzen	noun	Bonze
bordells	noun	Bordell
brots	noun	Brot
brotes	noun	Brot
brotkästen	noun	Brotkasten
bolivianers	noun	Bolivianer
pizzas	noun	Pizza
eschen	noun	Esche
birken	noun	Birke
lärchen	noun	Lärche
patronen	noun	Patrone
antidepressiva	noun	Antidepressivum
arabers	noun	Araber
mägde	noun	Magd
mantras	noun	Mantra
raubvögel	noun	Raubvogel
greifvögel	noun	Greifvogel
ablösen	noun	Ablöse
blogs	noun	Blog
pixels	noun	Pixel
croissants	noun	Croissant
déjà-vus	noun	Déjà-vu
mafiosos	noun	Mafioso
nappas	noun	Nappa
velos	noun	Velo
landes	noun	Land
lande	noun	Land
apparats	noun	Apparat
apparates	noun	Apparat
apparate	noun	Apparat
aufgaben	noun	Aufgabe
aufnahmen	noun	Aufnahme
ateliers	noun	Atelier
atoms	noun	Atom
atome	noun	Atom
axioms	noun	Axiom
axiome	noun	Axiom
beulen	noun	Beule
biergärten	noun	Biergarten
dolomite	noun	Dolomit
turing-tests	noun	Turing-Test
klammern	noun	Klammer
protokolls	noun	Protokoll
achten	noun	Acht
siebe	noun	Sieb
brötchens	noun	Brötchen
airbags	noun	Airbag
punks	noun	Punk
financier	noun	Finanzier
financiers	noun	Financier
chamäleons	noun	Chamäleon
geckos	noun	Gecko
mambas	noun	Mamba
datschen	noun	Datsche
abwässer	noun	Abwasser
dilettanten	noun	Dilettant
dimensionen	noun	Dimension
diktatoren	noun	Diktator
diktators	noun	Diktator
diktaturen	noun	Diktatur
deserteurs	noun	Deserteur
despoten	noun	Despot
direktoren	noun	Direktor
direktors	noun	Direktor
deutsche doggen	noun	Deutsche Dogge
diplome	noun	Diplom
diploms	noun	Diplom
diagnosen	noun	Diagnose
dialekts	noun	Dialekt
diagrammes	noun	Diagramm
diagramme	noun	Diagramm
dekorationen	noun	Dekoration
dirigenten	noun	Dirigent
diplomaten	noun	Diplomat
delegationen	noun	Delegation
dellen	noun	Delle
delikatessen	noun	Delikatesse
doggen	noun	Dogge
sauerkrauts	noun	Sauerkraut
exporteurs	noun	Exporteur
falten	noun	Falte
autobahnen	noun	Autobahn
bandagen	noun	Bandage
bauten	noun	Bau
bankette	noun	Bankett
bankiers	noun	Bankier
bässe	noun	Bass
banden	noun	Bande
bachen	noun	Bache
bachs	noun	Bach
baches	noun	Bach
bäche	noun	Bach
barbaren	noun	Barbar
barons	noun	Baron
barones	noun	Baron
barone	noun	Baron
karos	noun	Karo
baracken	noun	Baracke
chorals	noun	Choral
chorales	noun	Choral
choräle	noun	Choral
laven	noun	Lava
dahlien	noun	Dahlie
dachshunds	noun	Dachshund
dachshundes	noun	Dachshund
dachshunde	noun	Dachshund
delfins	noun	Delfin
damms	noun	Damm
dammes	noun	Damm
dämpfe	noun	Dampf
abiturienten	noun	Abiturient
tanks	noun	Tank
sagen	noun	Sage
böreks	noun	Börek
schnauzen	noun	Schnauze
teppichböden	noun	Teppichboden
territoriums	noun	Territorium
terrariums	noun	Terrarium
terrassen	noun	Terrasse
tilden	noun	Tilde
tinten	noun	Tinte
textes	noun	Text
texte	noun	Text
feen	noun	Fee
fingernägel	noun	Fingernagel
firmen	noun	Firma
festivals	noun	Festival
feten	noun	Fete
feilen	noun	Feile
felgen	noun	Felge
fells	noun	Fell
felles	noun	Fell
felle	noun	Fell
fichten	noun	Fichte
fjords	noun	Fjord
fjordes	noun	Fjord
fjorde	noun	Fjord
feministen	noun	Feminist
filmes	noun	Film
schlage	verb	schlagen
grundlagen	noun	Grundlage
ränge	noun	Rang
klarinetten	noun	Klarinette
barrens	noun	Barren
cembalos	noun	Cembalo
cembali	noun	Cembalo
clans	noun	Clan
koalitionen	noun	Koalition
bornes	noun	Born
borns	noun	Born
amüsements	noun	Amüsement
hörens	noun	Hören
ständers	noun	Ständer
quäkers	noun	Quäker
quadrats	noun	Quadrat
quadrates	noun	Quadrat
qualen	noun	Qual
quants	noun	Quant
rabenmütter	noun	Rabenmutter
radikals	noun	Radikal
radikale	noun	Radikaler
radikalen	noun	Radikaler
raten	noun	Rate
radios	noun	Radio
reduktionen	noun	Reduktion
referates	noun	Referat
räume	noun	Raum
gifts	noun	Gift
giftes	noun	Gift
gifte	noun	Gift
räusche	noun	Rausch
regenbögen	noun	Regenbogen
rausschmisse	noun	Rausschmiss
kampfers	noun	Kampfer
abonnenten	noun	Abonnent
reformators	noun	Reformator
reformatoren	noun	Reformator
rampen	noun	Rampe
rallen	noun	Ralle
reaktionäre	noun	Reaktionär
reaktionen	noun	Reaktion
reaktionärs	noun	Reaktionär
regisseurs	noun	Regisseur
regimes	noun	Regime
reiches	noun	Reich
reiche	noun	Reich
reiche	noun	Reicher
reptils	noun	Reptil
reservates	noun	Reservat
reservate	noun	Reservat
rillen	noun	Rille
baisers	noun	Baiser
bodens	noun	Boden
meers	noun	Meer
obdachlosen	noun	Obdachloser
obdachlosen	noun	Obdachlose
omas	noun	Oma
originale	noun	Original
originals	noun	Original
orkans	noun	Orkan
ossis	noun	Ossi
omnibusses	noun	Omnibus
ouvertüren	noun	Ouvertüre
offerten	noun	Offerte
offensiven	noun	Offensive
onkels	noun	Onkel
objekts	noun	Objekt
oppositionen	noun	Opposition
ofens	noun	Ofen
abbrüche	noun	Abbruch
übermenschen	noun	Übermensch
ären	noun	Ära
überfälle	noun	Überfall
äquivalente	noun	Äquivalent
äquivalents	noun	Äquivalent
äquivalentes	noun	Äquivalent
zuschüsse	noun	Zuschuss
dungs	noun	Dung
dunges	noun	Dung
salme	noun	Salm
kontraktionen	noun	Kontraktion
senders	noun	Sender
empfänge	noun	Empfang
embryos	noun	Embryo
blutes	noun	Blut
blute	noun	Blut
massakers	noun	Massaker
frikadellen	noun	Frikadelle
bratäpfel	noun	Bratapfel
dermatologen	noun	Dermatologe
eingriffe	noun	Eingriff
oreganos	noun	Oregano
rosmarins	noun	Rosmarin
kinderwagens	noun	Kinderwagen
aperitifs	noun	Aperitif
bowlen	noun	Bowle
punsche	noun	Punsch
grappas	noun	Grappa
ouzos	noun	Ouzo
bronzen	noun	Bronze
arterien	noun	Arterie
drüsen	noun	Drüse
diaphragmas	noun	Diaphragma
beamten	noun	Beamter
beamten	noun	Beamte
sonntags	noun	Sonntag
völkerwanderungen	noun	Völkerwanderung
duschen	noun	Dusche
abschleppwägen	noun	Abschleppwagen
absinths	noun	Absinth
absinthe	noun	Absinth
handschriften	noun	Handschrift
automaten	noun	Automat
makronen	noun	Makrone
galerien	noun	Galerie
gedankenexperiments	noun	Gedankenexperiment
kreuzers	noun	Kreuzer
stoffe	noun	Stoff
wol	adverb	wohl
admirals	noun	Admiral
admirale	noun	Admiral
admiräle	noun	Admiral
advents	noun	Advent
adventes	noun	Advent
advente	noun	Advent
affronts	noun	Affront
primaten	noun	Primat
agents provocateurs	noun	Agent provocateur
agents provocateurs	noun	Agent Provocateur
agenden	noun	Agenda
akuts	noun	Akut
akute	noun	Akut
rettungswägen	noun	Rettungswagen
wagens	noun	Wagen
wals	noun	Wal
kastenwägen	noun	Kastenwagen
planwägen	noun	Planwagen
schwänze	noun	Schwanz
kastens	noun	Kasten
depressionen	noun	Depression
drucke	noun	Druck
drücke	noun	Druck
ausdrucke	noun	Ausdruck
fasses	noun	Fass
stürmerkästen	noun	Stürmerkasten
mähnen	noun	Mähne
nordpols	noun	Nordpol
roggenbrots	noun	Roggenbrot
steinbocks	noun	Steinbock
steinbrüche	noun	Steinbruch
pols	noun	Pol
essens	noun	Essen
tapeten	noun	Tapete
falters	noun	Falter
röhren	noun	Röhre
dollars	noun	Dollar
locken	noun	Locke
leichenwägen	noun	Leichenwagen
lkws	noun	Lkw
pkws	noun	PKW
kalke	verb	kalken
kakaos	noun	Kakao
lagunen	noun	Lagune
synergien	noun	Synergie
strahlen	noun	Strahl
stücke	noun	Stück
stollens	noun	Stollen
zechen	noun	Zeche
generators	noun	Generator
generatoren	noun	Generator
thyristors	noun	Thyristor
transformators	noun	Transformator
transformatoren	noun	Transformator
tieres	noun	Tier
tiergärten	noun	Tiergarten
kanarienvögel	noun	Kanarienvogel
bajonetts	noun	Bajonett
umlauts	noun	Umlaut
umlaute	noun	Umlaut
infektionen	noun	Infektion
mörtels	noun	Mörtel
lupinen	noun	Lupine
maltesen	noun	Maltese
sitten	noun	Sitte
brünetten	noun	Brünette
mankos	noun	Manko
panthers	noun	Panther
papas	noun	Papa
papiers	noun	Papier
pappen	noun	Pappe
paprikas	noun	Paprika
parabeln	noun	Parabel
hypothesen	noun	Hypothese
zusammenarbeiten	noun	Zusammenarbeit
edelweißes	noun	Edelweiß
eingeweihten	noun	Eingeweihter
eingeweihten	noun	Eingeweihte
schusses	noun	Schuss
typen	noun	Type
häme	noun	Häm
suren	noun	Sure
tunnels	noun	Tunnel
interpreten	noun	Interpret
löhne	noun	Lohn
kompagnons	noun	Kompagnon
pardons	noun	Pardon
strangs	noun	Strang
stranges	noun	Strang
stränge	noun	Strang
heliostats	noun	Heliostat
referendums	noun	Referendum
fußes	noun	Fuß
zeugen	noun	Zeuge
bomben	noun	Bombe
tränen	noun	Träne
lebkuchens	noun	Lebkuchen
leckes	noun	Leck
leders	noun	Leder
legenden	noun	Legende
stils	noun	Stil
stiles	noun	Stil
lauten	noun	Laute
lautes	noun	Laut
laufs	noun	Lauf
läufe	noun	Lauf
orts	noun	Ort
gelds	noun	Geld
gelder	noun	Geld
sände	noun	Sand
gases	noun	Gas
utensils	noun	Utensil
gestalten	noun	Gestalt
fälle	noun	Fall
basalts	noun	Basalt
basaltes	noun	Basalt
basalte	noun	Basalt
füsse	noun	Fuss
höhlen	noun	Höhle
belemmert	adjective	belämmert
friesen	noun	Friese
ultimatums	noun	Ultimatum
universums	noun	Universum
uniformen	noun	Uniform
ungläubigen	noun	Ungläubiger
ungläubigen	noun	Ungläubige
unionen	noun	Union
unken	noun	Unke
unparteiischen	noun	Unparteiischer
unparteiischen	noun	Unparteiische
unterschiede	noun	Unterschied
unterstriche	noun	Unterstrich
urnen	noun	Urne
urvögel	noun	Urvogel
urteile	noun	Urteil
utopien	noun	Utopie
ursprungs	noun	Ursprung
urgroßmütter	noun	Urgroßmutter
urgroßväter	noun	Urgroßvater
urinals	noun	Urinal
urinale	noun	Urinal
vaters	noun	Vater
vasallen	noun	Vasall
vektoren	noun	Vektor
vektors	noun	Vektor
vampirs	noun	Vampir
vampires	noun	Vampir
vegetariers	noun	Vegetarier
veganers	noun	Veganer
variationen	noun	Variation
variablen	noun	Variable
ventile	noun	Ventil
ventilators	noun	Ventilator
ventils	noun	Ventil
varietés	noun	Varieté
vandalismen	noun	Vandalismus
verlage	noun	Verlag
waren	noun	Ware
weiße	noun	Weißer
spinne	verb	spinnen
pinguins	noun	Pinguin
auges	noun	Auge
sanders	noun	Sander
erwachsener	noun	Erwachsene
erwachsene	noun	Erwachsener
faches	noun	Fach
armbands	noun	Armband
bilds	noun	Bild
märtyrers	noun	Märtyrer
glases	noun	Glas
ösen	noun	Öse
überträgers	noun	Überträger
äquators	noun	Äquator
äthiopiens	noun	Äthiopien
œuvres	noun	Œuvre
zwecks	noun	Zweck
zonis	noun	Zoni
zollvereins	noun	Zollverein
zusammenstöße	noun	Zusammenstoß
zwiebacks	noun	Zwieback
zooms	noun	Zoom
zoos	noun	Zoo
zünders	noun	Zünder
namens	noun	Name
sättel	noun	Sattel
kantinen	noun	Kantine
optiken	noun	Optik
thailänders	noun	Thailänder
titels	noun	Titel
glaube	verb	glauben
staats	noun	Staat
iglus	noun	Iglu
reife	noun	Reif
unterdrücke	noun	Unterdruck
spanners	noun	Spanner
mundharmonikas	noun	Mundharmonika
akkordeons	noun	Akkordeon
blasinstruments	noun	Blasinstrument
balalaikas	noun	Balalaika
klavieres	noun	Klavier
cellos	noun	Cello
glockenspiels	noun	Glockenspiel
orgeln	noun	Orgel
saxofones	noun	Saxofon
saxofons	noun	Saxofon
triangeln	noun	Triangel
violinen	noun	Violine
zithern	noun	Zither
accessoires	noun	Accessoire
abonnements	noun	Abonnement
abos	noun	Abo
achats	noun	Achat
achates	noun	Achat
achate	noun	Achat
obduktionen	noun	Obduktion
lasers	noun	Laser
lassos	noun	Lasso
lasters	noun	Laster
lasten	noun	Last
lamms	noun	Lamm
gaben	noun	Gabe
gagen	noun	Gage
gangsters	noun	Gangster
garagen	noun	Garage
gefahren	noun	Gefahr
garderoben	noun	Garderobe
garben	noun	Garbe
garnisonen	noun	Garnison
renten	noun	Rente
losts	noun	Lost
maße	noun	Maß
mäße	verb	messen
masken	noun	Maske
stiefväter	noun	Stiefvater
stiefbrüder	noun	Stiefbruder
statistiken	noun	Statistik
kassen	noun	Kasse
klöster	noun	Kloster
serien	noun	Serie
lifte	noun	Lift
liftes	noun	Lift
republiken	noun	Republik
verlören	verb	verlieren
dependancen	noun	Dependance
dépendance	noun	Dependance
dépendancen	noun	Dépendance
dekans	noun	Dekan
demografien	noun	Demografie
dildos	noun	Dildo
eiben	noun	Eibe
elegien	noun	Elegie
mandats	noun	Mandat
mandates	noun	Mandat
metonymien	noun	Metonymie
narwals	noun	Narwal
nationalparks	noun	Nationalpark
pontons	noun	Ponton
stabilisators	noun	Stabilisator
stabilisatoren	noun	Stabilisator
basen	noun	Base
basen	noun	Basis
sämlings	noun	Sämling
temperaturen	noun	Temperatur
temperaments	noun	Temperament
taten	noun	Tat
tempels	noun	Tempel
tempos	noun	Tempo
tempi	noun	Tempo
tachometers	noun	Tachometer
tachos	noun	Tacho
tabletten	noun	Tablette
tablettes	noun	Tablett
tabus	noun	Tabu
tabellen	noun	Tabelle
tagträume	noun	Tagtraum
taxis	noun	Taxi
tals	noun	Tal
talente	noun	Talent
talents	noun	Talent
talers	noun	Taler
talismans	noun	Talisman
terrains	noun	Terrain
terpentins	noun	Terpentin
tees	noun	Tee
termines	noun	Termin
termins	noun	Termin
tenors	noun	Tenor
tenöre	noun	Tenor
teilnahmen	noun	Teilnahme
teils	noun	Teil
theologien	noun	Theologie
telefones	noun	Telefon
telefaxes	noun	Telefax
teints	noun	Teint
telefons	noun	Telefon
tampons	noun	Tampon
tante-emma-läden	noun	Tante-Emma-Laden
teleskops	noun	Teleskop
telexe	noun	Telex
tellers	noun	Teller
telexes	noun	Telex
theoreme	noun	Theorem
theaters	noun	Theater
thäler	noun	Thal
theorems	noun	Theorem
themas	noun	Thema
tangenten	noun	Tangente
tangos	noun	Tango
tannen	noun	Tanne
thermometers	noun	Thermometer
thermoskannen	noun	Thermoskanne
thermostats	noun	Thermostat
tiden	noun	Tide
tiefen	noun	Tiefe
tigers	noun	Tiger
timbres	noun	Timbre
tipis	noun	Tipi
titanen	noun	Titan
tobaks	noun	Tobak
todes	noun	Tod
tode	noun	Tod
toiletten	noun	Toilette
tomahawks	noun	Tomahawk
tones	noun	Ton
töne	noun	Ton
topologien	noun	Topologie
toponyme	noun	Toponym
toponyms	noun	Toponym
tors	noun	Tor
tores	noun	Tor
toren	noun	Tor
torpedos	noun	Torpedo
torten	noun	Torte
torturen	noun	Tortur
tori	noun	Torus
totenkopfs	noun	Totenkopf
transvestiten	noun	Transvestit
transports	noun	Transport
transportes	noun	Transport
transporte	noun	Transport
traumas	noun	Trauma
treckers	noun	Trecker
traumen	noun	Trauma
treffens	noun	Treffen
massagen	noun	Massage
machers	noun	Macher
macheten	noun	Machete
mangels	noun	Mangel
mängel	noun	Mangel
mangeln	noun	Mangel
mangolds	noun	Mangold
manifests	noun	Manifest
manifeste	noun	Manifest
mafias	noun	Mafia
maden	noun	Made
masseurs	noun	Masseur
matineen	noun	Matinee
matrosen	noun	Matrose
manövers	noun	Manöver
maracujas	noun	Maracuja
mantels	noun	Mantel
mäntel	noun	Mantel
manuale	noun	Manual
marathons	noun	Marathon
manuals	noun	Manual
manuales	noun	Manual
mannequins	noun	Mannequin
materials	noun	Material
markts	noun	Markt
marktes	noun	Markt
markisen	noun	Markise
maximums	noun	Maximum
marschs	noun	Marsch
missverständnisse	noun	Missverständnis
missverständnisses	noun	Missverständnis
verkäufe	noun	Verkauf
versuche	noun	Versuch
verhöre	noun	Verhör
rollen	noun	Rolle
alkalimetalls	noun	Alkalimetall
walds	noun	Wald
sargs	noun	Sarg
sarges	noun	Sarg
epidemien	noun	Epidemie
gaus	noun	Gau
gaue	noun	Gau
salzes	noun	Salz
nagels	noun	Nagel
haars	noun	Haar
hacks	noun	Hack
hacken	noun	Hacke
häfen	noun	Hafen
hadrons	noun	Hadron
hadronen	noun	Hadron
hais	noun	Hai
haies	noun	Hai
haie	noun	Hai
haines	noun	Hain
hakens	noun	Haken
hains	noun	Hain
halls	noun	Hall
hamsters	noun	Hamster
handbremsen	noun	Handbremse
handgranaten	noun	Handgranate
handlangers	noun	Handlanger
winzers	noun	Winzer
marzipans	noun	Marzipan
apfelstrudels	noun	Apfelstrudel
nougats	noun	Nougat
schokoladen	noun	Schokolade
puddings	noun	Pudding
musikinstruments	noun	Musikinstrument
instrumentes	noun	Instrument
bratschen	noun	Bratsche
acids	noun	Acid
rockes	noun	Rock
perioden	noun	Periode
paradigmas	noun	Paradigma
paradiesäpfel	noun	Paradiesapfel
parameters	noun	Parameter
parallelogramme	noun	Parallelogramm
parasiten	noun	Parasit
terminologien	noun	Terminologie
palästinensers	noun	Palästinenser
palindrome	noun	Palindrom
palindroms	noun	Palindrom
palindromes	noun	Palindrom
bekannten	noun	Bekannte
brisen	noun	Brise
pedals	noun	Pedal
pedale	noun	Pedal
perfektionisten	noun	Perfektionist
passagiers	noun	Passagier
passanten	noun	Passant
pensionäre	noun	Pensionär
pensionen	noun	Pension
penners	noun	Penner
pentagrammes	noun	Pentagramm
pentagramme	noun	Pentagramm
pendels	noun	Pendel
facebooks	noun	Facebook
lebenswelten	noun	Lebenswelt
laboratoriums	noun	Laboratorium
lehren	noun	Lehre
leids	noun	Leid
leides	noun	Leid
leisten	noun	Leiste
leitfäden	noun	Leitfaden
leitmotivs	noun	Leitmotiv
lenden	noun	Lende
lektionen	noun	Lektion
lemmings	noun	Lemming
lemuren	noun	Lemur
lemuren	noun	Lemure
lenze	noun	Lenz
lesben	noun	Lesbe
lesers	noun	Leser
lettern	noun	Letter
leptons	noun	Lepton
leptonen	noun	Lepton
landminen	noun	Landmine
transparents	noun	Transparent
transparentes	noun	Transparent
transparente	noun	Transparent
tribunals	noun	Tribunal
tribunales	noun	Tribunal
tribünen	noun	Tribüne
tribunale	noun	Tribunal
transaktionen	noun	Transaktion
transistors	noun	Transistor
triumphbögen	noun	Triumphbogen
turms	noun	Turm
turners	noun	Turner
trogs	noun	Trog
tröge	noun	Trog
verses	noun	Vers
versen	noun	Vers
baders	noun	Bader
tukans	noun	Tukan
detektoren	noun	Detektor
scheiden	noun	Scheide
speisen	noun	Speise
esquimo	noun	Eskimo
stimmen	noun	Stimme
korrespondenten	noun	Korrespondent
wiederwahlen	noun	Wiederwahl
proteste	noun	Protest
rates	noun	Rat
kommst	verb	kommen
demonstranten	noun	Demonstrant
demonstrationen	noun	Demonstration
sägen	noun	Säge
absagen	noun	Absage
versuchen	noun	Versuch
entwürfe	noun	Entwurf
lagers	noun	Lager
wortes	noun	Wort
worts	noun	Wort
claqueurs	noun	Claqueur
kapellmeisters	noun	Kapellmeister
kanten	noun	Kante
würden	noun	Würde
beschiß	noun	Beschiss
lunten	noun	Lunte
lösungen	noun	Lösung
libellen	noun	Libelle
ladens	noun	Laden
lakens	noun	Laken
letten	noun	Lette
konstellationen	noun	Konstellation
guppys	noun	Guppy
defilees	noun	Defilee
energien	noun	Energie
chlorids	noun	Chlorid
chloride	noun	Chlorid
medien	noun	Medium
schi	noun	Ski
quantums	noun	Quantum
quarkoniums	noun	Quarkonium
quartale	noun	Quartal
quartiers	noun	Quartier
quartales	noun	Quartal
quasars	noun	Quasar
rapporte	noun	Rapport
rappers	noun	Rapper
rapports	noun	Rapport
rapportes	noun	Rapport
radars	noun	Radar
radare	noun	Radar
rasuren	noun	Rasur
ranken	noun	Ranke
rallyes	noun	Rallye
raffinaden	noun	Raffinade
ragouts	noun	Ragout
realisten	noun	Realist
reaktoren	noun	Reaktor
gebräuche	noun	Gebrauch
gebärmütter	noun	Gebärmutter
gasmasken	noun	Gasmaske
skorpionen	noun	Skorpion
chauvinisten	noun	Chauvinist
komponisten	noun	Komponist
popos	noun	Popo
löcher	noun	Loch
lochs	noun	Loch
loches	noun	Loch
monopole	noun	Monopol
kanals	noun	Kanal
watvögel	noun	Watvogel
kiefern	noun	Kiefer
homos	noun	Homo
kiele	noun	Kiel
benzols	noun	Benzol
esten	noun	Este
himmels	noun	Himmel
gesellschaften	noun	Gesellschaft
puzzles	noun	Puzzle
flanken	noun	Flanke
hörner	noun	Horn
insekts	noun	Insekt
schmeißfliegen	noun	Schmeißfliege
krebsen	noun	Krebs
solen	noun	Sole
jungens	noun	Junge
wallen	noun	Wall
sorgen	noun	Sorge
dritten	numeral	dritte
aake	noun	Aak
aktivs	noun	Aktiv
aktive	noun	Aktiv
amarettos	noun	Amaretto
amaretti	noun	Amaretto
jollen	noun	Jolle
abakas	noun	Abaka
attributs	noun	Attribut
barben	noun	Barbe
grenaders	noun	Grenader
gyroskops	noun	Gyroskop
renegaten	noun	Renegat
resultats	noun	Resultat
fürze	noun	Furz
furzes	noun	Furz
konfirmationen	noun	Konfirmation
hefts	noun	Heft
glücks	noun	Glück
computers	noun	Computer
kurse	noun	Kurs
arien	noun	Arie
bagels	noun	Bagel
biotope	noun	Biotop
malers	noun	Maler
sacks	noun	Sack
rucksacks	noun	Rucksack
schwiegermütter	noun	Schwiegermutter
plattformen	noun	Plattform
rutschen	noun	Rutsche
chirurgien	noun	Chirurgie
dystopien	noun	Dystopie
windes	noun	Wind
kleiderschranken	noun	Kleiderschrank
stämme	noun	Stamm
lederhosen	noun	Lederhose
päderasten	noun	Päderast
erdäpfel	noun	Erdapfel
muskats	noun	Muskat
bewußtsein	noun	Bewusstsein
nöte	noun	Not
lachen	noun	Lache
bewußtseins	noun	Bewußtsein
cineasten	noun	Cineast
klos	noun	Klo
malze	noun	Malz
reformen	noun	Reform
wälle	noun	Wall
wies	verb	weisen
wodkas	noun	Wodka
paars	noun	Paar
pastillen	noun	Pastille
pasten	noun	Paste
pastoren	noun	Pastor
paten	noun	Pate
patents	noun	Patent
patentes	noun	Patent
patienten	noun	Patient
patinas	noun	Patina
patrons	noun	Patron
patrioten	noun	Patriot
pavillons	noun	Pavillon
peitschen	noun	Peitsche
parolen	noun	Parole
partisanen	noun	Partisan
paraden	noun	Parade
pipetten	noun	Pipette
pessimisten	noun	Pessimist
pioniere	noun	Pionier
piraten	noun	Pirat
permutationen	noun	Permutation
perspektiven	noun	Perspektive
planetariums	noun	Planetarium
planetoiden	noun	Planetoid
plomben	noun	Plombe
portale	noun	Portal
professors	noun	Professor
professoren	noun	Professor
premieren	noun	Premiere
protagonisten	noun	Protagonist
punkers	noun	Punker
protonen	noun	Proton
protons	noun	Proton
pupillen	noun	Pupille
präpositionen	noun	Präposition
reisen	noun	Reise
reste	noun	Rest
rituale	noun	Ritual
relationen	noun	Relation
relikte	noun	Relikt
rüden	noun	Rüde
sardinen	noun	Sardine
satelliten	noun	Satellit
niederschläge	noun	Niederschlag
organellen	noun	Organelle
organe	noun	Organ
organisationen	noun	Organisation
organismen	noun	Organismus
pheromone	noun	Pheromon
phänomene	noun	Phänomen
polymere	noun	Polymer
plattenläden	noun	Plattenladen
polacken	noun	Polacke
pseudonyme	noun	Pseudonym
prototypen	noun	Prototyp
rebellen	noun	Rebell
reportagen	noun	Reportage
parvenüs	noun	Parvenü
ficke	verb	ficken
mengen	noun	Menge
hälften	noun	Hälfte
schlagt	verb	schlagen
schlag	verb	schlagen
schläge	noun	Schlag
erektionen	noun	Erektion
geishas	noun	Geisha
genossen	noun	Genosse
skandale	noun	Skandal
traditionen	noun	Tradition
toupets	noun	Toupet
trachten	noun	Tracht
tricks	noun	Trick
lineale	noun	Lineal
linden	noun	Linde
argumente	noun	Argument
dachschäden	noun	Dachschaden
cabriolets	noun	Cabriolet
cafés	noun	Café
chancen	noun	Chance
champignons	noun	Champignon
cappuccinos	noun	Cappuccino
canyons	noun	Canyon
charakteristika	noun	Charakteristikum
chefs	noun	Chef
chiffren	noun	Chiffre
chilenen	noun	Chilene
chöre	noun	Chor
cliquen	noun	Clique
clous	noun	Clou
colas	noun	Cola
coupés	noun	Coupé
coupons	noun	Coupon
coups	noun	Coup
colliers	noun	Collier
cocktails	noun	Cocktail
cremes	noun	Creme
crescendos	noun	Crescendo
bagagen	noun	Bagage
baissen	noun	Baisse
balancen	noun	Balance
ballaste	noun	Ballast
basare	noun	Basar
beile	noun	Beil
bassins	noun	Bassin
ballons	noun	Ballon
baguettes	noun	Baguette
belege	noun	Beleg
benze	noun	Benz
benzole	noun	Benzol
bikinis	noun	Bikini
birnbaüme	noun	Birnbaum
biologen	noun	Biologe
blusen	noun	Bluse
böcke	noun	Bock
bombardements	noun	Bombardement
bonobos	noun	Bonobo
bräuche	noun	Brauch
brezen	noun	Breze
brigaden	noun	Brigade
brillanten	noun	Brillant
brüche	noun	Bruch
bruderschaften	noun	Bruderschaft
buben	noun	Bube
brutkästen	noun	Brutkasten
bünde	noun	Bund
burgen	noun	Burg
böen	noun	Bö
bürden	noun	Bürde
auszählungen	noun	Auszählung
aussagen	noun	Aussage
atolle	noun	Atoll
assis	noun	Assi
appelle	noun	Appell
apokalypsen	noun	Apokalypse
antilopen	noun	Antilope
anstöße	noun	Anstoß
aborte	noun	Abort
daumennägel	noun	Daumennagel
deckmäntel	noun	Deckmantel
defekte	noun	Defekt
definitionen	noun	Definition
demagogen	noun	Demagoge
dokumente	noun	Dokument
drohnen	noun	Drohne
journale	noun	Journal
diskussionen	noun	Diskussion
dioden	noun	Diode
dissidenten	noun	Dissident
druiden	noun	Druide
dämonen	noun	Dämon
dänen	noun	Däne
doktoren	noun	Doktor
dünen	noun	Düne
dürren	noun	Dürre
einfälle	noun	Einfall
ellipsen	noun	Ellipse
emulsionen	noun	Emulsion
etiketten	noun	Etikett
expeditionen	noun	Expedition
experimente	noun	Experiment
experten	noun	Experte
expertisen	noun	Expertise
erlen	noun	Erle
elektronen	noun	Elektron
erfolge	noun	Erfolg
geranien	noun	Geranie
generationen	noun	Generation
gladiatoren	noun	Gladiator
gouverneure	noun	Gouverneur
gräben	noun	Graben
granatäpfel	noun	Granatapfel
greise	noun	Greis
gräten	noun	Gräte
guillotinen	noun	Guillotine
gören	noun	Göre
gewinne	noun	Gewinn
glasuren	noun	Glasur
grillen	noun	Grille
gemeinschaften	noun	Gemeinschaft
grünschnäbel	noun	Grünschnabel
gäste	noun	Gast
raum-zeit	noun	Raumzeit
dichten	noun	Dichte
düsen	noun	Düse
bechers	noun	Becher
implosionen	noun	Implosion
informationen	noun	Information
inflationen	noun	Inflation
injektionen	noun	Injektion
initiativen	noun	Initiative
inspirationen	noun	Inspiration
integrationen	noun	Integration
intervalle	noun	Intervall
isotope	noun	Isotop
irrgärten	noun	Irrgarten
intrigen	noun	Intrige
internate	noun	Internat
interaktionen	noun	Interaktion
kombinationen	noun	Kombination
kolumnen	noun	Kolumne
kolonien	noun	Kolonie
kolonnen	noun	Kolonne
kommentatoren	noun	Kommentator
konditoren	noun	Konditor
komponenten	noun	Komponente
kompositionen	noun	Komposition
kompressen	noun	Kompresse
kompromisse	noun	Kompromiss
kondensatoren	noun	Kondensator
konjunktionen	noun	Konjunktion
konjunkturen	noun	Konjunktur
konkurrenten	noun	Konkurrent
komparative	noun	Komparativ
kollektive	noun	Kollektiv
konventionen	noun	Konvention
kontroversen	noun	Kontroverse
kontinente	noun	Kontinent
kontakte	noun	Kontakt
konsuln	noun	Konsul
konstruktionen	noun	Konstruktion
konsumenten	noun	Konsument
mäuler	noun	Maul
körbe	noun	Korb
kurbeln	noun	Kurbel
küsten	noun	Küste
kronen	noun	Krone
krallen	noun	Kralle
klingen	noun	Klinge
klinken	noun	Klinke
klippen	noun	Klippe
klauen	noun	Klaue
klappen	noun	Klappe
kisten	noun	Kiste
kippen	noun	Kippe
flossen	noun	Flosse
quarze	noun	Quarz
turbinen	noun	Turbine
bojen	noun	Boje
stechäpfel	noun	Stechapfel
bißchen	adverb	bisschen
boykotte	noun	Boykott
aftershaves	noun	Aftershave
verdächtige	noun	Verdächtiger
verbote	noun	Verbot
visionäre	noun	Visionär
vitamine	noun	Vitamin
vitrinen	noun	Vitrine
vorhersagen	noun	Vorhersage
vorschläge	noun	Vorschlag
wallfahrten	noun	Wallfahrt
waschbären	noun	Waschbär
welpen	noun	Welpe
widerrufe	noun	Widerruf
wintergärten	noun	Wintergarten
zinnen	noun	Zinne
zucchinis	noun	Zucchini
zusagen	noun	Zusage
kapos	noun	Kapo
jachten	noun	Jacht
impulse	noun	Impuls
illustrationen	noun	Illustration
illusionen	noun	Illusion
ideologien	noun	Ideologie
ignoranten	noun	Ignorant
immigranten	noun	Immigrant
infixe	noun	Infix
intriganten	noun	Intrigant
investoren	noun	Investor
harpunen	noun	Harpune
harmonien	noun	Harmonie
ruten	noun	Rute
häute	noun	Haut
verstecke	noun	Versteck
vereine	noun	Verein
abschnitte	noun	Abschnitt
ampullen	noun	Ampulle
ansätze	noun	Ansatz
ansatzes	noun	Ansatz
adjektive	noun	Adjektiv
adjektivs	noun	Adjektiv
apotheken	noun	Apotheke
aussprachen	noun	Aussprache
büchsen	noun	Büchse
buchten	noun	Bucht
bürsten	noun	Bürste
buden	noun	Bude
brauen	noun	Braue
borsten	noun	Borste
diskursanalysen	noun	Diskursanalyse
kathedralen	noun	Kathedrale
kategorien	noun	Kategorie
kiemen	noun	Kieme
kioske	noun	Kiosk
galagos	noun	Galago
klassifikationen	noun	Klassifikation
knuten	noun	Knute
motivs	noun	Motiv
kommunikationen	noun	Kommunikation
etappen	noun	Etappe
etagen	noun	Etage
evangelien	noun	Evangelium
eskorten	noun	Eskorte
exporte	noun	Export
erträge	noun	Ertrag
fluppen	noun	Fluppe
fotografen	noun	Fotograf
fotografien	noun	Fotografie
fragmente	noun	Fragment
fregatten	noun	Fregatte
foren	noun	Forum
fragebögen	noun	Fragebogen
fuchsien	noun	Fuchsie
fußbälle	noun	Fußball
forderungen	noun	Forderung
folgen	noun	Folge
fuhren	noun	Fuhre
fugen	noun	Fuge
flächen	noun	Fläche
flechten	noun	Flechte
glieder	noun	Glied
kartografen	noun	Kartograf
klingeln	noun	Klingel
kopien	noun	Kopie
korrelationen	noun	Korrelation
korrekturen	noun	Korrektur
kosmonauten	noun	Kosmonaut
kusinen	noun	Kusine
kardiologen	noun	Kardiologe
kathoden	noun	Kathode
klagen	noun	Klage
kreaturen	noun	Kreatur
schränke	noun	Schrank
schranken	noun	Schranke
kutten	noun	Kutte
linsen	noun	Linse
linien	noun	Linie
limonaden	noun	Limonade
lüste	noun	Lust
logen	noun	Loge
lokale	noun	Lokal
liegen	noun	Liege
linguisten	noun	Linguist
luken	noun	Luke
längen	noun	Länge
wege	noun	Weg
exoplaneten	noun	Exoplanet
konstanten	noun	Konstante
glotzen	noun	Glotze
labore	noun	Labor
lilien	noun	Lilie
liturgien	noun	Liturgie
lungen	noun	Lunge
losungen	noun	Losung
lehnen	noun	Lehne
orgasmen	noun	Orgasmus
opale	noun	Opal
wachen	noun	Wache
visiere	noun	Visier
verbände	noun	Verband
volontäre	noun	Volontär
sandalen	noun	Sandale
satiren	noun	Satire
schaben	noun	Schabe
schamanen	noun	Schamane
schäfte	noun	Schaft
schnäbel	noun	Schnabel
native speakers	noun	native speaker
salven	noun	Salve
schnüre	noun	Schnur
schurken	noun	Schurke
schwiegertöchter	noun	Schwiegertochter
schützen	noun	Schütze
schützen	noun	Schütz
segmente	noun	Segment
sachschäden	noun	Sachschaden
savannen	noun	Savanne
schützengräben	noun	Schützengraben
seismogramme	noun	Seismogramm
sensoren	noun	Sensor
silben	noun	Silbe
sirenen	noun	Sirene
skalare	noun	Skalar
skulpturen	noun	Skulptur
sonden	noun	Sonde
sonaten	noun	Sonate
spenden	noun	Spende
museums	noun	Museum
liebhaben	verb	lieb haben
eids	noun	Eid
küssen	noun	Kuss
nachfragen	noun	Nachfrage
neonazis	noun	Neonazi
neutronen	noun	Neutron
nieren	noun	Niere
nonnen	noun	Nonne
nieten	noun	Niete
notare	noun	Notar
normen	noun	Norm
nomenklaturen	noun	Nomenklatur
nissen	noun	Nisse
karrieren	noun	Karriere
kassetten	noun	Kassette
kasserollen	noun	Kasserolle
kitze	noun	Kitz
kollisionen	noun	Kollision
kommas	noun	Komma
kommissionen	noun	Kommission
kompensationen	noun	Kompensation
kommandos	noun	Kommando
konserven	noun	Konserve
kritiken	noun	Kritik
divisionen	noun	Division
domänen	noun	Domäne
dronten	noun	Dronte
idiome	noun	Idiom
konfrontationen	noun	Konfrontation
kurven	noun	Kurve
knüppels	noun	Knüppel
oliven	noun	Olive
piloten	noun	Pilot
predigten	noun	Predigt
preise	noun	Preis
positionen	noun	Position
produktionen	noun	Produktion
prognosen	noun	Prognose
propheten	noun	Prophet
proportionen	noun	Proportion
proteine	noun	Protein
psychosen	noun	Psychose
psychologen	noun	Psychologe
psychotherapeuten	noun	Psychotherapeut
pädagogen	noun	Pädagoge
platanen	noun	Platane
puffmütter	noun	Puffmutter
pulsare	noun	Pulsar
pläne	noun	Plan
reißnägel	noun	Reißnagel
rekonstruktionen	noun	Rekonstruktion
resolutionen	noun	Resolution
rotationen	noun	Rotation
remouladen	noun	Remoulade
revolten	noun	Revolte
rivalen	noun	Rivale
rouladen	noun	Roulade
roth	adjective	rot
färsen	noun	Färse
elektroden	noun	Elektrode
kannen	noun	Kanne
kamele	noun	Kamel
ehen	noun	Ehe
fanfaren	noun	Fanfare
fasane	noun	Fasan
kalorien	noun	Kalorie
kapseln	noun	Kapsel
mikroskope	noun	Mikroskop
vorträge	noun	Vortrag
wunderkinder	noun	Wunderkind
perlen	noun	Perle
dogmen	noun	Dogma
farmen	noun	Farm
folien	noun	Folie
fußabdrücke	noun	Fußabdruck
förderungen	noun	Förderung
flotten	noun	Flotte
fronten	noun	Front
pickelhauben	noun	Pickelhaube
prisen	noun	Prise
promenaden	noun	Promenade
illustratoren	noun	Illustrator
atzen	noun	Atze
xis	noun	Xi
bergfinken	noun	Bergfink
briten	noun	Brite
chimären	noun	Chimäre
dinge	noun	Ding
erbinnen	noun	Erbin
favoriten	noun	Favorit
fensterläden	noun	Fensterladen
filtrate	noun	Filtrat
fließbänder	noun	Fließband
fluchten	noun	Flucht
fundamentalisten	noun	Fundamentalist
frakturen	noun	Fraktur
fusionen	noun	Fusion
filialen	noun	Filiale
formulare	noun	Formular
formeln	noun	Formel
flughäfen	noun	Flughafen
grotten	noun	Grotte
größenordnungen	noun	Größenordnung
halbbrüder	noun	Halbbruder
heime	noun	Heim
hinterköpfe	noun	Hinterkopf
hydrate	noun	Hydrat
herzöge	noun	Herzog
kapitulationen	noun	Kapitulation
kapellen	noun	Kapelle
kameraden	noun	Kamerad
kämme	noun	Kamm
magneten	noun	Magnet
mägen	noun	Magen
megafone	noun	Megafon
megaphone	noun	Megaphon
meteorologen	noun	Meteorologe
methoden	noun	Methode
missbräuche	noun	Missbrauch
mißverständnisse	noun	Mißverständnis
momente	noun	Moment
motorsägen	noun	Motorsäge
münder	noun	Mund
mutationen	noun	Mutation
regenmäntel	noun	Regenmantel
signale	noun	Signal
plasmen	noun	Plasma
posen	noun	Pose
ruinen	noun	Ruine
schwiegerväter	noun	Schwiegervater
sekrete	noun	Sekret
serpentinen	noun	Serpentine
synagogen	noun	Synagoge
sturmvögel	noun	Sturmvogel
strukturen	noun	Struktur
summen	noun	Summe
sultanate	noun	Sultanat
streiche	noun	Streich
straßenbahnen	noun	Straßenbahn
suiten	noun	Suite
studenten	noun	Student
spritzen	noun	Spritze
spuren	noun	Spur
stümpfe	noun	Stumpf
striche	noun	Strich
stöße	noun	Stoß
stolpersteine	noun	Stolperstein
strategien	noun	Strategie
steppen	noun	Steppe
statuen	noun	Statue
stiefmütter	noun	Stiefmutter
stieftöchter	noun	Stieftochter
stände	noun	Stand
standarten	noun	Standarte
stangen	noun	Stange
werte	noun	Wert
souveräne	noun	Souverän
suffixe	noun	Suffix
sängerinnen	noun	Sängerin
symbole	noun	Symbol
stützen	noun	Stütze
strecken	noun	Strecke
sippen	noun	Sippe
sehnen	noun	Sehne
schollen	noun	Scholle
schoten	noun	Schote
schrauben	noun	Schraube
hufe	noun	Huf
horte	noun	Hort
regents	noun	Regent
dummkopfs	noun	Dummkopf
spiels	noun	Spiel
führers	noun	Führer
antisemiten	noun	Antisemit
anklagen	noun	Anklage
lexikografen	noun	Lexikograf
lkws	noun	LKW
margarinen	noun	Margarine
margen	noun	Marge
milieus	noun	Milieu
metten	noun	Mette
mundwässer	noun	Mundwasser
marken	noun	Marke
marken	noun	Mark
talwege	noun	Talweg
tunten	noun	Tunte
büsten	noun	Büste
ringers	noun	Ringer
orang-utans	noun	Orang-Utan
orchestergräben	noun	Orchestergraben
pressen	noun	Presse
parodien	noun	Parodie
dumme-jungen-streiche	noun	Dumme-Jungen-Streich
dummejungenstreiche	noun	Dummejungenstreich
grafen	noun	Graf
gardinen	noun	Gardine
abrisses	noun	Abriss
abrisse	noun	Abriss
yaks	noun	Yak
eingaben	noun	Eingabe
barometers	noun	Barometer
weißwürste	noun	Weißwurst
weißstörche	noun	Weißstorch
weissstörche	noun	Weissstorch
weiten	noun	Weite
wenden	noun	Wende
weltanschauungen	noun	Weltanschauung
wetten	noun	Wette
wiegen	noun	Wiege
reklamen	noun	Reklame
theologen	noun	Theologe
ethnologen	noun	Ethnologe
röstis	noun	Rösti
sprößlings	noun	Sprößling
sprößlinge	noun	Sprößling
ringfingers	noun	Ringfinger
ekstasen	noun	Ekstase
embargos	noun	Embargo
emigrationen	noun	Emigration
enteriche	noun	Enterich
epigramme	noun	Epigramm
fressen	noun	Fresse
piken	noun	Pike
prärien	noun	Prärie
psychen	noun	Psyche
potenziale	noun	Potenzial
potentiale	noun	Potential
dramaturgien	noun	Dramaturgie
distributionen	noun	Distribution
dolden	noun	Dolde
dialoge	noun	Dialog
aasvögel	noun	Aasvogel
fabrikanten	noun	Fabrikant
fäden	noun	Faden
xylophone	noun	Xylophon
walzen	noun	Walze
wangen	noun	Wange
servietten	noun	Serviette
sponsoren	noun	Sponsor
sukkulenten	noun	Sukkulente
erben	noun	Erbe
crèmes fraîches	noun	Crème fraîche
grammatiken	noun	Grammatik
moden	noun	Mode
bibeln	noun	Bibel
blenden	noun	Blende
backöfen	noun	Backofen
attachés	noun	Attaché
abdrücke	noun	Abdruck
pantoffels	noun	Pantoffel
pantoffeln	noun	Pantoffel
stimuli	noun	Stimulus
tremas	noun	Trema
tremata	noun	Trema
extrema	noun	Extremum
fenneks	noun	Fennek
barbier	verb	barbieren
austenite	noun	Austenit
sauerbratens	noun	Sauerbraten
forts	noun	Fort
aromen	noun	Aroma
auguren	noun	Augur
autodidakten	noun	Autodidakt
barken	noun	Bark
beträge	noun	Betrag
brände	noun	Brand
faxe	noun	Fax
flöße	noun	Floß
flamen	noun	Flame
ponys	noun	Pony
pythons	noun	Python
räte	noun	Rat
rumänen	noun	Rumäne
reize	noun	Reiz
rentiere	noun	Rentier
reime	noun	Reim
notfalls	noun	Notfall
riten	noun	Ritus
rösser	noun	Ross
schemata	noun	Schema
ströme	noun	Strom
volks	noun	Volk
nationen	noun	Nation
feilte	verb	feilen
wanderers	noun	Wanderer
tannenbaums	noun	Tannenbaum
tannenbäume	noun	Tannenbaum
jongleurs	noun	Jongleur
vereist	verb	vereisen
infrastrukturen	noun	Infrastruktur
interviews	noun	Interview
implantate	noun	Implantat
igels	noun	Igel
historikers	noun	Historiker
menüs	noun	Menü
monitore	noun	Monitor
kremen	verb	cremen
bosse	noun	Boss
frasse	noun	Frass
belieft	verb	belaufen
fürsten	noun	Fürst
strudels	noun	Strudel
knappen	noun	Knappe
aldehyds	noun	Aldehyd
aldehyde	noun	Aldehyd
ketons	noun	Keton
ketone	noun	Keton
litfaßsäulen	noun	Litfaßsäule
ligen	noun	Liga
loks	noun	Lok
kannibalen	noun	Kannibale
kinos	noun	Kino
kuriosa	noun	Kuriosum
incubi	noun	Incubus
grapefruits	noun	Grapefruit
gnus	noun	Gnu
guerillas	noun	Guerilla
gurus	noun	Guru
gesässe	noun	Gesäss
gesäße	noun	Gesäß
genies	noun	Genie
ghettos	noun	Ghetto
gettos	noun	Getto
herbergen	noun	Herberge
hippies	noun	Hippie
flamingos	noun	Flamingo
faktoren	noun	Faktor
beging	verb	begehen
beginge	verb	begehen
fraßes	noun	Fraß
arrangements	noun	Arrangement
bademäntel	noun	Bademantel
bonmots	noun	Bonmot
bulletins	noun	Bulletin
bistros	noun	Bistro
kommandanten	noun	Kommandant
traumata	noun	Trauma
tyrannen	noun	Tyrann
tussis	noun	Tussi
trips	noun	Trip
betrüge	noun	Betrug
doktrinen	noun	Doktrin
diastolen	noun	Diastole
epiloge	noun	Epilog
fungizide	noun	Fungizid
hobbits	noun	Hobbit
imame	noun	Imam
ip-adressen	noun	IP-Adresse
kadetten	noun	Kadett
mineralwässer	noun	Mineralwasser
buchsen	noun	Buchse
majonäsen	noun	Majonäse
schienen	noun	Schiene
schichten	noun	Schicht
strassenbahnen	noun	Strassenbahn
störe	noun	Stör
wehren	noun	Wehr
yperite	noun	Yperit
rosses	noun	Ross
rosse	noun	Ross
subversionen	noun	Subversion
stalkers	noun	Stalker
tranks	noun	Trank
tränke	noun	Trank
abfragen	noun	Abfrage
pieke	verb	pieken
giere	verb	gieren
giert	verb	gieren
autonomien	noun	Autonomie
queues	noun	Queue
billards	noun	Billard
wene	pronoun	wer
nasals	noun	Nasal
nasale	noun	Nasal
qualitätsweins	noun	Qualitätswein
junkies	noun	Junkie
fänge	noun	Fang
dioxide	noun	Dioxid
sichten	noun	Sicht
schwarten	noun	Schwarte
scharen	noun	Schar
schaufeln	noun	Schaufel
schaukeln	noun	Schaukel
schriften	noun	Schrift
schwächen	noun	Schwäche
kalkten	verb	kalken
kalkte	verb	kalken
kalkt	verb	kalken
befalls	noun	Befall
befalles	noun	Befall
größen	noun	Größe
grössen	noun	Grösse
gele	noun	Gel
hooligans	noun	Hooligan
integrale	noun	Integral
ikonen	noun	Ikone
irren	noun	Irre
kobras	noun	Kobra
marschen	noun	Marsch
buchläden	noun	Buchladen
buren	noun	Bure
bürgen	noun	Bürge
kohlrabis	noun	Kohlrabi
kappen	noun	Kappe
kellen	noun	Kelle
krumen	noun	Krume
taufen	noun	Taufe
bulgaren	noun	Bulgare
breiten	noun	Breite
dynamos	noun	Dynamo
zuhause	adverb	zu Hause
silos	noun	Silo
haruspices	noun	Haruspex
medaillons	noun	Medaillon
mikroorganismen	noun	Mikroorganismus
mozzarellas	noun	Mozzarella
rollläden	noun	Rollladen
sarkasmen	noun	Sarkasmus
deinen	determiner	dein
luden	noun	Lude
spenders	noun	Spender
hyänen	noun	Hyäne
hüllen	noun	Hülle
hecken	noun	Hecke
herden	noun	Herde
hürden	noun	Hürde
indoiranischs	noun	Indoiranisch
plissees	noun	Plissee
reklamationen	noun	Reklamation
rupien	noun	Rupie
ränder	noun	Rand
reusen	noun	Reuse
rinds	noun	Rind
rufe	noun	Ruf
pannen	noun	Panne
puten	noun	Pute
positronen	noun	Positron
pokale	noun	Pokal
intellekts	noun	Intellekt
dogen	noun	Doge
kennenlernen	verb	kennen lernen
kroaten	noun	Kroate
künstlerromans	noun	Künstlerroman
künstlerromane	noun	Künstlerroman
gymnasiums	noun	Gymnasium
chilis	noun	Chili
helden	noun	Held
boulevards	noun	Boulevard
fagotte	noun	Fagott
fagotts	noun	Fagott
fagottes	noun	Fagott
fagottisten	noun	Fagottist
granden	noun	Grande
pinschers	noun	Pinscher
gehaltes	noun	Gehalt
schlappen	noun	Schlappe
dompteurs	noun	Dompteur
regens	noun	Regen
schuhcremes	noun	Schuhcreme
teeei	noun	Tee-Ei
teeeis	noun	Teeei
teeeies	noun	Teeei
teeeier	noun	Teeei
tee-eis	noun	Tee-Ei
tee-eies	noun	Tee-Ei
tee-eier	noun	Tee-Ei
hallelujas	noun	Halleluja
presslufthämmer	noun	Presslufthammer
glutens	noun	Gluten
schwemmen	noun	Schwemme
opals	noun	Opal
toastes	noun	Toast
toasts	noun	Toast
toaste	noun	Toast
iss	verb	essen
toasters	noun	Toaster
mobbings	noun	Mobbing
t-shirts	noun	T-Shirt
großteils	noun	Großteil
bosses	noun	Boss
fresken	noun	Fresko
fresken	noun	Freske
fallouts	noun	Fallout
jeeps	noun	Jeep
pepsins	noun	Pepsin
pepsine	noun	Pepsin
reeden	noun	Reede
pissers	noun	Pisser
rhododendrons	noun	Rhododendron
simulators	noun	Simulator
soprane	noun	Sopran
truppen	noun	Truppe
gründers	noun	Gründer
songs	noun	Song
francs	noun	Franc
lobbys	noun	Lobby
falles	noun	Fall
gangarten	noun	Gangart
regiments	noun	Regiment
fürbaß	adverb	fürbass
bloggers	noun	Blogger
posten	noun	Post
postens	noun	Posten
interregna	noun	Interregnum
interregnums	noun	Interregnum
isobare	noun	Isobar
isobaren	noun	Isobare
quorums	noun	Quorum
librettos	noun	Libretto
libretti	noun	Libretto
talibs	noun	Talib
altars	noun	Altar
altares	noun	Altar
ovare	noun	Ovar
sexsymbols	noun	Sexsymbol
trainings	noun	Training
obatzda	noun	Obazda
pinten	noun	Pinte
brühen	noun	Brühe
bäuche	noun	Bauch
bleche	noun	Blech
dominas	noun	Domina
dissense	noun	Dissens
epen	noun	Epos
etymologien	noun	Etymologie
harken	noun	Harke
hechte	noun	Hecht
helme	noun	Helm
proben	noun	Probe
eßstäbchen	noun	Essstäbchen
wannen	noun	Wanne
graue eminenzen	noun	Graue Eminenz
kacheln	noun	Kachel
klänge	noun	Klang
horizonte	noun	Horizont
animationen	noun	Animation
dossiers	noun	Dossier
eigennamen	noun	Eigenname
fönen	verb	föhnen
kommunen	noun	Kommune
eiscrème	noun	Eiscreme
fritüre	noun	Frittüre
ginko	noun	Ginkgo
karamel	noun	Karamell
communiqué	noun	Kommuniqué
crèmig	adjective	cremig
schuhcrème	noun	Schuhcreme
sonnencrème	noun	Sonnencreme
négligé	noun	Negligee
lobbies	noun	Lobby
babies	noun	Babys
babies	noun	Baby
parties	noun	Partys
parties	noun	Party
hot pants	noun	Hotpants
small talk	noun	Smalltalk
flash-back	noun	Flashback
güter	noun	Gut
gutes	noun	Gut
mensen	noun	Mensa
muskeln	noun	Muskel
myriaden	noun	Myriade
mollis	noun	Molli
nachhause	adverb	nach Hause
aufseiten	preposition	auf Seiten
auf seiten	preposition	auf Seiten
mit hilfe	preposition	mithilfe
zu gunsten	preposition	zugunsten
mops	noun	Mop
firewalls	noun	Firewall
jotas	noun	Jota
mets	noun	Met
metes	noun	Met
moren	noun	More
moren	noun	Mora
mohren	noun	Mohr
mienen	noun	Miene
minen	noun	Mine
liedes	noun	Lied
lides	noun	Lid
lids	noun	Lid
lider	noun	Lid
doublé	noun	Dublee
claims	noun	Claim
rabatts	noun	Rabatt
rabatte	noun	Rabatt
sphære	noun	Sphäre
kars	noun	Kar
nordens	noun	Norden
jubiläums	noun	Jubiläum
messen	noun	Messe
leime	noun	Leim
wcs	noun	WC
kiosks	noun	Kiosk
flugs	noun	Flug
voraussagen	noun	Voraussage
laiche	noun	Laich
betts	noun	Bett
bettes	noun	Bett
toten	noun	Toter
affenpinschers	noun	Affenpinscher
teers	noun	Teer
teere	noun	Teer
dirndls	noun	Dirndl
triebe	noun	Trieb
feste	noun	Fest
schwämme	noun	Schwamm
molken	noun	Molke
mullahs	noun	Mullah
monarchen	noun	Monarch
novellen	noun	Novelle
duelle	noun	Duell
digitalkameras	noun	Digitalkamera
derivate	noun	Derivat
eigenvektoren	noun	Eigenvektor
erden	noun	Erde
erwerbe	noun	Erwerb
einkäufe	noun	Einkauf
entnahmen	noun	Entnahme
äschen	noun	Äsche
enzyme	noun	Enzym
greifen	noun	Greif
albs	noun	Alb
albes	noun	Alb
kasernen	noun	Kaserne
mobiliare	noun	Mobiliar
giganten	noun	Gigant
galgens	noun	Galgen
humors	noun	Humor
humore	noun	Humor
eure	determiner	euer
küren	noun	Kür
barte	noun	Bart
blutsbrüder	noun	Blutsbruder
konsolen	noun	Konsole
anakondas	noun	Anakonda
comebacks	noun	Comeback
maats	noun	Maat
maate	noun	Maat
maaten	noun	Maat
come-backs	noun	Come-back
blöde	adjective	blöd
simsen	noun	Simse
syndrome	noun	Syndrom
nomaden	noun	Nomade
boutiques	noun	Boutique
butiken	noun	Butike
maffias	noun	Maffia
armbruste	noun	Armbrust
genausogut	adverb	genauso gut
grapheme	noun	Graphem
phoneme	noun	Phonem
lebensräume	noun	Lebensraum
adrians	noun	Adrian
serben	noun	Serbe
bytes	noun	Byte
emus	noun	Emu
fräcke	noun	Frack
generäle	noun	General
safaris	noun	Safari
sonnencremes	noun	Sonnencreme
advokaten	noun	Advokat
tumulte	noun	Tumult
photograph	noun	Fotograf
sheriffs	noun	Sheriff
schmerzen	noun	Schmerz
willen	noun	Wille
willens	noun	Wille
willens	noun	Willen
gefäße	noun	Gefäß
krägen	noun	Kragen
rollkrägen	noun	Rollkragen
retters	noun	Retter
nußknacker	noun	Nussknacker
vetters	noun	Vetter
malven	noun	Malve
countdowns	noun	Countdown
alts	noun	Alt
starts	noun	Start
youtubes	noun	YouTube
gibbons	noun	Gibbon
ungkas	noun	Ungka
carotinoide	noun	Carotinoid
carotine	noun	Carotin
dolche	noun	Dolch
fluten	noun	Flut
geologen	noun	Geologe
genitivs	noun	Genitiv
hupen	noun	Hupe
sprossen	noun	Sprosse
brüderschaften	noun	Brüderschaft
crêpes	noun	Crêpe
geräte	noun	Gerät
großväter	noun	Großvater
heerzüge	noun	Heerzug
hyperbeln	noun	Hyperbel
inspektoren	noun	Inspektor
karteikästen	noun	Karteikasten
luschen	noun	Lusche
manuskripte	noun	Manuskript
partien	noun	Partie
repräsentationen	noun	Repräsentation
riffe	noun	Riff
risse	noun	Riss
scheren	noun	Schere
schenken	noun	Schenke
schnitte	noun	Schnitt
seismografen	noun	Seismograf
sekundanten	noun	Sekundant
schwärme	noun	Schwarm
staffeln	noun	Staffel
steuern	noun	Steuer
tarife	noun	Tarif
schritte	noun	Schritt
schwellen	noun	Schwelle
spulen	noun	Spule
späne	noun	Span
schlingen	noun	Schlinge
härten	noun	Härte
unis	noun	Uni
kakofonien	noun	Kakofonie
thaler	noun	Taler
ure	noun	Ur
ures	noun	Ur
urs	noun	Ur
strasse	noun	Strass
meteore	noun	Meteor
profils	noun	Profil
profiles	noun	Profil
ficks	noun	Fick
gewiß	adjective	gewiss
gewiß	adverb	gewiss
ungewiß	adjective	ungewiss
webinars	noun	Webinar
jez	adverb	jetzt
beete	noun	Beet
strauss	noun	Strauß
stege	noun	Steg
institutionen	noun	Institution
apps	noun	App
fäßchen	noun	Fässchen
matts	noun	Matt
kose	verb	kosen
baart	noun	Bart
beilen	noun	Beil
aras	noun	Ara
puffers	noun	Puffer
workshops	noun	Workshop
mondes	noun	Mond
almen	noun	Alm
anstalten	noun	Anstalt
arbeitslöhne	noun	Arbeitslohn
halonen	noun	Halo
botenlöhne	noun	Botenlohn
bräunungsprozeß	noun	Bräunungsprozess
haart	verb	haaren
schleswigers	noun	Schleswiger
bügelverschluß	noun	Bügelverschluss
küßchen	noun	Küsschen
stammtischs	noun	Stammtisch
stammtisches	noun	Stammtisch
manne	noun	Mann
discounts	noun	Discount
adjektiven	noun	Adjektiv
handstands	noun	Handstand
äppel	noun	Appel
filters	noun	Filter
eßstäbchens	noun	Eßstäbchen
klubs	noun	Klub
clubs	noun	Club
vuvuzelas	noun	Vuvuzela
klausen	noun	Klause
sera	noun	Serum
evangelisten	noun	Evangelist
semaphore	noun	Semaphor
lazarette	noun	Lazarett
laibe	noun	Laib
keime	noun	Keim
homepages	noun	Homepage
ellipsoiden	noun	Ellipsoid
etablissements	noun	Etablissement
verläufe	noun	Verlauf
metiers	noun	Metier
amis	noun	Ami
gates	noun	Gate
maiden	noun	Maid
ausschlußverfahren	noun	Ausschlussverfahren
ions	noun	Ion
gneise	noun	Gneis
dicken	noun	Dicke
becks	noun	Beck
adverbs	noun	Adverb
a-schwas	noun	a-Schwa
futters	noun	Futter
untrew	adjective	untreu
gasthöfe	noun	Gasthof
fach	verb	fachen
mischlinge	noun	Mischling
mischlings	noun	Mischling
hälse	noun	Hals
sachets	noun	Sachet
woll	adverb	wohl
außenwände	noun	Außenwand
kachelöfen	noun	Kachelofen
pompons	noun	Pompon
barten	noun	Barte
chartas	noun	Charta
crèmes	noun	Crème
flure	noun	Flur
genres	noun	Genre
herbste	noun	Herbst
käffer	noun	Kaff
plaketten	noun	Plakette
pyromanen	noun	Pyromane
restaurants	noun	Restaurant
schwule	noun	Schwuler
socken	noun	Socke
skier	noun	Ski
sphæren	noun	Sphære
stäube	noun	Staub
schätze	noun	Schatz
wehen	noun	Weh
pflugs	noun	Pflug
pflüge	noun	Pflug
schwüre	noun	Schwur
bonsais	noun	Bonsai
umwelten	noun	Umwelt
tuches	noun	Tuch
hygrometers	noun	Hygrometer
buketts	noun	Bukett
etats	noun	Etat
shitstorms	noun	Shitstorm
schützes	noun	Schütz
antidots	noun	Antidot
antidote	noun	Antidot
abflüsse	noun	Abfluss
dialysen	noun	Dialyse
aasvogels	noun	Aasvogel
bräute	noun	Braut
negligés	noun	Negligé
mists	noun	Mist
christe	noun	Christus
christi	noun	Christus
arsenate	noun	Arsenat
invektiven	noun	Invektive
ninhydrins	noun	Ninhydrin
services	noun	Service
subtraktionen	noun	Subtraktion
reflexionen	noun	Reflexion
trampolins	noun	Trampolin
picknicks	noun	Picknick
picknicke	noun	Picknick
rats	noun	Rat
singletons	noun	Singleton
doktorväter	noun	Doktorvater
god objects	noun	God object
programmes	noun	Programm
frameworks	noun	Framework
bebens	noun	Beben
headhunters	noun	Headhunter
arbeitspaß	noun	Arbeitspass
kelvins	noun	Kelvin
futharks	noun	Futhark
abgänge	noun	Abgang
rads	noun	Rad
rades	noun	Rad
küsters	noun	Küster
rätseln	noun	Rätsel
kommentars	noun	Kommentar
pucks	noun	Puck
schnitten	noun	Schnitte
schnitten	noun	Schnitt
porphyrine	noun	Porphyrin
porphyrins	noun	Porphyrin
blitzes	noun	Blitz
stichs	noun	Stich
e-mails	noun	E-Mail
costa-ricaners	noun	Costa-Ricaner
bruches	noun	Bruch
fibonaccifolgen	noun	Fibonaccifolge
fibonacci-folgen	noun	Fibonacci-Folge
saucen	noun	Sauce
molochs	noun	Moloch
postillions	noun	Postillion
postillons	noun	Postillon
schuldigers	noun	Schuldiger
schmelzen	noun	Schmelze
wachse	noun	Wachs
parmesans	noun	Parmesan
veste	noun	Feste
vesten	noun	Veste
festen	noun	Feste
festen	noun	Fest
fests	noun	Fest
festes	noun	Fest
ovarien	noun	Ovarium
blütenböden	noun	Blütenboden
flensers	noun	Flenser
stiers	noun	Stier
stieres	noun	Stier
paparazzi	noun	Paparazzo
paparazzos	noun	Paparazzo
abgesangs	noun	Abgesang
whirlpools	noun	Whirlpool
diskussionsfäden	noun	Diskussionsfaden
fundis	noun	Fundi
realos	noun	Realo
elektrolysen	noun	Elektrolyse
wants	noun	Want
wanten	noun	Want
sofis	noun	Sofi
körner	noun	Korn
retronyms	noun	Retronym
retronyme	noun	Retronym
baristas	noun	Barista
higgs-bosons	noun	Higgs-Boson
higgs-bosonen	noun	Higgs-Boson
iterators	noun	Iterator
milanković-zyklen	noun	Milanković-Zyklus
limits	noun	Limit
milankovic-zyklen	noun	Milankovic-Zyklus
anrichten	noun	Anrichte
vorhängeschloß	noun	Vorhängeschloss
einstiege	noun	Einstieg
papis	noun	Papi
masterings	noun	Mastering
busmasterings	noun	Busmastering
bus-masterings	noun	Bus-Mastering
rums	noun	Rum
endometriums	noun	Endometrium
müttern	noun	Mutter
plektra	noun	Plektron
ihre	pronoun	Ihr
greises	noun	Greis
gefaßt	adjective	gefasst
gefaßt	verb	gefasst
hinterländer	noun	Hinterland
wikipedianers	noun	Wikipedianer
zerfälle	noun	Zerfall
hoteliers	noun	Hotelier
heliums	noun	Helium
lithiums	noun	Lithium
berylliums	noun	Beryllium
priesters	noun	Priester
burritos	noun	Burrito
guacamoles	noun	Guacamole
gaffers	noun	Gaffer
spiegels	noun	Spiegel
schilder	noun	Schild
steins	noun	Stein
belts	noun	Belt
belte	noun	Belt
belten	noun	Belt
rockers	noun	Rocker
tetrarchen	noun	Tetrarch
alveolars	noun	Alveolar
alveolare	noun	Alveolar
alveolaren	noun	Alveolar
springers	noun	Springer
intranets	noun	Intranet
extranets	noun	Extranet
proxyservers	noun	Proxyserver
decorators	noun	Decorator
model-view-controllers	noun	Model-View-Controller
kaisers	noun	Kaiser
tabaks	noun	Tabak
muttern	noun	Mutter
departements	noun	Departement
tupels	noun	Tupel
object request brokers	noun	Object Request Broker
portable executables	noun	Portable Executable
marshallings	noun	Marshalling
gelees	noun	Gelee
trainees	noun	Trainee
inländers	noun	Inländer
deos	noun	Deo
unittests	noun	Unittest
tic tac toe	noun	Tic-Tac-Toe
kreis und kreuzes	noun	Kreis und Kreuz
amarante	noun	Amarant
idioms	noun	Idiom
rothaarigen	noun	Rothaarige
putze	noun	Putz
wesentlichen	noun	Wesentliche
musters	noun	Muster
diagonalen	noun	Diagonale
toxikologen	noun	Toxikologe
psychiaters	noun	Psychiater
veterinäre	noun	Veterinär
kritikers	noun	Kritiker
dealers	noun	Dealer
elektrikers	noun	Elektriker
seminars	noun	Seminar
seminares	noun	Seminar
blaus	noun	Blau
muts	noun	Mut
mutes	noun	Mut
hyperlinks	noun	Hyperlink
thesauri	noun	Thesaurus
killers	noun	Killer
investors	noun	Investor
müllers	noun	Müller
dichters	noun	Dichter
schäfers	noun	Schäfer
webers	noun	Weber
magisters	noun	Magister
warten	noun	Warte
zacken	noun	Zacke
hyperonyms	noun	Hyperonym
hyperonyme	noun	Hyperonym
species	noun	Spezies
pyrazins	noun	Pyrazin
pyrazine	noun	Pyrazin
heaps	noun	Heap
gens	noun	Gen
heiden	noun	Heide
fracks	noun	Frack
föhne	noun	Föhn
föhns	noun	Föhn
hausens	noun	Hausen
saccharide	noun	Saccharid
spinners	noun	Spinner
oesophagospasmus	noun	Ösophagospasmus
hotspots	noun	Hotspot
kopten	noun	Kopte
bestsellers	noun	Bestseller
wasservögel	noun	Wasservogel
aikidos	noun	Aikido
abiturs	noun	Abitur
tamtams	noun	Tamtam
fall lines	noun	Fall Line
electoral colleges	noun	Electoral College
wertes	noun	Wert
skorpions	noun	Skorpion
vorfahren	noun	Vorfahre
vorfahren	noun	Vorfahr
rss-feeds	noun	RSS-Feed
musikantenwägen	noun	Musikantenwagen
staatsbürgers	noun	Staatsbürger
ruders	noun	Ruder
infos	noun	Info
borges	noun	Borg
börge	noun	Borg
refrains	noun	Refrain
grabens	noun	Graben
rasens	noun	Rasen
pronomina	noun	Pronomen
pronomens	noun	Pronomen
jedem	pronoun	jeder
jedes	pronoun	jeder
tutorials	noun	Tutorial
ports	noun	Port
deutschen	noun	Deutsch
deutschen	noun	Deutscher
deutschen	noun	Deutsche
dropdown-listen	noun	Dropdown-Liste
drop-down-listen	noun	Drop-down-Liste
totems	noun	Totem
jähe	adjective	jäh
fingers	noun	Finger
alkalimetallen	noun	Alkalimetall
alkoholen	noun	Alkohol
anfängen	noun	Anfang
aprile	noun	April
samstags	noun	Samstag
russischen	noun	Russisch
vakua	noun	Vakuum
lexikons	noun	Lexikon
herbstes	noun	Herbst
banne	noun	Bann
banns	noun	Bann
bannes	noun	Bann
nebels	noun	Nebel
pharaos	noun	Pharao
plutos	noun	Pluto
lichts	noun	Licht
ordens	noun	Orden
diasporas	noun	Diaspora
helikopters	noun	Helikopter
sexten	noun	Sexte
septimen	noun	Septime
oktaven	noun	Oktave
spannungsbögen	noun	Spannungsbogen
satans	noun	Satan
sommers	noun	Sommer
belgiers	noun	Belgier
nevadas	noun	Nevada
blattes	noun	Blatt
rinden	noun	Rinde
märze	noun	März
märzes	noun	März
dienstags	noun	Dienstag
donnerstags	noun	Donnerstag
freitags	noun	Freitag
horizonts	noun	Horizont
horizontes	noun	Horizont
grußes	noun	Gruß
armeniers	noun	Armenier
montags	noun	Montag
montages	noun	Montag
dilemmas	noun	Dilemma
dilemmata	noun	Dilemma
abaki	noun	Abakus
ablauts	noun	Ablaut
aborts	noun	Abort
abortes	noun	Abort
adapters	noun	Adapter
adels	noun	Adel
affixe	noun	Affix
affixes	noun	Affix
animes	noun	Anime
anoraks	noun	Anorak
antonyms	noun	Antonym
aquariums	noun	Aquarium
argumentes	noun	Argument
armes	noun	Arm
aromas	noun	Aroma
asses	noun	As
assemblers	noun	Assembler
asthmas	noun	Asthma
atolls	noun	Atoll
autobusses	noun	Autobus
avatars	noun	Avatar
axolotls	noun	Axolotl
billete	noun	Billet
blitzkriegs	noun	Blitzkrieg
bocks	noun	Bock
boilers	noun	Boiler
borde	noun	Bord
bords	noun	Bord
bordes	noun	Bord
bouillons	noun	Bouillon
bouquets	noun	Bouquet
boxers	noun	Boxer
brandes	noun	Brand
brands	noun	Brand
bretts	noun	Brett
brettes	noun	Brett
budgets	noun	Budget
buffets	noun	Buffet
büge	noun	Bug
bundes	noun	Bund
burken	noun	Burke
bösen	noun	Böse
charismata	noun	Charisma
charismas	noun	Charisma
chats	noun	Chat
chauffeurs	noun	Chauffeur
chosen	noun	Chose
couleurs	noun	Couleur
coulombs	noun	Coulomb
cousins	noun	Cousin
crickets	noun	Cricket
datums	noun	Datum
deals	noun	Deal
desserts	noun	Dessert
dias	noun	Dia
dialogs	noun	Dialog
diesels	noun	Diesel
dingos	noun	Dingo
dodekaeders	noun	Dodekaeder
dogmata	noun	Dogma
dogmas	noun	Dogma
dome	noun	Dom
doms	noun	Dom
domes	noun	Dom
doppelgängers	noun	Doppelgänger
dragées	noun	Dragée
dramas	noun	Drama
dysprosiums	noun	Dysprosium
eies	noun	Ei
elans	noun	Elan
elements	noun	Element
emails	noun	Email
engagements	noun	Engagement
enkels	noun	Enkel
ersatzes	noun	Ersatz
espressos	noun	Espresso
esprits	noun	Esprit
ethanols	noun	Ethanol
evolutionen	noun	Evolution
exceptions	noun	Exception
experimentes	noun	Experiment
exports	noun	Export
exportes	noun	Export
exposés	noun	Exposé
fanges	noun	Fang
fastens	noun	Fasten
faunen	noun	Faun
faunen	noun	Fauna
februare	noun	Februar
feuilletons	noun	Feuilleton
filets	noun	Filet
finals	noun	Final
finals	noun	Finale
finales	noun	Finale
flecken	noun	Fleck
fluide	noun	Fluid
fluids	noun	Fluid
formats	noun	Format
formates	noun	Format
forums	noun	Forum
fossile	noun	Fossil
fossils	noun	Fossil
foyers	noun	Foyer
fragments	noun	Fragment
fragmentes	noun	Fragment
futurs	noun	Futur
gangs	noun	Gang
gastes	noun	Gast
gasts	noun	Gast
gels	noun	Gel
generals	noun	General
gladiators	noun	Gladiator
gourmets	noun	Gourmet
grabes	noun	Grab
grads	noun	Grad
grades	noun	Grad
grames	noun	Gram
grams	noun	Gram
grants	noun	Grant
grunds	noun	Grund
grundes	noun	Grund
görs	noun	Gör
göres	noun	Gör
hage	noun	Hag
hags	noun	Hag
hages	noun	Hag
halses	noun	Hals
halte	noun	Halt
halts	noun	Halt
haltes	noun	Halt
hangars	noun	Hangar
harakiris	noun	Harakiri
harems	noun	Harem
helms	noun	Helm
helmes	noun	Helm
herds	noun	Herd
herdes	noun	Herd
hobbys	noun	Hobby
hockeys	noun	Hockey
horns	noun	Horn
horrors	noun	Horror
hungers	noun	Hunger
huts	noun	Hut
ideals	noun	Ideal
imams	noun	Imam
imames	noun	Imam
immigrationen	noun	Immigration
imperiums	noun	Imperium
imports	noun	Import
importes	noun	Import
infixes	noun	Infix
integrals	noun	Integral
jaguars	noun	Jaguar
jaks	noun	Jak
jargons	noun	Jargon
joules	noun	Joule
journals	noun	Journal
judokas	noun	Judoka
julis	noun	Juli
junis	noun	Juni
juntas	noun	Junta
kis	noun	KI
kalis	noun	Kali
karats	noun	Karat
karates	noun	Karat
kerfs	noun	Kerf
kilos	noun	Kilo
koalas	noun	Koala
kondoms	noun	Kondom
konjunktivs	noun	Konjunktiv
labors	noun	Labor
lacke	noun	Lack
lackes	noun	Lack
lacks	noun	Lack
leuen	noun	Leu
liaisons	noun	Liaison
lobe	noun	Lob
lobs	noun	Lob
lobes	noun	Lob
loses	noun	Los
lote	noun	Lot
lots	noun	Lot
lotes	noun	Lot
lunchs	noun	Lunch
lurches	noun	Lurch
maisonettes	noun	Maisonette
mals	noun	Mal
males	noun	Mal
mamas	noun	Mama
mandarins	noun	Mandarin
mandarines	noun	Mandarin
mannen	noun	Mann
marketings	noun	Marketing
mauls	noun	Maul
mayos	noun	Mayo
mediums	noun	Medium
melodramas	noun	Melodrama
meme	noun	Mem
mems	noun	Mem
memorandums	noun	Memorandum
metallers	noun	Metaller
meters	noun	Meter
mikroskops	noun	Mikroskop
minimums	noun	Minimum
mobs	noun	Mob
mobiles	noun	Mobile
modems	noun	Modem
molen	noun	Mole
moments	noun	Moment
monitoren	noun	Monitor
monitors	noun	Monitor
monsters	noun	Monster
moste	noun	Most
motels	noun	Motel
mulche	noun	Mulch
mulches	noun	Mulch
multimedias	noun	Multimedia
musen	noun	Muse
musicals	noun	Musical
musiken	noun	Musik
nanometers	noun	Nanometer
naturen	noun	Natur
negers	noun	Neger
neigen	noun	Neige
nester	noun	Nest
nests	noun	Nest
nestes	noun	Nest
neurons	noun	Neuron
neutrinos	noun	Neutrino
neutrons	noun	Neutron
niveaus	noun	Niveau
nonagone	noun	Nonagon
notebooks	noun	Notebook
omina	noun	Omen
omens	noun	Omen
opiums	noun	Opium
orbits	noun	Orbit
ordern	noun	Order
organs	noun	Organ
orients	noun	Orient
otters	noun	Otter
palimpseste	noun	Palimpsest
palimpsests	noun	Palimpsest
palimpsestes	noun	Palimpsest
panoramas	noun	Panorama
parasole	noun	Parasol
parasols	noun	Parasol
parke	noun	Park
pärke	noun	Park
parkes	noun	Park
partners	noun	Partner
patzers	noun	Patzer
pellen	noun	Pelle
pendants	noun	Pendant
pentagons	noun	Pentagon
personals	noun	Personal
phalli	noun	Phallus
pharaohs	noun	Pharaoh
photons	noun	Photon
pianos	noun	Piano
pieres	noun	Pier
piks	noun	Pik
piques	noun	Pique
placebos	noun	Placebo
planes	noun	Plan
plaques	noun	Plaque
plasmas	noun	Plasma
podcasts	noun	Podcast
politiken	noun	Politik
polkas	noun	Polka
pollens	noun	Pollen
polymers	noun	Polymer
popcorns	noun	Popcorn
portals	noun	Portal
portales	noun	Portal
positrons	noun	Positron
premiers	noun	Premier
problemes	noun	Problem
produkts	noun	Produkt
proteins	noun	Protein
proteines	noun	Protein
protests	noun	Protest
protestes	noun	Protest
protestanten	noun	Protestant
pseudonyms	noun	Pseudonym
putsches	noun	Putsch
qualms	noun	Qualm
quarks	noun	Quark
rands	noun	Rand
rangs	noun	Rang
rauche	noun	Rauch
recks	noun	Reck
regimenter	noun	Regiment
reises	noun	Reis
remakes	noun	Remake
rentiers	noun	Rentier#Etymology 1
rentiers	noun	Rentier#Etymology 2
rentieres	noun	Rentier#Etymology 1
repertoires	noun	Repertoire
reservoirs	noun	Reservoir
rests	noun	Rest
restes	noun	Rest
retinae	noun	Retina
revolvers	noun	Revolver
rings	noun	Ring
ringes	noun	Ring
rituals	noun	Ritual
rotors	noun	Rotor
rouges	noun	Rouge
roulettes	noun	Roulette
saisons	noun	Saison
salamanders	noun	Salamander
salamis	noun	Salami
samurais	noun	Samurai
sands	noun	Sand
sandes	noun	Sand
sandwichs	noun	Sandwich
sashimis	noun	Sashimi
satyrs	noun	Satyr
schemas	noun	Schema
schmucks	noun	Schmuck
schmuckes	noun	Schmuck
schwas	noun	Schwa
segments	noun	Segment
signals	noun	Signal
signales	noun	Signal
singulare	noun	Singular
sinnes	noun	Sinn
sirupe	noun	Sirup
sirups	noun	Sirup
sitzkriegs	noun	Sitzkrieg
skis	noun	Ski
slips	noun	Slip
smaragds	noun	Smaragd
smaragdes	noun	Smaragd
smogs	noun	Smog
snobs	noun	Snob
sorbets	noun	Sorbet
souvenirs	noun	Souvenir
spans	noun	Span
spanes	noun	Span
specke	noun	Speck
specks	noun	Speck
spitzes	noun	Spitz
splitters	noun	Splitter
spurte	noun	Spurt
spurts	noun	Spurt
stalls	noun	Stall
stalles	noun	Stall
standes	noun	Stand
steaks	noun	Steak
sternes	noun	Stern
sterns	noun	Stern
strands	noun	Strand
strandes	noun	Strand
stresse	noun	Stress
stresses	noun	Stress
stroms	noun	Strom
suffixes	noun	Suffix
sutras	noun	Sutra
symbols	noun	Symbol
symposiums	noun	Symposium
synonyma	noun	Synonym
synonymes	noun	Synonym
tempora	noun	Tempus
testes	noun	Test
texts	noun	Text
tickets	noun	Ticket
tods	noun	Tod
tofus	noun	Tofu
trancen	noun	Trance
transfers	noun	Transfer
transite	noun	Transit
transits	noun	Transit
transites	noun	Transit
trends	noun	Trend
trolls	noun	Troll
trottoirs	noun	Trottoir
trunks	noun	Trunk
trunkes	noun	Trunk
tumoren	noun	Tumor
tumore	noun	Tumor
tumors	noun	Tumor
twists	noun	Twist
verben	noun	Verb
videos	noun	Video
vinyle	noun	Vinyl
vinyls	noun	Vinyl
visen	noun	Visum
visums	noun	Visum
vitamins	noun	Vitamin
volts	noun	Volt
voltes	noun	Volt
voyeurs	noun	Voyeur
waden	noun	Wade
wafers	noun	Wafer
wagons	noun	Wagon
wegs	noun	Weg
wieners	noun	Wiener
wilds	noun	Wild
wildes	noun	Wild
winke	noun	Wink
winks	noun	Wink
winkels	noun	Winkel
winkers	noun	Winker
winters	noun	Winter
wolfs	noun	Wolf
wolfes	noun	Wolf
wracks	noun	Wrack
wunderkinds	noun	Wunderkind
xylitols	noun	Xylitol
zebus	noun	Zebu
bisons	noun	Bison
äser	noun	Aas
aases	noun	Aas
krämers	noun	Krämer
memos	noun	Memo
süßen	noun	Süßer
seiden	noun	Seide
hofs	noun	Hof
busses	noun	Bus
phosphors	noun	Phosphor
zinks	noun	Zink
bleis	noun	Blei
beschissen	noun	Beschiss
typs	noun	Typ
kalbes	noun	Kalb
heers	noun	Heer
ostens	noun	Osten
klicks	noun	Klick
händlers	noun	Händler
downloads	noun	Download
aaren	noun	Aar
aars	noun	Aar
aares	noun	Aar
heims	noun	Heim
kugelblitzes	noun	Kugelblitz
mixers	noun	Mixer
infernos	noun	Inferno
smokings	noun	Smoking
lappens	noun	Lappen
mittels	noun	Mittel
laubenvögel	noun	Laubenvogel
obstes	noun	Obst
kamels	noun	Kamel
dromedars	noun	Dromedar
kanzlers	noun	Kanzler
atomen	noun	Atom
peche	noun	Pech
pechs	noun	Pech
peches	noun	Pech
punkts	noun	Punkt
schales	noun	Schal
chors	noun	Chor
chores	noun	Chor
opossums	noun	Opossum
säugers	noun	Säuger
mülls	noun	Müll
hirns	noun	Hirn
keims	noun	Keim
schnabels	noun	Schnabel
reizes	noun	Reiz
atommassen	noun	Atommasse
schnapses	noun	Schnaps
morgens	noun	Morgen
hagels	noun	Hagel
blechs	noun	Blech
bleches	noun	Blech
fußballs	noun	Fußball
fußballes	noun	Fußball
frühstücke	noun	Frühstück
schobers	noun	Schober
mundes	noun	Mund
munds	noun	Mund
großmütter	noun	Großmutter
nihilartikels	noun	Nihilartikel
bodybuildings	noun	Bodybuilding
reporters	noun	Reporter
fritz'	noun	Fritz
phönixes	noun	Phönix
vokals	noun	Vokal
chiantis	noun	Chianti
kaffeeklatsches	noun	Kaffeeklatsch
opas	noun	Opa
kohls	noun	Kohl
maßes	noun	Maß
fleißes	noun	Fleiß
schöße	noun	Schoß
floßes	noun	Floß
rotzen	noun	Rotz
wetters	noun	Wetter
scherze	noun	Scherz
sturmes	noun	Sturm
storchs	noun	Storch
salzwässer	noun	Salzwasser
dinger	noun	Ding
dinges	noun	Ding
dings	noun	Ding
dorns	noun	Dorn
widders	noun	Widder
brachen	noun	Brache
asphalte	noun	Asphalt
asphaltes	noun	Asphalt
enden	noun	Ende
friseurs	noun	Friseur
ministeriums	noun	Ministerium
hechts	noun	Hecht
höckers	noun	Höcker
pakets	noun	Paket
stammes	noun	Stamm
mords	noun	Mord
mordes	noun	Mord
ruße	noun	Ruß
rußes	noun	Ruß
risses	noun	Riß
bisse	noun	Biss
bisses	noun	Biss
schutzen	noun	Schutz
baus	noun	Bau
ahnen	noun	Ahn
beins	noun	Bein
borken	noun	Borke
bügels	noun	Bügel
bündels	noun	Bündel
busches	noun	Busch
brausen	noun	Brause
breie	noun	Brei
breis	noun	Brei
brunnens	noun	Brunnen
dauern	noun	Dauer
degens	noun	Degen
dieners	noun	Diener
dochte	noun	Docht
dotters	noun	Dotter
dränge	noun	Drang
drangs	noun	Drang
duftes	noun	Duft
ebben	noun	Ebbe
föne	noun	Fön
forste	noun	Forst
garne	noun	Garn
garns	noun	Garn
gefäßes	noun	Gefäß
gnaden	noun	Gnade
grats	noun	Grat
grates	noun	Grat
grieße	noun	Grieß
grießes	noun	Grieß
griffs	noun	Griff
griffes	noun	Griff
hauchs	noun	Hauch
hefen	noun	Hefe
heilande	noun	Heiland
imkers	noun	Imker
kinne	noun	Kinn
blößen	noun	Blöße
klangs	noun	Klang
knalle	noun	Knall
knicke	noun	Knick
klatsche	noun	Klatsch
klatsches	noun	Klatsch
korkens	noun	Korken
kragens	noun	Kragen
krans	noun	Kran
säbels	noun	Säbel
magens	noun	Magen
möbeln	noun	Möbel
möbels	noun	Möbel
mühen	noun	Mühe
neiden	noun	Neid
rasten	noun	Rast
reifes	noun	Reif
pokals	noun	Pokal
puders	noun	Puder
riffs	noun	Riff
rucke	noun	Ruck
rucks	noun	Ruck
ruckes	noun	Ruck
schaftes	noun	Schaft
schalle	noun	Schall
schälle	noun	Schall
schauen	noun	Schau
scheiter	noun	Scheit
schwäger	noun	Schwager
sieges	noun	Sieg
sporne	noun	Sporn
spottes	noun	Spott
staube	noun	Staub
stempels	noun	Stempel
stifts	noun	Stift
stiftes	noun	Stift
streite	noun	Streit
krapfens	noun	Krapfen
striches	noun	Strich
stumpfes	noun	Stumpf
fladens	noun	Fladen
tausche	noun	Tausch
wächters	noun	Wächter
wäschen	noun	Wäsche
watten	noun	Watte
werks	noun	Werk
werkes	noun	Werk
schärfen	noun	Schärfe
gerätes	noun	Gerät
kapitels	noun	Kapitel
marmeladen	noun	Marmelade
kaiserdoms	noun	Kaiserdom
kabels	noun	Kabel
kabinetts	noun	Kabinett
maskulina	noun	Maskulinum
eiscremes	noun	Eiscreme
pulsars	noun	Pulsar
skalars	noun	Skalar
konjunktions	noun	Konjunktion
ginkgos	noun	Ginkgo
periastrons	noun	Periastron
apastrons	noun	Apastron
vergleiche	noun	Vergleich
östrogens	noun	Östrogen
enzyms	noun	Enzym
metalle	noun	Metall
metalls	noun	Metall
butts	noun	Butt
buttes	noun	Butt
kulturträgers	noun	Kulturträger
rubins	noun	Rubin
pornos	noun	Porno
spektrums	noun	Spektrum
schnörkels	noun	Schnörkel
bogenschiessens	noun	Bogenschiessen
müslis	noun	Müsli
fasans	noun	Fasan
salats	noun	Salat
salates	noun	Salat
schleifen	noun	Schleife
schwulen	noun	Schwuler
konstruktivismen	noun	Konstruktivismus
kriminellen	noun	Krimineller
magnetismen	noun	Magnetismus
nachmittags	noun	Nachmittag
mammuts	noun	Mammut
knechte	noun	Knecht
knechts	noun	Knecht
parfüms	noun	Parfüm
kontinents	noun	Kontinent
kollektivs	noun	Kollektiv
kraters	noun	Krater
bodybuilders	noun	Bodybuilder
lottos	noun	Lotto
sensors	noun	Sensor
kamins	noun	Kamin
fernen	noun	Ferne
hockers	noun	Hocker
literaturen	noun	Literatur
vormittags	noun	Vormittag
verbrauche	noun	Verbrauch
tresors	noun	Tresor
indianers	noun	Indianer
mirakels	noun	Mirakel
extremums	noun	Extremum
chinesischen	noun	Chinesisch
fachchinesischen	noun	Fachchinesisch
neandertalers	noun	Neandertaler
pünsche	noun	Punsch
plattens	noun	Platten
grills	noun	Grill
vermögens	noun	Vermögen
verbündeten	noun	Verbündete
exils	noun	Exil
stillstands	noun	Stillstand
pulse	noun	Puls
pulses	noun	Puls
dadaismen	noun	Dadaismus
studiums	noun	Studium
dopings	noun	Doping
schlächters	noun	Schlächter
planens	noun	Planen
portemonnaies	noun	Portemonnaie
klans	noun	Klan
asyls	noun	Asyl
politikers	noun	Politiker
balkons	noun	Balkon
musikers	noun	Musiker
lokals	noun	Lokal
effekts	noun	Effekt
komas	noun	Koma
komata	noun	Koma
störs	noun	Stör
störes	noun	Stör
hortes	noun	Hort
baritons	noun	Bariton
pioniers	noun	Pionier
prostituierten	noun	Prostituierte
skeletts	noun	Skelett
ironien	noun	Ironie
verrats	noun	Verrat
pornografien	noun	Pornografie
populismen	noun	Populismus
mikrofons	noun	Mikrofon
schurwollen	noun	Schurwolle
etiketts	noun	Etikett
seismometers	noun	Seismometer
seismogrammes	noun	Seismogramm
schlägers	noun	Schläger
desktop-computers	noun	Desktop-Computer
stolpersteins	noun	Stolperstein
pürees	noun	Püree
doktors	noun	Doktor
internats	noun	Internat
internates	noun	Internat
dumme-jungen-streichs	noun	Dumme-Jungen-Streich
dumme-jungen-streiches	noun	Dumme-Jungen-Streich
dummejungenstreichs	noun	Dummejungenstreich
dummejungenstreiches	noun	Dummejungenstreich
fahnenflüchtigen	noun	Fahnenflüchtige
kremes	noun	Kreme
duetts	noun	Duett
fließbands	noun	Fließband
fließbandes	noun	Fließband
projekts	noun	Projekt
verdächtigen	noun	Verdächtiger
militärs	noun	Militär
basars	noun	Basar
sultanats	noun	Sultanat
sultanates	noun	Sultan
sexismen	noun	Sexismus
dynamites	noun	Dynamit
moduls	noun	Modul
granits	noun	Granit
granites	noun	Granit
serbischen	noun	Serbisch
marihuanas	noun	Marihuana
skandals	noun	Skandal
visionäres	noun	Visionär
konflikts	noun	Konflikt
projektors	noun	Projektor
fixers	noun	Fixer
indris	noun	Indri
cholesterins	noun	Cholesterin
charmeurs	noun	Charmeur
charmes	noun	Charme
flaneurs	noun	Flaneur
flairs	noun	Flair
frisörs	noun	Frisör
faibles	noun	Faible
etuis	noun	Etui
debüts	noun	Debüt
souterraine	noun	Souterrain
souterrains	noun	Souterrain
parterres	noun	Parterre
fiaskos	noun	Fiasko
plateaus	noun	Plateau
malheurs	noun	Malheur
streitwägen	noun	Streitwagen
souffleurs	noun	Souffleur
goudas	noun	Gouda
magien	noun	Magie
soufflés	noun	Soufflé
soufflees	noun	Soufflee
döners	noun	Döner
potpourris	noun	Potpourri
chics	noun	Chic
fondues	noun	Fondue
puffs	noun	Puff
kefirs	noun	Kefir
horsts	noun	Horst
kickers	noun	Kicker
dämons	noun	Dämon
trapezes	noun	Trapez
holländers	noun	Holländer
erdböden	noun	Erdboden
weissstorchs	noun	Weissstorch
weissstorches	noun	Weissstorch
jugendlichen	noun	Jugendliche
instituts	noun	Institut
institutes	noun	Institut
gehöre	noun	Gehör
pheromones	noun	Pheromon
prestiges	noun	Prestige
kapitals	noun	Kapital
migränen	noun	Migräne
australiers	noun	Australier
brasilianers	noun	Brasilianer
kalibers	noun	Kaliber
sesams	noun	Sesam
konsuls	noun	Konsul
derivats	noun	Derivat
derivates	noun	Derivat
iros	noun	Iro
gramms	noun	Gramm
stopps	noun	Stopp
präfixe	noun	Präfix
präfixes	noun	Präfix
mobiltelefons	noun	Mobiltelefon
biogases	noun	Biogas
kuverts	noun	Kuvert
couverts	noun	Couvert
klassikers	noun	Klassiker
defekts	noun	Defekt
großhändlers	noun	Großhändler
depps	noun	Depp
lineals	noun	Lineal
gesten	noun	Geste
renommees	noun	Renommee
separees	noun	Separee
séparées	noun	Séparée
exposees	noun	Exposee
essstäbchens	noun	Essstäbchen
dimmers	noun	Dimmer
menthole	noun	Menthol
menthols	noun	Menthol
entrees	noun	Entree
entrées	noun	Entrée
avantgarden	noun	Avantgarde
böllers	noun	Böller
bankettes	noun	Bankett
erdgeschosse	noun	Erdgeschoss
erdgeschosses	noun	Erdgeschoss
pkws	noun	Pkw
personenwägen	noun	Personenwagen
gesäßes	noun	Gesäß
appetits	noun	Appetit
appetites	noun	Appetit
kriteriums	noun	Kriterium
materien	noun	Materie
bidets	noun	Bidet
dogmatikers	noun	Dogmatiker
dragees	noun	Dragee
ressentiments	noun	Ressentiment
arrangeurs	noun	Arrangeur
omelette	noun	Omelett
portefeuilles	noun	Portefeuille
portiers	noun	Portier
portiere	noun	Portier
gouverneurs	noun	Gouverneur
privilege	noun	Privileg
resümees	noun	Resümee
ballens	noun	Ballen
separationen	noun	Separation
interieurs	noun	Interieur
interieure	noun	Interieur
handwerke	noun	Handwerk
handwerkes	noun	Handwerk
japaners	noun	Japaner
livreen	noun	Livree
matinéen	noun	Matinée
necessaires	noun	Necessaire
faktums	noun	Faktum
plünderers	noun	Plünderer
kontaktes	noun	Kontakt
kontakts	noun	Kontakt
pissoirs	noun	Pissoir
protegés	noun	Protegé
profiteurs	noun	Profiteur
fakts	noun	Fakt
reformers	noun	Reformer
ressorts	noun	Ressort
salute	noun	Salut
saluts	noun	Salut
salutes	noun	Salut
tournees	noun	Tournee
nikotins	noun	Nikotin
nicotins	noun	Nicotin
karabiners	noun	Karabiner
besitzen	noun	Besitz
nominativs	noun	Nominativ
perfekte	noun	Perfekt
kulis	noun	Kuli
haussen	noun	Hausse
sanis	noun	Sani
propans	noun	Propan
komparativs	noun	Komparativ
hypnosen	noun	Hypnose
mopps	noun	Mopp
kaplans	noun	Kaplan
stolzes	noun	Stolz
sanatoriums	noun	Sanatorium
themata	noun	Thema
sponsors	noun	Sponsor
dokuments	noun	Dokument
dokumentes	noun	Dokument
neugeborenen	noun	Neugeborenes
lüsters	noun	Lüster
flashbacks	noun	Flashback
sünders	noun	Sünder
verdachte	noun	Verdacht
verdächte	noun	Verdacht
köters	noun	Köter
sexes	noun	Sex
satins	noun	Satin
sagers	noun	Sager
bunkers	noun	Bunker
glossare	noun	Glossar
megafons	noun	Megafon
römers	noun	Römer
besserwissers	noun	Besserwisser
dresseurs	noun	Dresseur
ensembles	noun	Ensemble
fußgängers	noun	Fußgänger
fungizides	noun	Fungizid
parkette	noun	Parkett
parkettes	noun	Parkett
oleanders	noun	Oleander
provisoriums	noun	Provisorium
benzes	noun	Benz
exempels	noun	Exempel
kollapse	noun	Kollaps
deodorants	noun	Deodorant
deodorante	noun	Deodorant
biodiesels	noun	Biodiesel
kubikmeters	noun	Kubikmeter
horoskops	noun	Horoskop
romanciers	noun	Romancier
prismas	noun	Prisma
duells	noun	Duell
artikels	noun	Artikel
digestifs	noun	Digestif
stipendiums	noun	Stipendium
illustrators	noun	Illustrator
sujets	noun	Sujet
trampers	noun	Tramper
ichlauts	noun	Ichlaut
rondelle	noun	Rondell
nagellacks	noun	Nagellack
menhirs	noun	Menhir
moderators	noun	Moderator
visiers	noun	Visier
filtrats	noun	Filtrat
filtrates	noun	Filtrat
initiators	noun	Initiator
faktors	noun	Faktor
peruaners	noun	Peruaner
bewusstseins	noun	Bewusstsein
tierparke	noun	Tierpark
tierpärke	noun	Tierpark
menuetts	noun	Menuett
behagens	noun	Behagen
reserverades	noun	Reserverad
saphirs	noun	Saphir
reiters	noun	Reiter
denkers	noun	Denker
stammbaums	noun	Stammbaum
rekta	noun	Rektum
jockeys	noun	Jockey
individuums	noun	Individuum
iotas	noun	Iota
impulses	noun	Impuls
jodlers	noun	Jodler
kinderwägen	noun	Kinderwagen
hologrammes	noun	Hologramm
epilogs	noun	Epilog
internierten	noun	Internierter
internierten	noun	Internierte
naturelle	noun	Naturell
stadions	noun	Stadion
konservatoriums	noun	Konservatorium
vielfachen	noun	Vielfaches
einfuhren	noun	Einfuhr
notars	noun	Notar
fakirs	noun	Fakir
mainstreams	noun	Mainstream
fußabdrucks	noun	Fußabdruck
fußabdruckes	noun	Fußabdruck
sakkos	noun	Sakko
klimas	noun	Klima
flößers	noun	Flößer
panters	noun	Panter
plagiats	noun	Plagiat
plagiates	noun	Plagiat
asbests	noun	Asbest
asbestes	noun	Asbest
triathlons	noun	Triathlon
republikaners	noun	Republikaner
skalpells	noun	Skalpell
routiniers	noun	Routinier
pandemien	noun	Pandemie
türkises	noun	Türkis
evangeliums	noun	Evangelium
rekords	noun	Rekord
hormons	noun	Hormon
hormones	noun	Hormon
unrechtes	noun	Unrecht
puters	noun	Puter
formulars	noun	Formular
bücklings	noun	Bückling
determinanten	noun	Determinante
zeloten	noun	Zelot
singvögel	noun	Singvogel
disken	noun	Diskus
abzocken	noun	Abzocke
haine	noun	Hain
dominoeffekts	noun	Dominoeffekt
litfasssäulen	noun	Litfasssäule
peinen	noun	Pein
flirts	noun	Flirt
koreanischen	noun	Koreanisch
ogers	noun	Oger
gurte	noun	Gurt
gurts	noun	Gurt
bogenschießens	noun	Bogenschießen
kamillen	noun	Kamille
kondoren	noun	Kondor
isotops	noun	Isotop
missionars	noun	Missionar
insulins	noun	Insulin
xanthins	noun	Xanthin
orks	noun	Ork
erdgeschoße	noun	Erdgeschoß
erdgeschoßes	noun	Erdgeschoß
lexikografs	noun	Lexikograf
passive	noun	Passiv
schier	noun	Schi
resultate	noun	Resultat
ukase	noun	Ukas
ukases	noun	Ukas
präterita	noun	Präteritum
passepartouts	noun	Passepartout
quantile	noun	Quantil
heterozygote	noun	Heterozygot
präsente	noun	Präsent
präsentes	noun	Präsent
positive	noun	Positiv
ausfuhren	noun	Ausfuhr
billette	noun	Billett
billettes	noun	Billett
regenmantels	noun	Regenmantel
brioches	noun	Brioche
websites	noun	Website
superjumbos	noun	Superjumbo
proletariers	noun	Proletarier
mißverständnisses	noun	Mißverständnis
obergruppenführers	noun	Obergruppenführer
gauleiters	noun	Gauleiter
weißbiers	noun	Weißbier
deckels	noun	Deckel
zunahmen	noun	Zunahme
immateriellen	noun	Immaterielles
implantates	noun	Implantat
majos	noun	Majo
geißeln	noun	Geißel
hydrates	noun	Hydrat
hydrats	noun	Hydrat
graveurs	noun	Graveur
xylofons	noun	Xylofon
mumus	noun	Mumu
gesässes	noun	Gesäss
octane	noun	Octan
weißstorchs	noun	Weißstorch
weißstorches	noun	Weißstorch
kosmologien	noun	Kosmologie
abiture	noun	Abitur
löwchens	noun	Löwchen
posthorns	noun	Posthorn
partitive	noun	Partitiv
partitivs	noun	Partitiv
auflaufs	noun	Auflauf
takts	noun	Takt
festons	noun	Feston
einzahlen	noun	Einzahl
fraße	noun	Fraß
kuren	noun	Kur
soleis	noun	Solei
dioxids	noun	Dioxid
tarifs	noun	Tarif
potts	noun	Pott
wehes	noun	Weh
kanjis	noun	Kanji
manuskripts	noun	Manuskript
forken	noun	Forke
paraments	noun	Parament
immergrüne	noun	Immergrün
nutellas	noun	Nutella
rixes	noun	Rixe
tennisballs	noun	Tennisball
isothermen	noun	Isotherme
isobars	noun	Isobar
ortolane	noun	Ortolan
ortolans	noun	Ortolan
majore	noun	Major
majors	noun	Major
inspektors	noun	Inspektor
juniors	noun	Junior
obersten	noun	Oberst
oberste	noun	Oberst
krams	noun	Kram
anblicks	noun	Anblick
patres	noun	Pater
paters	noun	Pater
lazarettes	noun	Lazarett
bauxite	noun	Bauxit
arboreta	noun	Arboretum
arboretums	noun	Arboretum
waggons	noun	Waggon
eiscrèmes	noun	Eiscrème
fritüren	noun	Fritüre
karamels	noun	Karamel
communiqués	noun	Communiqué
schuhcrèmes	noun	Schuhcrème
sonnencrèmes	noun	Sonnencrème
négligés	noun	Négligé
flash-backs	noun	Flash-back
toreros	noun	Torero
sketches	noun	Sketch
sketchs	noun	Sketch
prions	noun	Prion
solos	noun	Solo
soli	noun	Solo
menagen	noun	Menage
petabytes	noun	Petabyte
entrecotes	noun	Entrecote
habitate	noun	Habitat
habitats	noun	Habitat
habitates	noun	Habitat
stops	noun	Stop
heliometers	noun	Heliometer
täters	noun	Täter
epitaphe	noun	Epitaph
pylone	noun	Pylon
femora	noun	Femur
femurs	noun	Femur
doublés	noun	Doublé
stunts	noun	Stunt
aulas	noun	Aula
anapäste	noun	Anapäst
anapästs	noun	Anapäst
husos	noun	Huso
laichen	noun	Laich
polynome	noun	Polynom
polynoms	noun	Polynom
purpure	noun	Purpur
purpurs	noun	Purpur
rorschachtests	noun	Rorschachtest
huchens	noun	Huchen
woblas	noun	Wobla
toxine	noun	Toxin
toxins	noun	Toxin
fruktosen	noun	Fruktose
shiitakes	noun	Shiitake
politbüros	noun	Politbüro
syndroms	noun	Syndrom
vestibüle	noun	Vestibül
manien	noun	Manie
galas	noun	Gala
brunche	noun	Brunch
brunchs	noun	Brunch
brunches	noun	Brunch
oboloi	noun	Obolus
sexshops	noun	Sexshop
bluffs	noun	Bluff
servals	noun	Serval
balitigers	noun	Balitiger
simplexe	noun	Simplex
kaders	noun	Kader
seppukus	noun	Seppuku
carotins	noun	Carotin
inkarnationen	noun	Inkarnation
grosshändlers	noun	Grosshändler
thalers	noun	Thaler
griffels	noun	Griffel
strassen	noun	Strasse
halos	noun	Halo
rülpse	noun	Rülps
anflüge	noun	Anflug
fässchens	noun	Fässchen
breaks	noun	Break
etymologen	noun	Etymologe
markörs	noun	Markör
tribometers	noun	Tribometer
downers	noun	Downer
farads	noun	Farad
funkers	noun	Funker
zählungen	noun	Zählung
cyborgs	noun	Cyborg
eingüße	noun	Einguß
eingußes	noun	Einguß
zufuhren	noun	Zufuhr
broilers	noun	Broiler
stationen	noun	Station
volten	noun	Volte
spitals	noun	Spital
fenne	noun	Fenn
fenns	noun	Fenn
fennes	noun	Fenn
kwashiorkors	noun	Kwashiorkor
mehlnährschäden	noun	Mehlnährschaden
kibas	noun	Kiba
stramine	noun	Stramin
aussenwände	noun	Aussenwand
schlachters	noun	Schlachter
strings	noun	String
urethane	noun	Urethan
urethans	noun	Urethan
adenine	noun	Adenin
adenins	noun	Adenin
lebensmittelläden	noun	Lebensmittelladen
oxide	noun	Oxid
oxids	noun	Oxid
tamarisken	noun	Tamariske
brennöfen	noun	Brennofen
mucken	noun	Mucke
mongos	noun	Mongo
blinkers	noun	Blinker
archäopteryges	noun	Archäopteryx
avantgardekünste	noun	Avantgardekunst
avantgarde-künste	noun	Avantgarde-Kunst
kummerbunds	noun	Kummerbund
rabenväter	noun	Rabenvater
limite	noun	Limit
putzen	noun	Putze
alabasters	noun	Alabaster
honorare	noun	Honorar
laminate	noun	Laminat
psychothrillers	noun	Psychothriller
beteiligten	noun	Beteiligte
quetzals	noun	Quetzal
randen	noun	Rande
spuke	noun	Spuk
actinoids	noun	Actinoid
antioxidans'	noun	Antioxidans
baryonen	noun	Baryon
baryons	noun	Baryon
deuteriums	noun	Deuterium
monoxide	noun	Monoxid
drücken	noun	Druck
deuteride	noun	Deuterid
deuterons	noun	Deuteron
dichromate	noun	Dichromat
dichromats	noun	Dichromat
dichromates	noun	Dichromat
chromate	noun	Chromat
chromates	noun	Chromat
nitrate	noun	Nitrat
nitrates	noun	Nitrat
sulfate	noun	Sulfat
sulfates	noun	Sulfat
phosphate	noun	Phosphat
phosphates	noun	Phosphat
monoxids	noun	Monoxid
monoxides	noun	Monoxid
pentoxide	noun	Pentoxid
pentoxides	noun	Pentoxid
suboxide	noun	Suboxid
suboxides	noun	Suboxid
tetroxide	noun	Tetroxid
tetroxids	noun	Tetroxid
tetroxides	noun	Tetroxid
trioxide	noun	Trioxid
trioxids	noun	Trioxid
trioxides	noun	Trioxid
dinucleotide	noun	Dinucleotid
nucleotide	noun	Nucleotid
mononucleotide	noun	Mononucleotid
polynucleotide	noun	Polynucleotid
ribonucleotide	noun	Ribonucleotid
fantasten	noun	Fantast
cashflows	noun	Cashflow
big macs	noun	Big Mac
amphotere	noun	Amphoter
amphoteres	noun	Amphoter
elektrons	noun	Elektron
elementen	noun	Element
enthält	verb	enthalten
laß	verb	lass
erzes	noun	Erz
erzen	noun	Erz
europiums	noun	Europium
experimenten	noun	Experiment
flüssen	noun	Fluss
härtungen	noun	Härtung
forschungsgegenstande	noun	Forschungsgegenstand
gasen	noun	Gas
gebieten	noun	Gebiet
gastanks	noun	Gastank
drehe	noun	Dreh
halogene	noun	Halogen
halogens	noun	Halogen
obole	noun	Obolus
oboli	noun	Obolus
hoches	noun	Hoch
hydride	noun	Hydrid
ihres	determiner	ihr
isotopen	noun	Isotop
innere	noun	Inneres
inneren	noun	Inneres
inventare	noun	Inventar
isolatoren	noun	Isolator
katalysatoren	noun	Katalysator
katalysators	noun	Katalysator
kerne	noun	Kern
kerns	noun	Kern
kernes	noun	Kern
suchten	noun	Sucht
komplexes	noun	Komplex
komplexe	noun	Komplex
lagern	noun	Lager
links	noun	Link
litern	noun	Liter
riviere	noun	Rivier
lanthanoids	noun	Lanthanoid
letzten	noun	Letzter
letzten	noun	Letzte
lufttemperaturen	noun	Lufttemperatur
metallen	noun	Metall
minerals	noun	Mineral
minerale	noun	Mineral
nukleons	noun	Nukleon
nukleonen	noun	Nukleon
normaldrucke	noun	Normaldruck
normaldrücke	noun	Normaldruck
orbitals	noun	Orbital
orbitale	noun	Orbital
permafrostböden	noun	Permafrostboden
polyethylene	noun	Polyethylen
gradienten	noun	Gradient
elektrodynamiken	noun	Elektrodynamik
reportes	noun	Report
reporte	noun	Report
schwenke	noun	Schwenk
forschungsgegenstände	noun	Forschungsgegenstand
stoffen	noun	Stoff
spins	noun	Spin
stadiums	noun	Stadium
systemen	noun	System
teilen	noun	Teil
terms	noun	Term
terme	noun	Term
tritiums	noun	Tritium
transplantate	noun	Transplantat
turbogenerators	noun	Turbogenerator
umgangs	noun	Umgang
umgänge	noun	Umgang
umganges	noun	Umgang
unfällen	noun	Unfall
übergängen	noun	Übergang
uploads	noun	Upload
tip	noun	Tipp
tips	noun	Tip
wassers	noun	Wasser
wässer	noun	Wasser
peroxids	noun	Peroxid
peroxide	noun	Peroxid
peroxides	noun	Peroxid
superoxide	noun	Superoxid
superoxides	noun	Superoxid
wegen	noun	Weg
ytterbiums	noun	Ytterbium
yangs	noun	Yang
sättigungsdampfdrücke	noun	Sättigungsdampfdruck
sättigungsdampfdrucke	noun	Sättigungsdampfdruck
zehners	noun	Zehner
spannen	noun	Spanne
bogatyrs	noun	Bogatyr
bogatyri	noun	Bogatyr
atmosphärendrücke	noun	Atmosphärendruck
atmosphärendrucke	noun	Atmosphärendruck
bosonen	noun	Boson
bosons	noun	Boson
cleveite	noun	Cleveit
cleveites	noun	Cleveit
dimere	noun	Dimer
dimers	noun	Dimer
diprotons	noun	Diproton
spangen	noun	Spange
erdmäntel	noun	Erdmantel
expansionen	noun	Expansion
fermionen	noun	Fermion
fermions	noun	Fermion
fermiones	noun	Fermion
gesundheitsschäden	noun	Gesundheitsschaden
heliumhydride	noun	Heliumhydrid
hochdrücke	noun	Hochdruck
hochdrucke	noun	Hochdruck
inertgases	noun	Inertgas
innendrücke	noun	Innendruck
innendrucke	noun	Innendruck
pakte	noun	Pakt
pakts	noun	Pakt
leuchten	noun	Leuchte
mineralen	noun	Mineral
missionen	noun	Mission
millikelvins	noun	Millikelvin
nanometern	noun	Nanometer
natriums	noun	Natrium
nebeln	noun	Nebel
preisen	noun	Preis
rungen	noun	Runge
sieben	noun	Sieb
stählen	noun	Stahl
symptome	noun	Symptom
symptoms	noun	Symptom
spritzers	noun	Spritzer
potten	noun	Pott
zerfällen	noun	Zerfall
ausfällen	noun	Ausfall
akkumulatoren	noun	Akkumulator
akkumulators	noun	Akkumulator
amblygonite	noun	Amblygonit
halogenide	noun	Halogenid
ausfälle	noun	Ausfall
booten	noun	Boot
bombenmäntel	noun	Bombenmantel
caesiums	noun	Caesium
carbonyle	noun	Carbonyl
carbonyls	noun	Carbonyl
eiern	noun	Ei
elastomere	noun	Elastomer
elastomers	noun	Elastomer
elastomeres	noun	Elastomer
grunde	noun	Grund
gründen	noun	Grund
divise	noun	Divis
divises	noun	Divis
flusswässer	noun	Flusswasser
graphite	noun	Graphit
graphites	noun	Graphit
carbonate	noun	Carbonat
amalgame	noun	Amalgam
lagerstätten	noun	Lagerstätte
acetate	noun	Acetat
acetats	noun	Acetat
amide	noun	Amid
amides	noun	Amid
bromide	noun	Bromid
bromids	noun	Bromid
citrats	noun	Citrat
citrates	noun	Citrat
fluoride	noun	Fluorid
fluorids	noun	Fluorid
hexafluorophosphate	noun	Hexafluorophosphat
hexafluorophosphates	noun	Hexafluorophosphat
hydroxide	noun	Hydroxid
iodide	noun	Iodid
iodids	noun	Iodid
metaborate	noun	Metaborat
metaborates	noun	Metaborat
borate	noun	Borat
borates	noun	Borat
niobate	noun	Niobat
nitride	noun	Nitrid
nitrids	noun	Nitrid
perchlorate	noun	Perchlorat
chlorate	noun	Chlorat
stearate	noun	Stearat
tetraborate	noun	Tetraborat
tritide	noun	Tritid
metallstäube	noun	Metallstaub
metallstaube	noun	Metallstaub
methyls	noun	Methyl
olefins	noun	Olefin
alkene	noun	Alken
alkens	noun	Alken
alkane	noun	Alkan
alkans	noun	Alkan
paraffine	noun	Paraffin
pegmatite	noun	Pegmatit
petalite	noun	Petalit
petroleums	noun	Petroleum
psilocybins	noun	Psilocybin
salzen	noun	Salz
schmelzflüsse	noun	Schmelzfluss
schmelzflusse	noun	Schmelzfluss
schmieren	noun	Schmier
sodas	noun	Soda
tetramere	noun	Tetramer
tetramers	noun	Tetramer
tremores	noun	Tremor
tremors	noun	Tremor
triphyline	noun	Triphylin
triphylines	noun	Triphylin
sulfids	noun	Sulfid
sulfides	noun	Sulfid
zinnwaldite	noun	Zinnwaldit
zinnwaldites	noun	Zinnwaldit
abbés	noun	Abbé
alexandrite	noun	Alexandrit
aquamarine	noun	Aquamarin
bertrandite	noun	Bertrandit
carbide	noun	Carbid
telluride	noun	Tellurid
tellurides	noun	Tellurid
edelsteinen	noun	Edelstein
geräten	noun	Gerät
gestirne	noun	Gestirn
gadolinite	noun	Gadolinit
segmenten	noun	Segment
leberschäden	noun	Leberschaden
membranen	noun	Membran
membranen	noun	Membrane
gefässe	noun	Gefäss
gefässes	noun	Gefäss
beryllate	noun	Beryllat
phenakite	noun	Phenakit
bors	noun	Bor
boracite	noun	Boracit
borane	noun	Boran
boride	noun	Borid
borids	noun	Borid
trichloride	noun	Trichlorid
waschnuß	noun	Waschnuss
kicks	noun	Kick
pascals	noun	Pascal
gläsern	noun	Glas
cobalts	noun	Cobalt
colemanite	noun	Colemanit
decahydrate	noun	Decahydrat
elektronenmängel	noun	Elektronenmangel
gigapascals	noun	Gigapascal
ikosaeders	noun	Ikosaeder
ikosaedern	noun	Ikosaeder
kations	noun	Kation
industrien	noun	Industrie
magnete	noun	Magnet
magnetes	noun	Magnet
magnets	noun	Magnet
großflughäfen	noun	Großflughafen
schwerpunkts	noun	Schwerpunkt
schwerpunkte	noun	Schwerpunkt
ausstiege	noun	Ausstieg
orbitalen	noun	Orbital
kernite	noun	Kernit
beläge	noun	Belag
lichtbögen	noun	Lichtbogen
linearmotors	noun	Linearmotor
perborate	noun	Perborat
perborates	noun	Perborat
ehren	noun	Ehre
aerogels	noun	Aerogel
bicarbonate	noun	Bicarbonat
cyanide	noun	Cyanid
cyanids	noun	Cyanid
spielers	noun	Spieler
typografien	noun	Typografie
kristallen	noun	Kristall
fullerene	noun	Fulleren
hohlraums	noun	Hohlraum
kimberlite	noun	Kimberlit
disulfide	noun	Disulfid
disulfids	noun	Disulfid
lonsdaleite	noun	Lonsdaleit
anhydride	noun	Anhydrid
tetraeders	noun	Tetraeder
umfasst	verb	umfassen
amine	noun	Amin
ackerböden	noun	Ackerboden
alkaloids	noun	Alkaloid
alternativen	noun	Alternative
ammoniums	noun	Ammonium
nitrite	noun	Nitrit
azide	noun	Azid
azotometers	noun	Azotometer
chlorophylls	noun	Chlorophyll
cyanogens	noun	Cyanogen
cyans	noun	Cyan
codereviews	noun	Codereview
gewittern	noun	Gewitter
kabeln	noun	Kabel
hydrazine	noun	Hydrazin
hydroxylamine	noun	Hydroxylamin
hyponitrite	noun	Hyponitrit
indikatoren	noun	Indikator
triiodide	noun	Triiodid
nitrile	noun	Nitril
nitrils	noun	Nitril
nitroglycerins	noun	Nitroglycerin
nukleophile	noun	Nukleophil
orthonitrate	noun	Orthonitrat
proteinen	noun	Protein
peptide	noun	Peptid
peptids	noun	Peptid
proteids	noun	Proteid
pyrogallols	noun	Pyrogallol
uracils	noun	Uracil
aldehyden	noun	Aldehyd
alkenen	noun	Alken
abläufe	noun	Ablauf
allotrope	noun	Allotrop
blitzen	noun	Blitz
difluoride	noun	Difluorid
enzymen	noun	Enzym
esters	noun	Ester
ethers	noun	Ether
eosine	noun	Eosin
eosins	noun	Eosin
ethyls	noun	Ethyl
gefäßen	noun	Gefäß
glimmers	noun	Glimmer
halogenen	noun	Halogen
iods	noun	Iod
heteroatome	noun	Heteroatom
heteroatoms	noun	Heteroatom
homodimers	noun	Homodimer
hydroxyaldehyde	noun	Hydroxyaldehyd
hydroxyketone	noun	Hydroxyketon
hyperoxide	noun	Hyperoxid
hypochlorite	noun	Hypochlorit
chlorite	noun	Chlorit
hypothalami	noun	Hypothalamus
thalami	noun	Thalamus
kaliumhydroxids	noun	Kaliumhydroxid
permanganate	noun	Permanganat
manganate	noun	Manganat
sedimente	noun	Sediment
sediments	noun	Sediment
sedimentes	noun	Sediment
methanals	noun	Methanal
methanols	noun	Methanol
anione	noun	Anion
anions	noun	Anion
peroxiden	noun	Peroxid
problemen	noun	Problem
natriumhydroxids	noun	Natriumhydroxid
oxidasen	noun	Oxidase
ozonide	noun	Ozonid
phenanthroline	noun	Phenanthrolin
phenols	noun	Phenol
phlogistons	noun	Phlogiston
stähle	noun	Stahl
schneiden	noun	Schneide
balls	noun	Ball
balles	noun	Ball
silicate	noun	Silicat
teildrucke	noun	Teildruck
teildrücke	noun	Teildruck
thiosulfate	noun	Thiosulfat
vitriols	noun	Vitriol
zweier	numeral	zwei
befasst	verb	befassen
hotkeys	noun	Hotkey
shortcuts	noun	Shortcut
abstoßungen	noun	Abstoßung
auswürfe	noun	Auswurf
beschäftigte	verb	beschäftigen
betrieb	verb	betreiben
blättern	noun	Blatt
trifluoride	noun	Trifluorid
einbauten	noun	Einbau
einbaue	noun	Einbau
fluors	noun	Fluor
acetamids	noun	Acetamid
fluorapatite	noun	Fluorapatit
fluorite	noun	Fluorit
schüppen	noun	Schüppe
interhalogens	noun	Interhalogen
isomere	noun	Isomer
isomers	noun	Isomer
lungenschäden	noun	Lungenschaden
ödeme	noun	Ödem
tetrafluoride	noun	Tetrafluorid
polyolefine	noun	Polyolefin
polyolefins	noun	Polyolefin
trakts	noun	Trakt
verläuft	verb	verlaufen
regalien	noun	Regal
airports	noun	Airport
hexafluoride	noun	Hexafluorid
sellaite	noun	Sellait
tenside	noun	Tensid
topase	noun	Topas
topases	noun	Topas
anstiege	noun	Anstieg
neons	noun	Neon
clathrate	noun	Clathrat
fraktionen	noun	Fraktion
abführt	verb	abführen
anfällen	noun	Anfall
äußeren	noun	Äußere
schubs	noun	Schub
albite	noun	Albit
alkalis	noun	Alkali
angiotensine	noun	Angiotensin
angiotensins	noun	Angiotensin
axone	noun	Axon
axons	noun	Axon
bränden	noun	Brand
behelfe	noun	Behelf
brüters	noun	Brüter
chloroforms	noun	Chloroform
cytosols	noun	Cytosol
dimeren	noun	Dimer
halite	noun	Halit
halons	noun	Halon
kaliums	noun	Kalium
ketonen	noun	Keton
kaliummängel	noun	Kaliummangel
niederländischen	noun	Niederländisch
natriummängel	noun	Natriummangel
neurotransmitters	noun	Neurotransmitter
polymeren	noun	Polymer
resten	noun	Rest
renins	noun	Renin
schnellen	noun	Schnelle
seren	noun	Serum
serums	noun	Serum
steige	noun	Steig
straßenverkehrs	noun	Straßenverkehr
thiole	noun	Thiol
thiols	noun	Thiol
tracers	noun	Tracer
zirconiums	noun	Zirconium
abriebe	noun	Abrieb
aerosols	noun	Aerosol
aspartate	noun	Aspartat
drinks	noun	Drink
spate	noun	Spat
spats	noun	Spat
coenzyme	noun	Coenzym
erwachsenen	noun	Erwachsener
erwachsenen	noun	Erwachsene
gluconate	noun	Gluconat
granulate	noun	Granulat
heilwässer	noun	Heilwasser
heptahydrate	noun	Heptahydrat
konzentrationsmängel	noun	Konzentrationsmangel
magnesiums	noun	Magnesium
magnesite	noun	Magnesit
magnesiumhydroxids	noun	Magnesiumhydroxid
magnesiummängel	noun	Magnesiummangel
magnesiumoxids	noun	Magnesiumoxid
niederschlägen	noun	Niederschlag
oxiden	noun	Oxid
olivine	noun	Olivin
oxine	noun	Oxin
sulfaten	noun	Sulfat
schmelzöfen	noun	Schmelzofen
serpentins	noun	Serpentin
spinelle	noun	Spinell
trögen	noun	Trog
zunders	noun	Zunder
alaune	noun	Alaun
aluminiums	noun	Aluminium
akdalaite	noun	Akdalait
aluminate	noun	Aluminat
metaphosphate	noun	Metaphosphat
orthophosphate	noun	Orthophosphat
oxynitride	noun	Oxynitrid
polyphosphate	noun	Polyphosphat
antitranspirante	noun	Antitranspirant
antitranspirants	noun	Antitranspirant
steines	noun	Stein
corsage	noun	Korsage
bodys	noun	Body
ledermäntel	noun	Ledermantel
metropolen	noun	Metropole
metropolen	noun	Metropolis
drehrohröfen	noun	Drehrohrofen
feinstes	noun	Feinste
fließe	noun	Fließ
läßt	verb	lässt
mußte	verb	musste
müßten	verb	müssten
müßte	verb	müsste
installationen	noun	Installation
kilogramme	noun	Kilogramm
kontakten	noun	Kontakt
kriechen	noun	Krieche
kontaktdrücke	noun	Kontaktdruck
kontaktdrucke	noun	Kontaktdruck
lands	noun	Land
löchern	noun	Loch
modellen	noun	Modell
orten	noun	Ort
milligramme	noun	Milligramm
phenolphthaleins	noun	Phenolphthalein
pigmente	noun	Pigment
pigments	noun	Pigment
pigmentes	noun	Pigment
präparate	noun	Präparat
stillen	noun	Stille
sorten	noun	Sorte
riegels	noun	Riegel
tetraedern	noun	Tetraeder
werten	noun	Wert
wächst	verb	wachsen
zeolithe	noun	Zeolith
verschleiße	noun	Verschleiß
wavellite	noun	Wavellit
übertragers	noun	Übertrager
artikeln	noun	Artikel
angesichts	noun	Angesicht
drehen	noun	Dreh
carbosilane	noun	Carbosilan
köppe	noun	Kopp
kopps	noun	Kopp
hexafluorosilicate	noun	Hexafluorosilicat
kälbern	noun	Kalb
lautet	verb	lauten
obsidians	noun	Obsidian
orthosilicate	noun	Orthosilicat
polysilane	noun	Polysilan
silane	noun	Silan
aaß	noun	Aas
reduktionsöfen	noun	Reduktionsofen
schwarzes	noun	Schwarz
siliciums	noun	Silicium
silikone	noun	Silikon
stäbe	noun	Stab
stabs	noun	Stab
stücken	noun	Stück
stumpens	noun	Stumpen
silicide	noun	Silicid
tetrachloride	noun	Tetrachlorid
silicone	noun	Silicon
silicons	noun	Silicon
texten	noun	Text
apatite	noun	Apatit
additive	noun	Additiv
alkoxys	noun	Alkoxy
molybdate	noun	Molybdat
molybdophosphate	noun	Molybdophosphat
anthocyane	noun	Anthocyan
anthocyans	noun	Anthocyan
aspartame	noun	Aspartam
berners	noun	Berner
bisphosphonate	noun	Bisphosphonat
coenzymen	noun	Coenzym
calciumphosphate	noun	Calciumphosphat
diphosphate	noun	Diphosphat
diphosphonate	noun	Diphosphonat
phosphonate	noun	Phosphonat
erosionen	noun	Erosion
guanos	noun	Guano
habitus'	noun	Habitus
heptamolybdate	noun	Heptamolybdat
hydroxylapatite	noun	Hydroxylapatit
hypophosphite	noun	Hypophosphit
phosphite	noun	Phosphit
lipiden	noun	Lipid
lichtbogenöfen	noun	Lichtbogenofen
lipide	noun	Lipid
lipids	noun	Lipid
mols	noun	Mol
meeresvögel	noun	Meeresvogel
kursaals	noun	Kursaal
peroxodiphosphate	noun	Peroxodiphosphat
peroxophosphate	noun	Peroxophosphat
phosphane	noun	Phosphan
phosphazene	noun	Phosphazen
phosphide	noun	Phosphid
phosphids	noun	Phosphid
phosphine	noun	Phosphin
phosphinate	noun	Phosphinat
phospholipide	noun	Phospholipid
phospholipids	noun	Phospholipid
phosphorite	noun	Phosphorit
pentachloride	noun	Pentachlorid
pentasulfide	noun	Pentasulfid
polyamide	noun	Polyamid
quarzsande	noun	Quarzsand
quarzsände	noun	Quarzsand
feuchten	noun	Feuchte
roten	noun	Rote
superphosphate	noun	Superphosphat
unterschieden	noun	Unterschied
autobiographie	noun	Autobiografie
viewports	noun	Viewport
renderers	noun	Renderer
thiophosphate	noun	Thiophosphat
allotropen	noun	Allotrop
absorbers	noun	Absorber
aggregate	noun	Aggregat
aggregates	noun	Aggregat
allicins	noun	Allicin
alliins	noun	Alliin
analoga	noun	Analogon
analogons	noun	Analogon
pentafluoride	noun	Pentafluorid
aragonite	noun	Aragonit
binders	noun	Binder
biotins	noun	Biotin
bleichen	noun	Bleiche
camps	noun	Camp
lärms	noun	Lärm
lärmes	noun	Lärm
caprolactams	noun	Caprolactam
connellite	noun	Connellit
cyanotrichite	noun	Cyanotrichit
cysteine	noun	Cystein
cysteins	noun	Cystein
cystine	noun	Cystin
designs	noun	Design
disulfane	noun	Disulfan
disulfate	noun	Disulfat
disulfite	noun	Disulfit
sulfite	noun	Sulfit
dithiolane	noun	Dithiolan
dithionate	noun	Dithionat
dithionite	noun	Dithionit
epoxide	noun	Epoxid
ethoxylate	noun	Ethoxylat
evaporite	noun	Evaporit
fetten	noun	Fett
schwamm	verb	schwimmen
ferredoxine	noun	Ferredoxin
ferredoxins	noun	Ferredoxin
golfe	noun	Golf
golfes	noun	Golf
grüne	noun	Grüner
grüne	noun	Grünes
globine	noun	Globin
globins	noun	Globin
glutathions	noun	Glutathion
grünen	noun	Grüner
grünen	noun	Grüne
hinterlässt	verb	hinterlassen
heteroelements	noun	Heteroelement
indonesiens	noun	Indonesien
komplexen	noun	Komplex
pyrosulfite	noun	Pyrosulfit
kaolins	noun	Kaolin
kesselwägen	noun	Kesselwagen
lavaflüsse	noun	Lavafluss
lavaflusse	noun	Lavafluss
leadhillite	noun	Leadhillit
legens	noun	Legen
mercaptans	noun	Mercaptan
metalloide	noun	Metalloid
metalloids	noun	Metalloid
metalloides	noun	Metalloid
noseans	noun	Nosean
phytoplanktons	noun	Phytoplankton
polysulfane	noun	Polysulfan
polysulfide	noun	Polysulfid
pyrophosphate	noun	Pyrophosphat
schritten	noun	Schritt
sedimenten	noun	Sediment
sulfiden	noun	Sulfid
dichloride	noun	Dichlorid
schwertmannite	noun	Schwertmannit
substituents	noun	Substituent
sulfonate	noun	Sulfonat
sulfone	noun	Sulfon
sulfoxide	noun	Sulfoxid
sulfoxylate	noun	Sulfoxylat
taurins	noun	Taurin
terpineols	noun	Terpineol
thioacetals	noun	Thioacetal
acetale	noun	Acetal
acetals	noun	Acetal
thioesters	noun	Thioester
thioethers	noun	Thioether
thioredoxine	noun	Thioredoxin
thioredoxins	noun	Thioredoxin
thiosulfite	noun	Thiosulfit
trachome	noun	Trachom
vulkanen	noun	Vulkan
xanthogenate	noun	Xanthogenat
xylems	noun	Xylem
ylide	noun	Ylid
ylids	noun	Ylid
alkanen	noun	Alkan
chromophore	noun	Chromophor
dibenzofurans	noun	Dibenzofuran
gehalte	noun	Gehalt
elektrophile	noun	Elektrophil
gegenions	noun	Gegenion
hydrogencarbonate	noun	Hydrogencarbonat
lignine	noun	Lignin
lignins	noun	Lignin
magensäfte	noun	Magensaft
oxoniums	noun	Oxonium
produkten	noun	Produkt
schwämmen	noun	Schwamm
argons	noun	Argon
basalten	noun	Basalt
prozeß	noun	Prozess
fluorohydride	noun	Fluorohydrid
hydrochinone	noun	Hydrochinon
aspekten	noun	Aspekt
becquerels	noun	Becquerel
butanols	noun	Butanol
hormonen	noun	Hormon
kainite	noun	Kainit
kainits	noun	Kainit
ausreden	noun	Ausrede
bromate	noun	Bromat
hexachloroplatinate	noun	Hexachloroplatinat
hexacyanoferrate	noun	Hexacyanoferrat
iodate	noun	Iodat
thiocyanate	noun	Thiocyanat
cyanate	noun	Cyanat
modulators	noun	Modulator
phloems	noun	Phloem
propanols	noun	Propanol
strassenverkehrs	noun	Strassenverkehr
zuckern	noun	Zucker
stomata	noun	Stoma
stomas	noun	Stoma
sylvinite	noun	Sylvinit
tartrate	noun	Tartrat
tetrahydrofurans	noun	Tetrahydrofuran
calciums	noun	Calcium
amaranten	noun	Amarant
amarants	noun	Amarant
amarantes	noun	Amarant
broccolis	noun	Broccoli
calcitonins	noun	Calcitonin
acetylide	noun	Acetylid
lactate	noun	Lactat
propionate	noun	Propionat
globuline	noun	Globulin
globulins	noun	Globulin
muskulaturen	noun	Muskulatur
oxalate	noun	Oxalat
parathormone	noun	Parathormon
phytate	noun	Phytat
schwangeren	noun	Schwangere
smilodons	noun	Smilodon
berylle	noun	Beryll
berylls	noun	Beryll
graue eminenzen	noun	graue Eminenz
weißrussischen	noun	Weißrussisch
bazzite	noun	Bazzit
euxenite	noun	Euxenit
kolbeckite	noun	Kolbeckit
thortveitite	noun	Thortveitit
wolframite	noun	Wolframit
vereinen	noun	Verein
titanate	noun	Titanat
biomaterials	noun	Biomaterial
cermets	noun	Cermet
fräsers	noun	Fräser
geistlichen	noun	Geistliche
goldfarben	noun	Goldfarbe
ilmenite	noun	Ilmenit
prothesen	noun	Prothese
kranke	noun	Kranker
kranken	noun	Kranker
kranken	noun	Kranke
schillings	noun	Schilling
titaniums	noun	Titanium
laders	noun	Lader
verbunde	noun	Verbund
polyvanadate	noun	Polyvanadat
vanadate	noun	Vanadat
descloizite	noun	Descloizit
ferrovanadiums	noun	Ferrovanadium
magnetite	noun	Magnetit
magnetits	noun	Magnetit
metallocene	noun	Metallocen
ferrocene	noun	Ferrocen
metalloproteine	noun	Metalloprotein
metalloproteins	noun	Metalloprotein
mineralogen	noun	Mineraloge
metavanadate	noun	Metavanadat
photographie	noun	Fotografie
patronite	noun	Patronit
röstens	noun	Rösten
triglyceride	noun	Triglycerid
diglyceride	noun	Diglycerid
monoglyceride	noun	Monoglycerid
glyceride	noun	Glycerid
glycerids	noun	Glycerid
vanadiums	noun	Vanadium
vanadinite	noun	Vanadinit
vanadocene	noun	Vanadocen
bipyridine	noun	Bipyridin
chromite	noun	Chromit
dihydrate	noun	Dihydrat
extreme	noun	Extrem
extrems	noun	Extrem
ferchromide	noun	Ferchromid
safrans	noun	Safran
ausfällt	verb	ausfallen
ferrite	noun	Ferrit
geometrien	noun	Geometrie
instrumenten	noun	Instrument
mangans	noun	Mangan
glutamate	noun	Glutamat
hypobromite	noun	Hypobromit
hypomanganate	noun	Hypomanganat
ligasen	noun	Ligase
lysosomen	noun	Lysosom
manganins	noun	Manganin
manganite	noun	Manganit
manganocene	noun	Manganocen
photosystems	noun	Photosystem
pyruvate	noun	Pyruvat
rhodochrosite	noun	Rhodochrosit
rhodonite	noun	Rhodonit
symptomen	noun	Symptom
alten	noun	Alter
alten	noun	Alte
ägyptischen	noun	Ägyptisch
agentia	noun	Agens
azteken	noun	Azteke
dämpfen	noun	Dampf
curiepunkts	noun	Curiepunkt
cytochrome	noun	Cytochrom
pentacarbonyls	noun	Pentacarbonyl
eisenmängel	noun	Eisenmangel
elektromotoren	noun	Elektromotor
elektroöfen	noun	Elektroofen
beauftragte	noun	Beauftragter
funde	noun	Fund
fünde	noun	Fund
funds	noun	Fund
fundes	noun	Fund
funden	noun	Fund
gräbern	noun	Grab
ferritine	noun	Ferritin
ferritins	noun	Ferritin
füllers	noun	Füller
hochöfen	noun	Hochofen
inkas	noun	Inka
häms	noun	Häm
hämatite	noun	Hämatit
hämerythrins	noun	Hämerythrin
hämosiderins	noun	Hämosiderin
kräften	noun	Kraft
kamacite	noun	Kamacit
limonite	noun	Limonit
mancher	pronoun	manch
meteorite	noun	Meteorit
meteorits	noun	Meteorit
muffeln	noun	Muffel
elben	noun	Elb
roben	noun	Robe
hellers	noun	Heller
melanterite	noun	Melanterit
myoglobins	noun	Myoglobin
octene	noun	Octen
oolithe	noun	Oolith
ooliths	noun	Oolith
organophosphine	noun	Organophosphin
pyrrhotine	noun	Pyrrhotin
rhodanide	noun	Rhodanid
schiffen	noun	Schiff
schachtöfen	noun	Schachtofen
siderite	noun	Siderit
sinters	noun	Sinter
taenite	noun	Taenit
transferrine	noun	Transferrin
transferrins	noun	Transferrin
knieen	verb	knien
frauenfüße	noun	Frauenfuß
frauenfußes	noun	Frauenfuß
frauenfüsse	noun	Frauenfuss
frauenfusses	noun	Frauenfuss
männerfüße	noun	Männerfuß
männerfußes	noun	Männerfuß
menschenfüsse	noun	Menschenfuss
menschenfusses	noun	Menschenfuss
menschenfüße	noun	Menschenfuß
menschenfußes	noun	Menschenfuß
männerfüsse	noun	Männerfuss
männerfusses	noun	Männerfuss
wüchse	noun	Wuchs
zuschläge	noun	Zuschlag
zuschlägen	noun	Zuschlag
wüstite	noun	Wüstit
rockbands	noun	Rockband
teeren	noun	Teer
schönen	noun	Schöne
azurite	noun	Azurit
bakterizide	noun	Bakterizid
bornite	noun	Bornit
cornwallite	noun	Cornwallit
cupalite	noun	Cupalit
verzichte	noun	Verzicht
nomina	noun	Nomen
grafiken	noun	Grafik
native speakers	noun	native Speaker
native speakers	noun	Native Speaker
hämocyanins	noun	Hämocyanin
organen	noun	Organ
magnetrons	noun	Magnetron
morbi	noun	Morbus
pumpellyite	noun	Pumpellyit
toners	noun	Toner
acyloine	noun	Acyloin
acyloins	noun	Acyloin
antagonisten	noun	Antagonist
arylamine	noun	Arylamin
auxiliare	noun	Auxiliar
auxiliars	noun	Auxiliar
beschläge	noun	Beschlag
falzen	noun	Falz
gesimsen	noun	Gesims
hemimorphite	noun	Hemimorphit
augeninnendrücke	noun	Augeninnendruck
augeninnendrucke	noun	Augeninnendruck
rammelsbergite	noun	Rammelsbergit
redoxpotentials	noun	Redoxpotential
sphalerite	noun	Sphalerit
unmute	noun	Unmut
zinken	noun	Zinke
sektoren	noun	Sektor
sektors	noun	Sektor
abfällen	noun	Abfall
französischen	noun	Französisch
rekorden	noun	Rekord
pedelecs	noun	Pedelec
gallane	noun	Gallan
gallans	noun	Gallan
gallate	noun	Gallat
antimonide	noun	Antimonid
arsenide	noun	Arsenid
indiums	noun	Indium
rhodamine	noun	Rhodamin
rhodamins	noun	Rhodamin
symmetrien	noun	Symmetrie
mutexes	noun	Mutex
einfluß	noun	Einfluss
germaniums	noun	Germanium
glutathione	noun	Glutathion
porte	noun	Port
übernahmen	noun	Übernahme
argyrodite	noun	Argyrodit
canfieldite	noun	Canfieldit
cytostatika	noun	Cytostatikum
freibergite	noun	Freibergit
germanate	noun	Germanat
organogermane	noun	Organogerman
vertriebe	noun	Vertrieb
gotts	noun	Gott
dahin gehend	adjective	dahingehend
pullis	noun	Pulli
wichse	verb	wichsen
salons	noun	Salon
firmaments	noun	Firmament
serverzugriffs	noun	Serverzugriff
serverzugriffes	noun	Serverzugriff
serverzugriffe	noun	Serverzugriff
server-zugriffs	noun	Server-Zugriff
server-zugriffes	noun	Server-Zugriff
server-zugriffe	noun	Server-Zugriff
servers	noun	Server
potentials	noun	Potential
lampions	noun	Lampion
beschäftigter	noun	Beschäftigte
strippen	noun	Strippe
beschäftigte	noun	Beschäftigter
beschäftigten	noun	Beschäftigter
beschäftigten	noun	Beschäftigte
sperren	noun	Sperre
zetteln	noun	Zettel
timeouts	noun	Timeout
beta versions	noun	beta version
panels	noun	Panel
tooltips	noun	Tooltip
screencasts	noun	Screencast
wanderwörter	noun	Wanderwort
wanderworts	noun	Wanderwort
quinnats	noun	Quinnat
appaloosas	noun	Appaloosa
parkas	noun	Parka
pingos	noun	Pingo
tupilaks	noun	Tupilak
kajaks	noun	Kajak
worten	noun	Wort
warts	noun	Wart
sprachbünde	noun	Sprachbund
genickschüsse	noun	Genickschuss
genickschusse	noun	Genickschuss
balten	noun	Balte
tattoos	noun	Tattoo
arrests	noun	Arrest
arrestes	noun	Arrest
arreste	noun	Arrest
schritttempos	noun	Schritttempo
schritt-tempo	noun	Schritttempo
schritt-tempos	noun	Schritt-Tempo
arresten	noun	Arrest
fechters	noun	Fechter
bads	noun	Bad
bades	noun	Bad
karers	noun	Karer
casino	noun	Kasino
casinos	noun	Casino
bombers	noun	Bomber
deklarationen	noun	Deklaration
mahnmals	noun	Mahnmal
schwatze	noun	Schwatz
steuerwägen	noun	Steuerwagen
snowboards	noun	Snowboard
blagen	noun	Blag
blags	noun	Blag
zöch	noun	Zoch
treffers	noun	Treffer
rahnen	noun	Rahne
anläufe	noun	Anlauf
käbbeln	verb	kebbeln
baslers	noun	Basler
klienten	noun	Klient
galgenvögel	noun	Galgenvogel
ansagen	noun	Ansage
vorgaben	noun	Vorgabe
plurals	noun	Plural
plurale	noun	Plural
singulars	noun	Singular
schalldichten	noun	Schalldichte
mittags	noun	Mittag
verträgen	noun	Vertrag
skuas	noun	Skua
eiße	noun	Eiß
eißes	noun	Eiß
eisse	noun	Eiss
eisses	noun	Eiss
kontinua	noun	Kontinuum
fittige	noun	Fittig
allemontite	noun	Allemontit
schwirrvögel	noun	Schwirrvogel
nägeln	noun	Nagel
aluminiumgalliumarsenide	noun	Aluminiumgalliumarsenid
arsane	noun	Arsan
arsenite	noun	Arsenit
arsenobetaine	noun	Arsenobetain
betaine	noun	Betain
arsenocholine	noun	Arsenocholin
choline	noun	Cholin
arsenolipids	noun	Arsenolipid
arsenopyrite	noun	Arsenopyrit
arsine	noun	Arsin
arsins	noun	Arsin
arsphenamine	noun	Arsphenamin
bundeslandern	noun	Bundesland
dokumenten	noun	Dokument
fischen	noun	Fisch
deutsche doggen	noun	Deutsche Dogge
geysiren	noun	Geysir
griechischen	noun	Griechisch
haaren	noun	Haar
hämoglobins	noun	Hämoglobin
auripigments	noun	Auripigment
biosensors	noun	Biosensor
calciumarsenate	noun	Calciumarsenat
cobaltite	noun	Cobaltit
diarsane	noun	Diarsan
domeykite	noun	Domeykit
duranusite	noun	Duranusit
dysenterien	noun	Dysenterie
enargite	noun	Enargit
erhalte	noun	Erhalt
gelbe	noun	Gelbes
gelben	noun	Gelbes
gelber	noun	Gelbes
gersdorffite	noun	Gersdorffit
glycolipide	noun	Glycolipid
glycolipids	noun	Glycolipid
glycolipides	noun	Glycolipid
hexahydrate	noun	Hexahydrat
hexahydrates	noun	Hexahydrat
indiumarsenide	noun	Indiumarsenid
inhibitors	noun	Inhibitor
kernen	noun	Kern
ausserdem	adverb	außerdem
geisers	noun	Geiser
lavendelwässer	noun	Lavendelwasser
lewisite	noun	Lewisit
luminometers	noun	Luminometer
löllingite	noun	Löllingit
metallothioneine	noun	Metallothionein
metallothioneins	noun	Metallothionein
schafen	noun	Schaf
gewichten	noun	Gewicht
wassern	noun	Wasser
affixen	noun	Affix
assen	noun	As
bluten	noun	Blut
fluiden	noun	Fluid
gelen	noun	Gel
giften	noun	Gift
glasen	noun	Glas
idiomen	noun	Idiom
kondomen	noun	Kondom
loten	noun	Lot
malen	noun	Mal
papieren	noun	Papier
potentialen	noun	Potential
rechten	noun	Recht
reichen	noun	Reich
spielen	noun	Spiel
talenten	noun	Talent
broten	noun	Brot
schildern	noun	Schild
segeln	noun	Segel
frühstücken	noun	Frühstück
maßen	noun	Maß
ufern	noun	Ufer
stieren	noun	Stier
gerüchten	noun	Gerücht
gliedern	noun	Glied
kinnen	noun	Kinn
riffen	noun	Riff
urteilen	noun	Urteil
wundern	noun	Wunder
silikonen	noun	Silikon
motiven	noun	Motiv
angeboten	noun	Angebot
mikrofonen	noun	Mikrofon
programmen	noun	Programm
objekten	noun	Objekt
kilogrammen	noun	Kilogramm
gesäßen	noun	Gesäß
anagrammen	noun	Anagramm
salären	noun	Salär
implantaten	noun	Implantat
xylofonen	noun	Xylofon
gesässen	noun	Gesäss
abteilen	noun	Abteil
energiezustanden	noun	Energiezustand
elastomeren	noun	Elastomer
acetaten	noun	Acetat
citraten	noun	Citrat
tetrameren	noun	Tetramer
cyaniden	noun	Cyanid
aerosolen	noun	Aerosol
fließen	noun	Fließ
pigmenten	noun	Pigment
elektrophilen	noun	Elektrophil
propanolen	noun	Propanol
gestellen	noun	Gestell
dekoren	noun	Dekor
extremen	noun	Extrem
bakteriziden	noun	Bakterizid
auxiliaren	noun	Auxiliar
pulvers	noun	Pulver
nanogramme	noun	Nanogramm
picometers	noun	Picometer
proustite	noun	Proustit
realgars	noun	Realgar
repressors	noun	Repressor
schillers	noun	Schiller
safflorite	noun	Safflorit
salvarsans	noun	Salvarsan
saumfarne	noun	Saumfarn
skutterudite	noun	Skutterudit
stimulantia	noun	Stimulans
sulfonamide	noun	Sulfonamid
sulfonamides	noun	Sulfonamid
triarsane	noun	Triarsan
trimethylarsine	noun	Trimethylarsin
triphosphate	noun	Triphosphat
uhrglasnägel	noun	Uhrglasnagel
whitneyite	noun	Whitneyit
zwanzigers	noun	Zwanziger
gemüsegärten	noun	Gemüsegarten
begriffen	noun	Begriff
käsen	noun	Käse
armen	noun	Arm
graden	noun	Grad
hunden	noun	Hund
kilometern	noun	Kilometer
monden	noun	Mond
negern	noun	Neger
rauchen	noun	Rauch
smaragden	noun	Smaragd
steinen	noun	Stein
tangen	noun	Tang
tigern	noun	Tiger
toden	noun	Tod
tonen	noun	Ton
trollen	noun	Troll
pfiffen	noun	Pfiff
spiegeln	noun	Spiegel
igeln	noun	Igel
schilden	noun	Schild
keimen	noun	Keim
töpfern	noun	Töpfer
blicken	noun	Blick
zundern	noun	Zunder
meisseln	noun	Meissel
zaubern	noun	Zauber
bernsteinen	noun	Bernstein
schauern	noun	Schauer
hufen	noun	Huf
rissen	noun	Riss
befehlen	noun	Befehl
bügeln	noun	Bügel
breien	noun	Brei
diensten	noun	Dienst
dochten	noun	Docht
fönen	noun	Fön
geizen	noun	Geiz
graten	noun	Grat
hauchen	noun	Hauch
kielen	noun	Kiel
knicken	noun	Knick
säbeln	noun	Säbel
reimen	noun	Reim
rucken	noun	Ruck
schäfern	noun	Schäfer
siegen	noun	Sieg
stapeln	noun	Stapel
stegen	noun	Steg
stielen	noun	Stiel
streichen	noun	Streich
streiten	noun	Streit
lenzen	noun	Lenz
talgen	noun	Talg
teigen	noun	Teig
trieben	noun	Trieb
wechseln	noun	Wechsel
pulsaren	noun	Pulsar
pudeln	noun	Pudel
salaten	noun	Salat
ausdrucken	noun	Ausdruck
stilen	noun	Stil
lippenstiften	noun	Lippenstift
kommentaren	noun	Kommentar
berufen	noun	Beruf
balkonen	noun	Balkon
kompassen	noun	Kompass
ausgleichen	noun	Ausgleich
beweisen	noun	Beweis
trakten	noun	Trakt
dialekten	noun	Dialekt
elektrikern	noun	Elektriker
kritikern	noun	Kritiker
abschnitten	noun	Abschnitt
gehalten	noun	Gehalt
hinweisen	noun	Hinweis
belegen	noun	Beleg
beryllen	noun	Beryll
historikern	noun	Historiker
appellen	noun	Appell
anstiegen	noun	Anstieg
föhnen	noun	Föhn
bossen	noun	Boss
rabatten	noun	Rabatt
veterinären	noun	Veterinär
schweifen	noun	Schweif
einstiegen	noun	Einstieg
berichten	noun	Bericht
amphoteren	noun	Amphoter
reporten	noun	Report
pakten	noun	Pakt
topasen	noun	Topas
behelfen	noun	Behelf
abrieben	noun	Abrieb
verschleißen	noun	Verschleiß
chromophoren	noun	Chromophor
elektromagneten	noun	Elektromagnet
verbunden	noun	Verbund
magnetiten	noun	Magnetit
safranen	noun	Safran
kulten	noun	Kult
vertrieben	noun	Vertrieb
eißen	noun	Eiß
eissen	noun	Eiss
erhalten	noun	Erhalt
abstracts	noun	Abstract
kullern	noun	Kuller
selenide	noun	Selenid
clausthalite	noun	Clausthalit
diselane	noun	Diselan
diselenide	noun	Diselenid
distrikte	noun	Distrikt
distrikts	noun	Distrikt
graphitrohröfen	noun	Graphitrohrofen
niggers	noun	Nigger
selenite	noun	Selenit
naumannite	noun	Naumannit
normalpotentials	noun	Normalpotential
selens	noun	Selen
spermien	noun	Spermium
selane	noun	Selan
selenate	noun	Selenat
selenmängel	noun	Selenmangel
selenols	noun	Selenol
selenone	noun	Selenon
selenophosphate	noun	Selenophosphat
selenoproteine	noun	Selenoprotein
selenoproteins	noun	Selenoprotein
selenoxide	noun	Selenoxid
telluriums	noun	Tellurium
thyroxins	noun	Thyroxin
tragante	noun	Tragant
tragantes	noun	Tragant
triselane	noun	Triselan
triselenide	noun	Triselenid
panoramata	noun	Panorama
alkyle	noun	Alkyl
alkyls	noun	Alkyl
biphenyle	noun	Biphenyl
biphenyls	noun	Biphenyl
epilepsien	noun	Epilepsie
europäers	noun	Europäer
polieren	noun	Polier
dibenzodioxins	noun	Dibenzodioxin
tribromide	noun	Tribromid
parsecs	noun	Parsec
kryptons	noun	Krypton
kloni	noun	Klonus
comics	noun	Comic
cyclodextrine	noun	Cyclodextrin
cyclodextrins	noun	Cyclodextrin
dextrine	noun	Dextrin
dextrins	noun	Dextrin
excimerlasers	noun	Excimerlaser
kiloparsecs	noun	Kiloparsec
oligosaccharide	noun	Oligosaccharid
starters	noun	Starter
getters	noun	Getter
leucite	noun	Leucit
formiate	noun	Formiat
rubidiumoxide	noun	Rubidiumoxid
pentaborate	noun	Pentaborat
periodate	noun	Periodat
tetrahydrate	noun	Tetrahydrat
normale	noun	Normal
normals	noun	Normal
chelate	noun	Chelat
isopropanols	noun	Isopropanol
liquidators	noun	Liquidator
pentamethylcyclopentadienyls	noun	Pentamethylcyclopentadienyl
permanentmagnets	noun	Permanentmagnet
ranelate	noun	Ranelat
strontiums	noun	Strontium
strontianite	noun	Strontianit
witherite	noun	Witherit
zooplanktons	noun	Zooplankton
schatze	noun	Schatz
schätzen	noun	Schatz
luminophore	noun	Luminophor
monazite	noun	Monazit
radioisotope	noun	Radioisotop
urans	noun	Uran
yttriums	noun	Yttrium
xenotime	noun	Xenotim
ytterbite	noun	Ytterbit
baddeleyite	noun	Baddeleyit
eudialyte	noun	Eudialyt
homologe	noun	Homolog
homologs	noun	Homolog
polypropylene	noun	Polypropylen
pulverformen	noun	Pulverform
teleskopen	noun	Teleskop
vakuums	noun	Vakuum
terminals	noun	Terminal
zircaloys	noun	Zircaloy
tetraiodide	noun	Tetraiodid
drähten	noun	Draht
edelstahle	noun	Edelstahl
edelstähle	noun	Edelstahl
dates	noun	Date
coltans	noun	Coltan
columbite	noun	Columbit
columbiums	noun	Columbium
gasturbinen	noun	Gasturbine
großen	noun	Große
zehnten	numeral	zehnte
beschäftigtem	noun	Beschäftigter
deutschem	noun	Deutscher
junger	noun	Junges
jungem	noun	Junges
niobs	noun	Niob
tantals	noun	Tantal
heptafluoroniobate	noun	Heptafluoroniobat
resonators	noun	Resonator
loparite	noun	Loparit
metallurgen	noun	Metallurg
niobite	noun	Niobit
olmsteadite	noun	Olmsteadit
piercings	noun	Piercing
pyrochlore	noun	Pyrochlor
samarskite	noun	Samarskit
tantalite	noun	Tantalit
vanadins	noun	Vanadin
shampoos	noun	Shampoo
aaks	noun	Aak
edelstählen	noun	Edelstahl
wulfenite	noun	Wulfenit
guanins	noun	Guanin
koppeln	noun	Koppel
molybdopterins	noun	Molybdopterin
hexacarbonyls	noun	Hexacarbonyl
rösters	noun	Röster
thiomolybdate	noun	Thiomolybdat
molybdite	noun	Molybdit
franciums	noun	Francium
beschluß	noun	Beschluss
einnahmen	noun	Einnahme
antigene	noun	Antigen
antigens	noun	Antigen
decacarbonyls	noun	Decacarbonyl
formationen	noun	Formation
halide	noun	Halid
halids	noun	Halid
heptasulfide	noun	Heptasulfid
plusse	noun	Plus
hummern	noun	Hummer
irische	noun	Irisch
irischen	noun	Irisch
kilojoules	noun	Kilojoule
erste	noun	Erster
ihren	pronoun	Ihr
paßt	verb	passt
kongreß	noun	Kongress
bundesländern	noun	Bundesland
bürgers	noun	Bürger
betrieben	noun	Betrieb
neutronenmängel	noun	Neutronenmangel
magistrate	noun	Magistrat
magistrats	noun	Magistrat
politikern	noun	Politiker
ihrem	pronoun	Ihr
plänen	noun	Plan
umbauten	noun	Umbau
umbaue	noun	Umbau
handelns	noun	Handeln
unterlagen	noun	Unterlage
shows	noun	Show
wünsch	noun	Wunsch
telephone	noun	Telephon
wünsche	noun	Wunsch
wünschs	noun	Wünsch
wünsches	noun	Wünsch
füßen	noun	Fuß
gästen	noun	Gast
holdings	noun	Holding
redaktionen	noun	Redaktion
schuß	noun	Schuss
filmen	noun	Film
märkten	noun	Markt
kandidaturen	noun	Kandidatur
jurys	noun	Jury
centers	noun	Center
mißbraucht	verb	missbraucht
nützten	verb	nützen
riß	verb	riss
selbstbewußt	adjective	selbstbewusst
veranlaßt	verb	veranlasst
verfaßt	verb	verfasst
verpaßt	verb	verpasst
zusammengefaßt	verb	zusammengefasst
recitativ	noun	Rezitativ
eingusses	noun	Einguss
eingüsse	noun	Einguss
abflusse	noun	Abfluss
absturze	noun	Absturz
abstürzen	noun	Absturz
abnahmen	noun	Abnahme
augustes	noun	August
anfluge	noun	Anflug
alkine	noun	Alkin
abbruche	noun	Abbruch
abgange	noun	Abgang
abfluge	noun	Abflug
markes	noun	Mark
abschwungen	noun	Abschwung
falze	noun	Falz
geize	noun	Geiz
äckern	noun	Acker
altären	noun	Altar
amalgamen	noun	Amalgam
anlässen	noun	Anlass
aufträgen	noun	Auftrag
bällen	noun	Ball
bänden	noun	Band
bänken	noun	Bank
beiträgen	noun	Beitrag
beträgen	noun	Betrag
dieseln	noun	Diesel
drängen	noun	Drang
edelstahlen	noun	Edelstahl
eiden	noun	Eid
einkäufen	noun	Einkauf
einträgen	noun	Eintrag
empfängen	noun	Empfang
abschwüngen	noun	Abschwung
ananassen	noun	Ananas
böcken	noun	Bock
energiezuständen	noun	Energiezustand
flößen	noun	Floß
flügen	noun	Flug
föns	noun	Fön
gebräuchen	noun	Gebrauch
asymptoten	noun	Asymptote
groschens	noun	Groschen
häuten	noun	Haut
hockern	noun	Hocker
hölzern	noun	Holz
hüten	noun	Hut
images	noun	Image
kämpfen	noun	Kampf
kilometers	noun	Kilometer
klängen	noun	Klang
kleiderschränken	noun	Kleiderschrank
köchen	noun	Koch
köpfen	noun	Kopf
künsten	noun	Kunst
kursen	noun	Kurs
läufen	noun	Lauf
löhnen	noun	Lohn
lüften	noun	Luft
lüsten	noun	Lust
mächten	noun	Macht
manövern	noun	Manöver
meissels	noun	Meissel
meißels	noun	Meißel
bilde	noun	Bild
möpsen	noun	Mops
oxides	noun	Oxid
parametern	noun	Parameter
pässen	noun	Pass
penissen	noun	Penis
pflügen	noun	Pflug
pullovers	noun	Pullover
pyrite	noun	Pyrit
rängen	noun	Rang
räten	noun	Rat
requiems	noun	Requiem
röcken	noun	Rock
rohren	noun	Rohr
samens	noun	Samen
säume	noun	Saum
säumen	noun	Saum
scanners	noun	Scanner
schäume	noun	Schaum
schäumen	noun	Schaum
schilde	noun	Schild
schlägen	noun	Schlag
schlössern	noun	Schloss
schößen	noun	Schoß
schränken	noun	Schrank
schwänzen	noun	Schwanz
schwärmen	noun	Schwarm
servern	noun	Server
spitzers	noun	Spitzer
sprüngen	noun	Sprung
stämmen	noun	Stamm
stapels	noun	Stapel
stegs	noun	Steg
steges	noun	Steg
stempeln	noun	Stempel
stengels	noun	Stengel
stürmen	noun	Sturm
süchten	noun	Sucht
superhelden	noun	Superheld
tange	noun	Tang
tangs	noun	Tang
tränken	noun	Trank
träumen	noun	Traum
tupeln	noun	Tupel
türmen	noun	Turm
urheimaten	noun	Urheimat
ursprüngen	noun	Ursprung
ventilen	noun	Ventil
verdachten	noun	Verdacht
verkäufen	noun	Verkauf
verläufen	noun	Verlauf
vorträgen	noun	Vortrag
vorwürfen	noun	Vorwurf
wachsen	noun	Wachs
wänden	noun	Wand
würfen	noun	Wurf
aaken	noun	Aake
aaken	noun	Aak
ausschlußverfahrens	noun	Ausschlußverfahren
kulturworts	noun	Kulturwort
normalen	noun	Normal
gotte	noun	Gott
heerzuge	noun	Heerzug
herzoge	noun	Herzog
fräuleins	noun	Fräulein
fußböden	noun	Fußboden
hyponyme	noun	Hyponym
hyponymen	noun	Hyponym
hyponyms	noun	Hyponym
konjugationen	noun	Konjugation
stamme	noun	Stamm
erbes	noun	Erbe
anläufen	noun	Anlauf
belägen	noun	Belag
server-zugriffen	noun	Server-Zugriff
serverzugriffen	noun	Serverzugriff
passe	noun	Pass
reichskanzlers	noun	Reichskanzler
rektoren	noun	Rektor
rektors	noun	Rektor
rudern	noun	Ruder
sträuße	noun	Strauß
sträußen	noun	Strauß
strauße	noun	Strauß
straußen	noun	Strauß
tönen	noun	Ton
volke	noun	Volk
winds	noun	Wind
würmen	noun	Wurm
abriß	noun	Abriss
anschlägen	noun	Anschlag
angriffen	noun	Angriff
areale	noun	Areal
areals	noun	Areal
badens	noun	Baden
ausschluß	noun	Ausschluss
baue	noun	Bau
bankers	noun	Banker
recitative	noun	Recitativ
recitativen	noun	Recitativ
recitativs	noun	Recitativ
belangen	noun	Belang
bestände	noun	Bestand
beständen	noun	Bestand
bestands	noun	Bestand
dingen	noun	Ding
cursors	noun	Cursor
dispositionen	noun	Disposition
dortmunders	noun	Dortmunder
entschluß	noun	Entschluss
erfolgen	noun	Erfolg
einführungsleitfäden	noun	Einführungsleitfaden
erlöse	noun	Erlös
erlösen	noun	Erlös
euch	pronoun	Ihr
exemplare	noun	Exemplar
exemplaren	noun	Exemplar
exemplars	noun	Exemplar
fisken	noun	Fiskus
diamantringen	noun	Diamantring
fremden	noun	Fremde
versus	noun	Vers
ästen	noun	Ast
asts	noun	Ast
astes	noun	Ast
aussenwänden	noun	Aussenwand
friedensprozeß	noun	Friedensprozess
gusse	noun	Guss
güsse	noun	Guss
fundamente	noun	Fundament
fundamenten	noun	Fundament
fundaments	noun	Fundament
gedichten	noun	Gedicht
gefangene	noun	Gefangener
gefangenen	noun	Gefangener
letzteren	noun	Letztere
letzterer	noun	Letztere
kleinen	noun	Kleine
kleiner	noun	Kleine
liberale	noun	Liberaler
liberalen	noun	Liberaler
geschäften	noun	Geschäft
awqaf	noun	Waqf
pänz	noun	Panz
gewinnen	noun	Gewinn
gewißheit	noun	Gewissheit
guldens	noun	Gulden
ablässen	noun	Ablass
abstiegen	noun	Abstieg
affekten	noun	Affekt
agnostikern	noun	Agnostiker
akkorden	noun	Akkord
akronymen	noun	Akronym
akuten	noun	Akut
alabastern	noun	Alabaster
alarmen	noun	Alarm
alarmsignalen	noun	Alarmsignal
albatrossen	noun	Albatros
albatross	noun	Albatros
algeriern	noun	Algerier
alkylen	noun	Alkyl
allergenen	noun	Allergen
abdrucke	noun	Abdruck
ablasshandels	noun	Ablasshandel
abläufen	noun	Ablauf
ablaßhandels	noun	Ablaßhandel
aborten	noun	Abort
abrissen	noun	Abriss
abschlägen	noun	Abschlag
achaten	noun	Achat
admiralen	noun	Admiral
akkusativen	noun	Akkusativ
akkusativs	noun	Akkusativ
aktiven	noun	Aktiv
albaners	noun	Albaner
altes	noun	Alt
alters	noun	Alter
amethysten	noun	Amethyst
amokläufen	noun	Amoklauf
backgammons	noun	Backgammon
badern	noun	Bader
ballasten	noun	Ballast
ballastes	noun	Ballast
basaren	noun	Basar
bässen	noun	Bass
basses	noun	Bass
amuletten	noun	Amulett
baste	noun	Bast
basten	noun	Bast
bastes	noun	Bast
bastarden	noun	Bastard
anatomen	noun	Anatom
benzen	noun	Benz
benzinen	noun	Benzin
bescheiden	noun	Bescheid
anblicken	noun	Anblick
betroffene	noun	Betroffener
betroffenen	noun	Betroffener
billarden	noun	Billard
bockbieren	noun	Bockbier
bordellen	noun	Bordell
brandschätzen	noun	Brandschatz
bräuten	noun	Braut
ängsten	noun	Angst
bügen	noun	Bug
bünden	noun	Bund
anhängen	noun	Anhang
bussen	noun	Bus
butanolen	noun	Butanol
animen	noun	Anime
appels	noun	Appel
anrufen	noun	Anruf
asylen	noun	Asyl
anstößen	noun	Anstoß
atollen	noun	Atoll
aufstiegen	noun	Aufstieg
ausstiegen	noun	Ausstieg
ausweisen	noun	Ausweis
autobussen	noun	Autobus
axiomen	noun	Axiom
antonymen	noun	Antonym
antrieben	noun	Antrieb
ani	noun	Anus
apostrophe	noun	Apostroph
apostrophes	noun	Apostroph
apparaten	noun	Apparat
centern	noun	Center
crystals	noun	Crystal
defekten	noun	Defekt
dekanen	noun	Dekan
detektiven	noun	Detektiv
diplomen	noun	Diplom
diskursen	noun	Diskurs
divisen	noun	Divis
dromedaren	noun	Dromedar
duellen	noun	Duell
düften	noun	Duft
dünste	noun	Dunst
dünsten	noun	Dunst
duos	noun	Duo
archiven	noun	Archiv
argumenten	noun	Argument
armeniern	noun	Armenier
arsens	noun	Arsen
artefakten	noun	Artefakt
asbesten	noun	Asbest
asparagins	noun	Asparagin
atomreaktoren	noun	Atomreaktor
attentaten	noun	Attentat
attributen	noun	Attribut
aufrufen	noun	Aufruf
aufschlägen	noun	Aufschlag
aufständen	noun	Aufstand
einstürzen	noun	Einsturz
eln	noun	EL
els	noun	EL
elchen	noun	Elch
ausschlägen	noun	Ausschlag
austauschen	noun	Austausch
australiern	noun	Australier
ausverkäufen	noun	Ausverkauf
auswürfen	noun	Auswurf
avantgarde-künsten	noun	Avantgarde-Kunst
avantgardekünsten	noun	Avantgardekunst
bächen	noun	Bach
bädern	noun	Bad
baggern	noun	Bagger
bajonetten	noun	Bajonett
balgs	noun	Balg
balletten	noun	Ballett
ballsälen	noun	Ballsaal
banketten	noun	Bankett
bankrotte	noun	Bankrott
bankrotten	noun	Bankrott
bankrottes	noun	Bankrott
bannen	noun	Bann
barometern	noun	Barometer
baronen	noun	Baron
barschen	noun	Barsch
bärten	noun	Bart
beets	noun	Beet
befunden	noun	Befund
belgiern	noun	Belgier
erdgeschossen	noun	Erdgeschoss
erdgeschoßen	noun	Erdgeschoß
analemmas	noun	Analemma
fängen	noun	Fang
analemmata	noun	Analemma
beschlägen	noun	Beschlag
homologen	noun	Homolog
derivaten	noun	Derivat
diagrammen	noun	Diagramm
diakonen	noun	Diakon
dialogen	noun	Dialog
disputen	noun	Disput
distrikten	noun	Distrikt
dodekaedern	noun	Dodekaeder
dogmatikern	noun	Dogmatiker
citrate	noun	Citrat
domen	noun	Dom
dominoeffekten	noun	Dominoeffekt
doppeln	noun	Doppel
dottern	noun	Dotter
drucken	noun	Druck
duetten	noun	Duett
dumme-jungen-streichen	noun	Dumme-Jungen-Streich
dummejungenstreichen	noun	Dummejungenstreich
faxen	noun	Fax
umgängen	noun	Umgang
feuern	noun	Feuer
niggern	noun	Nigger
wünschen	noun	Wunsch
effekten	noun	Effekt
egels	noun	Egel
fixpunkten	noun	Fixpunkt
flippers	noun	Flipper
flüchen	noun	Fluch
flößern	noun	Flößer
footballs	noun	Football
eilanden	noun	Eiland
formularen	noun	Formular
einfällen	noun	Einfall
eingriffen	noun	Eingriff
fraßen	noun	Fraß
frisören	noun	Frisör
fürzen	noun	Furz
fußabstreifern	noun	Fußabstreifer
einschlägen	noun	Einschlag
fängers	noun	Fänger
garnen	noun	Garn
gebissen	noun	Gebiss
gefässen	noun	Gefäss
genen	noun	Gen
generälen	noun	General
genitiven	noun	Genitiv
getrieben	noun	Getriebe
gipfeln	noun	Gipfel
gipsverbänden	noun	Gipsverband
endes	noun	Ende
endlagern	noun	Endlager
gittern	noun	Gitter
golfen	noun	Golf
gramme	noun	Gramm
grammen	noun	Gramm
greisen	noun	Greis
grießen	noun	Grieß
großhändlern	noun	Großhändler
wässern	noun	Wasser
grüßen	noun	Gruß
hälsen	noun	Hals
hamstern	noun	Hamster
hapaxlegomena	noun	Hapaxlegomenon
hartungen	noun	Hartung
entwürfen	noun	Entwurf
epilogen	noun	Epilog
epitaphs	noun	Epitaph
heften	noun	Heft
helikoptern	noun	Helikopter
hindernissen	noun	Hindernis
reports	noun	Report
honoraren	noun	Honorar
horoskopen	noun	Horoskop
höckern	noun	Höcker
idealen	noun	Ideal
idole	noun	Idol
idols	noun	Idol
ersten	noun	Erster
ersten	noun	Erste
erster	noun	Erste
imkern	noun	Imker
immergrünen	noun	Immergrün
erträgen	noun	Ertrag
erwerben	noun	Erwerb
impulsen	noun	Impuls
indern	noun	Inder
integralen	noun	Integral
intervallen	noun	Intervall
inventaren	noun	Inventar
jaguaren	noun	Jaguar
examens	noun	Examen
exilen	noun	Exil
journalen	noun	Journal
exporten	noun	Export
kabinetten	noun	Kabinett
kadavers	noun	Kadaver
kamelen	noun	Kamel
fagotten	noun	Fagott
kaminen	noun	Kamin
kardinälen	noun	Kardinal
fasanen	noun	Fasan
februars	noun	Februar
fiebern	noun	Fieber
filtern	noun	Filter
finalen	noun	Finale
fjorden	noun	Fjord
flecks	noun	Fleck
fließbändern	noun	Fließband
flöhen	noun	Floh
fluren	noun	Flur
formaten	noun	Format
fossilen	noun	Fossil
fragmenten	noun	Fragment
fraktalen	noun	Fraktal
frauenfüssen	noun	Frauenfuss
frauenfüßen	noun	Frauenfuß
gallen	noun	Galle
galliums	noun	Gallium
fritzen	noun	Fritz
fungiziden	noun	Fungizid
gebeten	noun	Gebet
geboten	noun	Gebot
gebäcken	noun	Gebäck
fußabdrücken	noun	Fußabdruck
fußbällen	noun	Fußball
fußgängern	noun	Fußgänger
gehören	noun	Gehör
geißen	noun	Geiß
geschenken	noun	Geschenk
gipsen	noun	Gips
glucken	noun	Glucke
gois	noun	Goi
gojs	noun	Goj
golds	noun	Gold
goldes	noun	Gold
graniten	noun	Granit
griffen	noun	Griff
grosshändlern	noun	Grosshändler
grüns	noun	Grün
reiben	noun	Reibe
importen	noun	Import
inbegriffen	noun	Inbegriff
instituten	noun	Institut
labs	noun	Lab
laboren	noun	Labor
laiches	noun	Laich
laminae	noun	Lamina
laminas	noun	Lamina
ledern	noun	Leder
leerläufen	noun	Leerlauf
lemmas	noun	Lemma
liften	noun	Lift
liters	noun	Liter
loben	noun	Lob
lochern	noun	Locher
löffeln	noun	Löffel
logiken	noun	Logik
lokalen	noun	Lokal
losen	noun	Los
lüstern	noun	Lüster
hörers	noun	Hörer
mägden	noun	Magd
magistraten	noun	Magistrat
magnums	noun	Magnum
megafonen	noun	Megafon
majoren	noun	Major
makeln	noun	Makel
meistern	noun	Meister
schwüren	noun	Schwur
memen	noun	Mem
mandaten	noun	Mandat
menschenfüssen	noun	Menschenfuss
menschenfüßen	noun	Menschenfuß
mängeln	noun	Mangel
menuetten	noun	Menuett
meridiane	noun	Meridian
meridians	noun	Meridian
manifesten	noun	Manifest
männerfüssen	noun	Männerfuss
männerfüßen	noun	Männerfuß
mänteln	noun	Mantel
manualen	noun	Manual
manuskripten	noun	Manuskript
marmoren	noun	Marmor
märschen	noun	Marsch
märzen	noun	März
maskulinums	noun	Maskulinum
massakern	noun	Massaker
mikroskopen	noun	Mikroskop
massiven	noun	Massiv
nächten	noun	Nacht
nachweisen	noun	Nachweis
nackens	noun	Nacken
nähte	noun	Naht
nähten	noun	Naht
ölen	noun	Öl
omeletten	noun	Omelett
oratorian	noun	Oratorium
nektaren	noun	Nektar
originalen	noun	Original
orkanen	noun	Orkan
nerves	noun	Nerv
netzen	noun	Netz
paaren	noun	Paar
paketen	noun	Paket
palästen	noun	Palast
palindromen	noun	Palindrom
pantern	noun	Panter
pedalen	noun	Pedal
nominativen	noun	Nominativ
nonagons	noun	Nonagon
pelikanen	noun	Pelikan
pendeln	noun	Pendel
pensionären	noun	Pensionär
peps	noun	Pep
nöten	noun	Not
notaren	noun	Notar
perfekten	noun	Perfekt
pergamenten	noun	Pergament
pergaments	noun	Pergament
parkan	noun	Parka
parlamenten	noun	Parlament
nukleophilen	noun	Nukleophil
partnern	noun	Partner
passiven	noun	Passiv
patenten	noun	Patent
patern	noun	Pater
picknicken	noun	Picknick
pilgern	noun	Pilger
pinsels	noun	Pinsel
pipis	noun	Pipi
plagiaten	noun	Plagiat
plakaten	noun	Plakat
plüschen	noun	Plüsch
pokalen	noun	Pokal
polynomen	noun	Polynom
popeln	noun	popeln
popeln	noun	Popel
portalen	noun	Portal
porzellanen	noun	Porzellan
positiven	noun	Positiv
positivs	noun	Positiv
pötte	noun	Pott
pötten	noun	Pott
pottes	noun	Pott
präsenten	noun	Präsent
profilen	noun	Profil
profite	noun	Profit
profits	noun	Profit
profites	noun	Profit
projekten	noun	Projekt
radaren	noun	Radar
protesten	noun	Protest
protokollen	noun	Protokoll
raps	noun	Rap
rapporten	noun	Rapport
puddingen	noun	Pudding
pudern	noun	Puder
pulsen	noun	Puls
raube	noun	Raub
rauben	noun	Raub
pumpernickels	noun	Pumpernickel
punschen	noun	Punsch
rauchern	noun	Raucher
purpuren	noun	Purpur
putschen	noun	Putsch
ihres	pronoun	Ihr
pylons	noun	Pylon
räuschen	noun	Rausch
rausschmissen	noun	Rausschmiss
razzias	noun	Razzia
reaktionären	noun	Reaktionär
quarzen	noun	Quarz
recyclings	noun	Recycling
regimen	noun	Regime
rehen	noun	Reh
säcken	noun	Sack
reizen	noun	Reiz
säften	noun	Saft
saiblings	noun	Saibling
islamisten	noun	Islamist
sämlingen	noun	Sämling
samten	noun	Samt
sanden	noun	Sand
sandsäcken	noun	Sandsack
sandwiches	noun	Sandwich
jahresüberschuß	noun	Jahresüberschuss
saphiren	noun	Saphir
sätteln	noun	Sattel
säuen	noun	Sau
sauen	noun	Sau
saxofonen	noun	Saxofon
schäften	noun	Schaft
schallen	noun	Schall
retronymen	noun	Retronym
scharnieren	noun	Scharnier
revolutionären	noun	Revolutionär
revolvern	noun	Revolver
schaudern	noun	Schauder
schauspielern	noun	Schauspieler
scheffeln	noun	Scheffel
rials	noun	Rial
bocke	noun	Bock
scheinen	noun	Schein
scherzen	noun	Scherz
schis	noun	Schi
schiefern	noun	Schiefer
schille	noun	Schill
schillen	noun	Schill
schimmels	noun	Schimmel
schirmen	noun	Schirm
schlachtern	noun	Schlachter
schlächtern	noun	Schlächter
schlägern	noun	Schläger
schlicke	noun	Schlick
schlossern	noun	Schlosser
schlücke	noun	Schluck
schlücken	noun	Schluck
schlucke	noun	Schluck
schmäusen	noun	Schmaus
schmucken	noun	Schmuck
schnorcheln	noun	Schnorchel
schnüren	noun	Schnur
schottern	noun	Schotter
schreien	noun	Schrei
tachyons	noun	Tachyon
schwatzen	noun	Schwatz
tagträumen	noun	Tagtraum
takten	noun	Takt
tälern	noun	Tal
talern	noun	Taler
talibans	noun	Taliban
talismanen	noun	Talisman
tänzen	noun	Tanz
tatorten	noun	Tatort
tatorts	noun	Tatort
taus	noun	Tau
taubern	noun	Tauber
taubers	noun	Tauber
täubern	noun	Täuber
täubers	noun	Täuber
tauschen	noun	Tausch
tee-eiern	noun	Tee-Ei
teeeiern	noun	Teeei
seile	noun	Seil
seiles	noun	Seil
telefaxen	noun	Telefax
telefonen	noun	Telefon
telegrammen	noun	Telegramm
telexen	noun	Telex
sekretären	noun	Sekretär
temperamenten	noun	Temperament
tenören	noun	Tenor
termen	noun	Term
terminen	noun	Termin
teste	noun	Test
thälern	noun	Thal
thalern	noun	Thaler
serins	noun	Serin
thermostaten	noun	Thermostat
servomotors	noun	Servomotor
signalen	noun	Signal
titeln	noun	Titel
singers	noun	Singer
singularen	noun	Singular
toasten	noun	Toast
sinnen	noun	Sinn
sintern	noun	Sinter
sirupen	noun	Sirup
sitzen	noun	Sitz
skalaren	noun	Skalar
skalpellen	noun	Skalpell
skandalen	noun	Skandal
skeletten	noun	Skelett
tonern	noun	Toner
smsen	noun	SMS
trampeln	noun	Trampel
trampolinen	noun	Trampolin
transiten	noun	Transit
transparenten	noun	Transparent
transporten	noun	Transport
sopranen	noun	Sopran
sorghums	noun	Sorghum
souveränen	noun	Souverän
tribunalen	noun	Tribunal
trünken	noun	Trunk
tsunamis	noun	Tsunami
tukanen	noun	Tukan
spinde	noun	Spind
spinden	noun	Spind
tunneln	noun	Tunnel
spionen	noun	Spion
türkisen	noun	Türkis
splittern	noun	Splitter
sporte	noun	Sport
sporten	noun	Sport
sports	noun	Sport
sprößlingen	noun	Sprößling
spuken	noun	Spuk
spurten	noun	Spurt
stäben	noun	Stab
ställen	noun	Stall
überfällen	noun	Überfall
ständen	noun	Stand
staplers	noun	Stapler
überschüssen	noun	Überschuss
starte	noun	Start
startes	noun	Start
übertragern	noun	Übertrager
überträgern	noun	Überträger
staus	noun	Stau
staue	noun	Stau
stäuben	noun	Staub
umfängen	noun	Umfang
stiften	noun	Stift
unterdrücken	noun	Unterdruck
unterstrichen	noun	Unterstrich
stören	noun	Stör
stößen	noun	Stoß
uren	noun	Ur
urinalen	noun	Urinal
stränden	noun	Strand
streuen	noun	Streu
streusels	noun	Streusel
strichen	noun	Strich
strömen	noun	Strom
stümpfen	noun	Stumpf
stürze	noun	Sturz
stürzen	noun	Sturz
substantiven	noun	Substantiv
substantivs	noun	Substantiv
verbs	noun	Verb
verbänden	noun	Verband
verboten	noun	Verbot
sultanaten	noun	Sultan
supermächten	noun	Supermacht
surinamers	noun	Surinamer
sushis	noun	Sushi
suspensoriums	noun	Suspensorium
vergleichen	noun	Vergleich
symbolen	noun	Symbol
verhören	noun	Verhör
syndromen	noun	Syndrom
synonymen	noun	Synonym
verlagen	noun	Verlag
verliesen	noun	Verlies
wachten	noun	Wacht
verstößen	noun	Verstoß
verzehren	noun	Verzehr
verzichten	noun	Verzicht
wällen	noun	Wall
vikars	noun	Vikar
visionären	noun	Visionär
vitaminen	noun	Vitamin
vokalen	noun	Vokal
vorbehalten	noun	Vorbehalt
vorschlägen	noun	Vorschlag
wehe	noun	Weh
vorsorgen	noun	Vorsorge
vorstößen	noun	Vorstoß
weissstörchen	noun	Weissstorch
weißstörchen	noun	Weißstorch
yogas	noun	Yoga
zauns	noun	Zaun
widerrufen	noun	Widerruf
zehnten	noun	Zehnt
wienern	noun	Wiener
winken	noun	Wink
zelten	noun	Zelt
wirbeln	noun	Wirbel
zielen	noun	Ziel
wüchsen	noun	Wuchs
wunsches	noun	Wunsch
würfeln	noun	Würfel
zuchten	noun	Zucht
zügeln	noun	Zügel
zündern	noun	Zünder
zusammenhängen	noun	Zusammenhang
zusammenstößen	noun	Zusammenstoß
zwängen	noun	Zwang
zweifeln	noun	Zweifel
büffeln	noun	Büffel
letzte	noun	Letzter
kunsthallen	noun	Kunsthalle
matche	noun	Match
matchen	noun	Match
matchs	noun	Match
matches	noun	Match
nachfolgen	noun	Nachfolge
pence	noun	Penny
pencen	noun	Penny
pennys	noun	Penny
performances	noun	Performance
planers	noun	Planer
podien	noun	Podium
podiums	noun	Podium
präsidiums	noun	Präsidium
revisionen	noun	Revision
kinde	noun	Kind
selbstbewußtsein	noun	Selbstbewusstsein
senaten	noun	Senat
senats	noun	Senat
senates	noun	Senat
sparten	noun	Sparte
streß	noun	Stress
trios	noun	Trio
umlands	noun	Umland
unbekannten	noun	Unbekannte
untersuchungsausschuß	noun	Untersuchungsausschuss
verdienste	noun	Verdienst
verdiensten	noun	Verdienst
unbekannter	noun	Unbekannte
unters	noun	Unter
untersuchungsausschüsse	noun	Untersuchungsausschuss
übergaben	noun	Übergabe
verletzten	noun	Verletzter
verletzten	noun	Verletzte
verwandten	noun	Verwandter
verwandten	noun	Verwandte
vergaben	noun	Vergabe
vota	noun	Votum
voten	noun	Votum
wollen	noun	Wolle
zuschuß	noun	Zuschuss
betreffe	noun	Betreff
betreffen	noun	Betreff
betreffs	noun	Betreff
zweite	noun	Zweiter
zweiten	noun	Zweiter
pertechnetate	noun	Pertechnetat
rutheniums	noun	Ruthenium
technetate	noun	Technetat
ditelluride	noun	Ditellurid
heptoxide	noun	Heptoxid
hexachloride	noun	Hexachlorid
tetrabromide	noun	Tetrabromid
verantwortliche	noun	Verantwortlicher
verantwortlichen	noun	Verantwortlicher
chlororuthenate	noun	Chlororuthenat
cisplatins	noun	Cisplatin
histologien	noun	Histologie
laurite	noun	Laurit
platins	noun	Platin
perruthenate	noun	Perruthenat
platinoide	noun	Platinoid
platinoids	noun	Platinoid
promotors	noun	Promotor
ruthenate	noun	Ruthenat
rutheniridosmine	noun	Rutheniridosmin
tetraoxide	noun	Tetraoxid
textils	noun	Textil
widerstände	noun	Widerstand
widerständen	noun	Widerstand
bowieite	noun	Bowieit
carbene	noun	Carben
platts	noun	Platt
genkinite	noun	Genkinit
rhodiums	noun	Rhodium
miassite	noun	Miassit
thermoelements	noun	Thermoelement
freiwilligen	noun	Freiwilliger
freiwilligen	noun	Freiwillige
palladiums	noun	Palladium
alpacca	noun	Alpaka
acroleins	noun	Acrolein
zuschusse	noun	Zuschuss
messies	noun	Messie
messy	noun	Messie
chlorargyrite	noun	Chlorargyrit
dichloroargentate	noun	Dichloroargentat
dicyanoargentate	noun	Dicyanoargentat
goldstandards	noun	Goldstandard
kunstwerken	noun	Kunstwerk
kurieren	noun	Kurier
kongsbergite	noun	Kongsbergit
stromeyerite	noun	Stromeyerit
korns	noun	Korn
modulen	noun	Modul
musikinstrumenten	noun	Musikinstrument
miargyrite	noun	Miargyrit
mikroben	noun	Mikrobe
möbiusbands	noun	Möbiusband
amperes	noun	Ampere
bots	noun	Bot
nanoamperes	noun	Nanoampere
nanobots	noun	Nanobot
nanofarads	noun	Nanofarad
nanojoules	noun	Nanojoule
nanomaterials	noun	Nanomaterial
nanomotors	noun	Nanomotor
nanosystems	noun	Nanosystem
nanoteslas	noun	Nanotesla
nanovolts	noun	Nanovolt
nanowatts	noun	Nanowatt
teslas	noun	Tesla
raffinate	noun	Raffinat
romanen	noun	Roman
fulminate	noun	Fulminat
silberfarben	noun	Silberfarbe
silberfäden	noun	Silberfaden
argentite	noun	Argentit
somite	noun	Somit
substrate	noun	Substrat
substraten	noun	Substrat
substrats	noun	Substrat
substrates	noun	Substrat
knechten	noun	Knecht
ångströms	noun	Ångström
cadmiums	noun	Cadmium
calciummängel	noun	Calciummangel
codices	noun	Codex
greenockite	noun	Greenockit
hartloten	noun	Hartlot
kadmiums	noun	Kadmium
parlamentes	noun	Parlament
otavite	noun	Otavit
donors	noun	Donor
habens	noun	Haben
hülfen	noun	Hülfe
auslesen	noun	Auslese
fotokopien	noun	Fotokopie
federweißes	noun	Federweiß
indite	noun	Indit
transporters	noun	Transporter
mutagene	noun	Mutagen
mutagenen	noun	Mutagen
mutagens	noun	Mutagen
roquesite	noun	Roquesit
sprinklers	noun	Sprinkler
barke	noun	Bake
körpergerüche	noun	Körpergeruch
körpergeruche	noun	Körpergeruch
eprouvettes	noun	Eprouvette
filmstars	noun	Filmstar
cheerleaders	noun	Cheerleader
stannate	noun	Stannat
stannats	noun	Stannat
wallachs	noun	Wallach
ehstnisch	adjective	estnisch
kayser	noun	Kaiser
keyser	noun	Kaiser
kaysers	noun	Kayser
nachtrage	noun	Nachtrag
nachträge	noun	Nachtrag
skarns	noun	Skarn
stannane	noun	Stannan
stannite	noun	Stannit
inspektionen	noun	Inspektion
volkssports	noun	Volkssport
zaine	noun	Zain
zains	noun	Zain
zaines	noun	Zain
stabe	noun	Stab
kusse	noun	Kuss
antimons	noun	Antimon
trisulfide	noun	Trisulfid
babyloniers	noun	Babylonier
endbeträge	noun	Endbetrag
endbetrage	noun	Endbetrag
eisennägel	noun	Eisennagel
ausbünde	noun	Ausbund
ausbunde	noun	Ausbund
dreier	numeral	drei
demos	noun	Demo
fichtelite	noun	Fichtelit
grosszügigkeiten	noun	Großzügigkeit
baume	noun	Baum
finks	noun	Fink
gecks	noun	Geck
graphs	noun	Graph
korridoren	noun	Korridor
korridors	noun	Korridor
lumps	noun	Lump
großzügigkeiten	noun	Großzügigkeit
fussgängern	noun	Fussgänger
fussgängers	noun	Fussgänger
tombolas	noun	Tombola
bekanntem	noun	Bekannter
akts	noun	Akt
kortholts	noun	Kortholt
schmeissfliegen	noun	Schmeissfliege
abstossungen	noun	Abstossung
abszeßes	noun	Abszeß
abszeße	noun	Abszeß
fusses	noun	Fuss
fussballs	noun	Fussball
fussbälle	noun	Fussball
fussballes	noun	Fussball
grüsse	noun	Gruss
grössenordnungen	noun	Grössenordnung
fussabdrücke	noun	Fussabdruck
fussabdruckes	noun	Fussabdruck
fussabdrucks	noun	Fussabdruck
grüssen	noun	Gruss
grusses	noun	Gruss
fussabstreifern	noun	Fussabstreifer
fussabstreifers	noun	Fussabstreifer
geisseln	noun	Geissel
griesse	noun	Griess
griessen	noun	Griess
griesses	noun	Griess
frassen	noun	Frass
frasses	noun	Frass
fussabdrücken	noun	Fussabdruck
flössern	noun	Flösser
flössers	noun	Flösser
federweisses	noun	Federweiss
fleisses	noun	Fleiss
fliessbänder	noun	Fliessband
fliessbändern	noun	Fliessband
fliessbands	noun	Fliessband
fliessbandes	noun	Fliessband
fliesse	noun	Fliess
fliessen	noun	Fliess
fliesses	noun	Fliess
spätzen	noun	Spatz
hünde	noun	Hund
mediators	noun	Mediator
campussen	noun	Campus
pächte	noun	Pacht
pachten	noun	Pacht
sprudeln	noun	Sprudel
lamme	noun	Lamm
baumwollen	noun	Baumwolle
röten	noun	Röte
röthen	noun	Röthe
zur-schau-stellens	noun	Zur-Schau-Stellen
zurschaustellens	noun	Zurschaustellen
lätze	noun	Latz
lätzen	noun	Latz
latze	noun	Latz
reptile	noun	Reptil
so'ne	pronoun	so'n
werkers	noun	Werker
filous	noun	Filou
ausreisen	noun	Ausreise
einreisen	noun	Einreise
erwachsenem	noun	Erwachsener
großes	noun	Groß
autoblocks	noun	Autoblock
knies	noun	Knie
knien	noun	Knie
kniee	noun	Knie
kinders	noun	Kind
wiktionarys	noun	Wiktionary
schwitz	verb	schwitzen
rauschgiftsüchtigen	noun	Rauschgiftsüchtige
donnervögel	noun	Donnervogel
hautfarben	noun	Hautfarbe
tarots	noun	Tarot
knöppen	noun	Knopp
knopps	noun	Knopp
melden	noun	Melde
pöhle	noun	Pohl
wedeln	noun	Wedel
sassen	noun	Sasse
fingerabdrücke	noun	Fingerabdruck
lallwörter	noun	Lallwort
parfüme	noun	Parfüm
backoffices	noun	Backoffice
swimmingpools	noun	Swimmingpool
eßwaren	noun	Esswaren
eßtisch	noun	Esstisch
eßtische	noun	Eßtisch
eßtisches	noun	Eßtisch
eßtischs	noun	Eßtisch
esstische	noun	Esstisch
esstisches	noun	Esstisch
esstischs	noun	Esstisch
junkfoods	noun	Junkfood
modi	noun	Modus
müden	adjective	müde
matthäus'	noun	Matthäus
kuppen	noun	Kuppe
durs	noun	Dur
muslime	noun	Muslim
muslims	noun	Muslim
võ	preposition	von
baufälle	noun	Baufall
baufalle	noun	Baufall
putzes	noun	Putz
einzelne	noun	Einzelner
gruben	noun	Grube
veraenderung	noun	Veränderung
oekonometrie	noun	Ökonometrie
veraenderungen	noun	Veraenderung
bruten	noun	Brut
uteri	noun	Uterus
managementsystems	noun	Managementsystem
content-management-systems	noun	Content-Management-System
omis	noun	Omi
moslems	noun	Moslem
wachliegen	verb	wach liegen
elter	noun	Eltern
fürchte	noun	Furcht
aeolisch	adjective	äolisch
koffers	noun	Koffer
cockpits	noun	Cockpit
verbräuche	noun	Verbrauch
verbräuchen	noun	Verbrauch
männekes	noun	Männeken
apfelsinensäfte	noun	Apfelsinensaft
apfelsinensafte	noun	Apfelsinensaft
orangensäfte	noun	Orangensaft
orangensafte	noun	Orangensaft
safte	noun	Saft
magensafte	noun	Magensaft
ananassäfte	noun	Ananassaft
ananassafte	noun	Ananassaft
aprikosensäfte	noun	Aprikosensaft
aprikosensafte	noun	Aprikosensaft
avocadosäfte	noun	Avocadosaft
avocadosafte	noun	Avocadosaft
bananensäfte	noun	Bananensaft
bananensafte	noun	Bananensaft
schutzwalle	noun	Schutzwall
schutzwälle	noun	Schutzwall
schutze	noun	Schutz
mappen	noun	Mappe
grabe	noun	Grab
gespannen	noun	Gespann
mullen	noun	Mull
anfange	noun	Anfang
stukas	noun	Stuka
klettergärten	noun	Klettergarten
bugs	noun	Bug
buge	noun	Bug
gebärden	noun	Gebärde
abhange	noun	Abhang
abhänge	noun	Abhang
abhängen	noun	Abhang
stiegen	noun	Stiege
balle	noun	Ball
browsers	noun	Browser
weißpunkt-buntbarschs	noun	Weißpunkt-Buntbarsch
weißpunkt-buntbarsches	noun	Weißpunkt-Buntbarsch
weißpunkt-buntbarsche	noun	Weißpunkt-Buntbarsch
weißpunkt-buntbarschen	noun	Weißpunkt-Buntbarsch
weißpunktbuntbarsches	noun	Weißpunktbuntbarsch
weißpunktbuntbarschs	noun	Weißpunktbuntbarsch
weißpunktbuntbarsche	noun	Weißpunktbuntbarsch
weißpunktbuntbarschen	noun	Weißpunktbuntbarsch
chocolade	noun	Schokolade
chokolade	noun	Schokolade
webs	noun	Web
objektive	noun	Objektiv
kindergartens	noun	Kindergarten
brätlings	noun	Brätling
brätlinge	noun	Brätling
bratlings	noun	Bratling
bratlinge	noun	Bratling
rubriken	noun	Rubrik
heus	noun	Heu
kfz	noun	KFZ
sallat	noun	Salat
beigest	verb	beigen
brod	noun	Brot
rußen	noun	Ruß
heimen	noun	Heim
divisors	noun	Divisor
wirren	noun	Wirre
butten	noun	Butt
brüsten	noun	Brust
dreien	noun	Drei
pneus	noun	Pneu
containers	noun	Container
dämmen	noun	Damm
stellv	noun	stellv.
bearb	adjective	bearb.
altern	noun	Alter
bauen	noun	Bau
ritten	noun	Ritt
mauren	noun	Maure
citys	noun	City
barbiere	noun	Barbier
barbiers	noun	Barbier
kaimane	noun	Kaiman
barrels	noun	Barrel
cunnilingi	noun	Cunnilingus
plaus	noun	Plau
suchen	noun	Suche
seßhaft	adjective	sesshaft
vormünder	noun	Vormund
kitts	noun	Kitt
pfalzerzherzoge	noun	Pfalzerzherzog
pfalzerzherzogen	noun	Pfalzerzherzog
pfalzerzherzöge	noun	Pfalzerzherzog
pfalzerzherzögen	noun	Pfalzerzherzog
rade	noun	Rad
caissons	noun	Caisson
paradiesvögel	noun	Paradiesvogel
durchsagen	noun	Durchsage
läser	noun	Leser
läser	noun	Laser
auß	preposition	aus
gantz	adjective	ganz
creuz	noun	Kreuz
almanachs	noun	Almanach
americiums	noun	Americium
anständen	noun	Anstand
antiken	noun	Antike
aposteln	noun	Apostel
apostels	noun	Apostel
aquifere	noun	Aquifer
aquifers	noun	Aquifer
archivare	noun	Archivar
archivaren	noun	Archivar
astats	noun	Astat
bachelors	noun	Bachelor
bariums	noun	Barium
barockes	noun	Barock
besuchen	noun	Besuch
bismuts	noun	Bismut
bitterlings	noun	Bitterling
blenders	noun	Blender
blöcken	noun	Block
bohriums	noun	Bohrium
börgen	noun	Borg
brassen	noun	Brasse
bratlingen	noun	Bratling
bräuchen	noun	Brauch
brätlingen	noun	Brätling
bröseln	noun	Brösel
bugen	noun	Bug
börden	noun	Börde
californiums	noun	Californium
containern	noun	Container
curiums	noun	Curium
cytosins	noun	Cytosin
cäsiums	noun	Cäsium
darmstadtiums	noun	Darmstadtium
decks	noun	Deck
deze	noun	Dez
dezen	noun	Dez
docks	noun	Dock
dubniums	noun	Dubnium
einsteiniums	noun	Einsteinium
erbiums	noun	Erbium
fasen	noun	Fase
femen	noun	Feme
feminismen	noun	Feminismus
fermiums	noun	Fermium
fleete	noun	Fleet
fleets	noun	Fleet
fließes	noun	Fließ
flints	noun	Flint
flors	noun	Flor
flüßen	noun	Fluß
frösten	noun	Frost
frosts	noun	Frost
frostes	noun	Frost
fusseln	noun	Fussel
gadoliniums	noun	Gadolinium
gemüseläden	noun	Gemüseladen
genusses	noun	Genuss
germanisten	noun	Germanist
gewächsen	noun	Gewächs
gilden	noun	Gilde
gossen	noun	Gosse
grachten	noun	Gracht
graumennigvögel	noun	Graumennigvogel
hähnen	noun	Hahn
hahnen	noun	Hahn
hahns	noun	Hahn
haien	noun	Hai
halligen	noun	Hallig
halme	noun	Halm
halmen	noun	Halm
halms	noun	Halm
händeln	noun	Handel
hängen	noun	Hang
hangs	noun	Hang
hanges	noun	Hang
happens	noun	Happen
hassiums	noun	Hassium
hecks	noun	Heck
heiraten	noun	Heirat
helmen	noun	Helm
heptane	noun	Heptan
heptans	noun	Heptan
hexane	noun	Hexan
hexans	noun	Hexan
heyden	noun	Heyde
holme	noun	Holm
holmen	noun	Holm
holms	noun	Holm
holmiums	noun	Holmium
hörsälen	noun	Hörsaal
ideeen	noun	Ideen
immen	noun	Imme
iodes	noun	Iod
jods	noun	Jod
jodes	noun	Jod
kämmen	noun	Kamm
kaps	noun	Kap
kiese	noun	Kies
kiesen	noun	Kies
klatschen	noun	Klatsch
klavieren	noun	Klavier
knallen	noun	Knall
kniffe	noun	Kniff
kniffen	noun	Kniff
kolossen	noun	Koloss
kongressen	noun	Kongress
konsonanten	noun	Konsonant
kräche	noun	Krach
krächen	noun	Krach
krachs	noun	Krach
kratzen	noun	Kratze
kreuzen	noun	Kreuz
krokodilen	noun	Krokodil
landesväter	noun	Landesvater
laptops	noun	Laptop
lawrenciums	noun	Lawrencium
linnens	noun	Linnen
meitneriums	noun	Meitnerium
mendeleviums	noun	Mendelevium
mennigvögel	noun	Mennigvogel
monologen	noun	Monolog
monologs	noun	Monolog
mosten	noun	Most
mulle	noun	Mull
mulls	noun	Mull
mulles	noun	Mull
nasses	noun	Nass
neptuniums	noun	Neptunium
nerze	noun	Nerz
nobeliums	noun	Nobelium
nullen	noun	Null
osmiums	noun	Osmium
patronyme	noun	Patronym
patronyms	noun	Patronym
patronymika	noun	Patronymikon
plutoniums	noun	Plutonium
poloniums	noun	Polonium
bierkästen	noun	Bierkasten
praseodyms	noun	Praseodym
primasse	noun	Primas
priorate	noun	Priorat
priorates	noun	Priorat
promethiums	noun	Promethium
blechkästen	noun	Blechkasten
pütte	noun	Pütt
pütten	noun	Pütt
pütts	noun	Pütt
bleistiftkästen	noun	Bleistiftkasten
radons	noun	Radon
bunds	noun	Bund
bunde	noun	Bund
buntstiftkästen	noun	Buntstiftkasten
rheniums	noun	Rhenium
ritte	noun	Ritt
roentgeniums	noun	Roentgenium
roste	noun	Rost
rosten	noun	Rost
rostes	noun	Rost
rubidiums	noun	Rubidium
ruhren	noun	Ruhr
rummeln	noun	Rummel
rutherfordiums	noun	Rutherfordium
salmen	noun	Salm
salms	noun	Salm
sänge	noun	Sang
sängen	noun	Sang
sangs	noun	Sang
sanges	noun	Sang
schelms	noun	Schelm
schimmern	noun	Schimmer
schleime	noun	Schleim
schleimen	noun	Schleim
schlote	noun	Schlot
schloten	noun	Schlot
schlöte	noun	Schlot
schluffe	noun	Schluff
schluffen	noun	Schluff
schlüffe	noun	Schluff
schläfen	noun	Schläfe
schnitzels	noun	Schnitzel
schöpfe	noun	Schopf
schöpfen	noun	Schopf
schwärzen	noun	Schwärze
seaborgiums	noun	Seaborgium
seehäfen	noun	Seehafen
senkkästen	noun	Senkkasten
smartphones	noun	Smartphone
spanns	noun	Spann
spannes	noun	Spann
speichern	noun	Speicher
stöcken	noun	Stock
stöcker	noun	Stock
stocks	noun	Stock
stockes	noun	Stock
stoppels	noun	Stoppel
tellurs	noun	Tellur
terbiums	noun	Terbium
farbstiftkästen	noun	Farbstiftkasten
thalliums	noun	Thallium
thrones	noun	Thron
topps	noun	Topp
toppen	noun	Topp
trimesters	noun	Trimester
verdecke	noun	Verdeck
verdecken	noun	Verdeck
felsböden	noun	Felsboden
visieres	noun	Visier
vorschlaghämmer	noun	Vorschlaghammer
wahne	noun	Wahn
wahnen	noun	Wahn
fingerabdrucke	noun	Fingerabdruck
wichten	noun	Wichte
wichten	noun	Wicht
wonnen	noun	Wonne
wunschs	noun	Wunsch
xenons	noun	Xenon
zirkoniums	noun	Zirkonium
zweien	noun	Zwei
überschüßen	noun	Überschuß
hinterkopfe	noun	Hinterkopf
meeresböden	noun	Meeresboden
niederschlage	noun	Niederschlag
primate	noun	Primat
sandböden	noun	Sandboden
schlöten	noun	Schlot
schlüffen	noun	Schluff
zirkelschlüsse	noun	Zirkelschluss
zirkelschlusse	noun	Zirkelschluss
steinbruche	noun	Steinbruch
spornen	noun	Sporn
singulariatantum	noun	Singularetantum
tannenbaume	noun	Tannenbaum
trugschlüsse	noun	Trugschluss
trugschlusse	noun	Trugschluss
mißverständnißes	noun	Mißverständniß
mißverständniße	noun	Mißverständniß
mißbrauchen	verb	missbrauchen
diser	pronoun	dieser
ablaßen	verb	ablassen
abmeßen	verb	abmessen
meßen	verb	messen
vermeßen	verb	vermessen
zwantzig	numeral	zwanzig
zwäntzig	numeral	zwanzig
biß	conjunction	bis
biß	preposition	bis
chymie	noun	Chemie
muslimas	noun	Muslima
managements	noun	Management
pluraliatantum	noun	Pluraletantum
furien	noun	Furie
meßbecher	noun	Messbecher
narkotika	noun	Narkotikum
webhooks	noun	WebHook
schnuren	noun	Schnur
kämpe	noun	Kamp
debuggings	noun	Debugging
radsätze	noun	Radsatz
radsatze	noun	Radsatz
halters	noun	Halter
malters	noun	Malter
timings	noun	Timing
meetings	noun	Meeting
lunden	noun	Lund
forthgang	noun	Fortgang
bonbons	noun	Bonbon
freaks	noun	Freak
ipas	noun	IPA
barden	noun	Barde
binnenlands	noun	Binnenland
posters	noun	Poster
mikros	noun	Mikro
muren	noun	Mure
hits	noun	Hit
umfloss	verb	umfließen
umfloß	verb	umfließen
i-dötzchen	noun	i-Dötzchen
underdogs	noun	Underdog
flusse	noun	Fluss
martern	noun	Marter
sandbänke	noun	Sandbank
königstöchter	noun	Königstochter
melodien	noun	Melodie
hotdogs	noun	Hotdog
hot dogs	noun	Hot Dog
kola	noun	Kolon
schippen	noun	Schippe
nachlaß	noun	Nachlass
glücke	noun	Glück
lärme	noun	Lärm
trotze	noun	Trotz
dariñ	adverb	darinn
dariñ	adverb	darin
jar	noun	Jahr
gateways	noun	Gateway
departments	noun	Department
bookmarks	noun	Bookmark
indexe	noun	Index
mustangs	noun	Mustang
bäre	noun	Bär
floße	noun	Floß
überlängen	noun	Überlänge
tusche	noun	Tusch
tuschen	noun	Tusche
tuschen	noun	Tusch
tusches	noun	Tusch
ausser	preposition	außer
rumbas	noun	Rumba
madjaren	noun	Madjar
ergüsse	noun	Erguss
ab messen	verb	abmessen
putts	noun	Putt
halsbands	noun	Halsband
spots	noun	Spot
wogen	noun	Woge
kats	noun	Kat
batiken	noun	Batik
batiks	noun	Batik
beig	verb	beigen
tschuess	interjection	tschüß
klammen	noun	Klamm
praktiken	noun	Praktik
u-ausschüsse	noun	U-Ausschuss
untersuchungsausschusse	noun	Untersuchungsausschuss
u-ausschusse	noun	U-Ausschuss
ausschusse	noun	Ausschuss
kömmst	verb	kommen
kömmt	verb	kommen
trotts	noun	Trott
wüstenfuchse	noun	Wüstenfuchs
wüstenfüchse	noun	Wüstenfuchs
fuße	noun	Fuß
jades	noun	Jade
grase	noun	Gras
afterlehens	noun	Afterlehen
auren	noun	Aura
landsknechte	noun	Landsknecht
landsknechts	noun	Landsknecht
vorsatze	noun	Vorsatz
vorsätze	noun	Vorsatz
inspirators	noun	Inspirator
irgend etwas	pronoun	irgendetwas
science-fiction	noun	Science-Fiction
sciencefiction	noun	Science-Fiction
krame	noun	Kram
reiser	noun	Reis
pantheisten	noun	Pantheist
abis	noun	Abi
atheisten	noun	Atheist
bits	noun	Bit
translationen	noun	Translation
drives	noun	Drive
whiskys	noun	Whisky
meßbuch	noun	Messbuch
abata	noun	Abaton
adjutanten	noun	Adjutant
agone	noun	Agon
allegorien	noun	Allegorie
aoriste	noun	Aorist
arsenale	noun	Arsenal
auswahlen	noun	Auswahl
auszahlungen	noun	Auszahlung
bacchanale	noun	Bacchanal
bakkies	noun	Bakkie
bäusche	noun	Bausch
befälle	noun	Befall
biome	noun	Biom
birnbäume	noun	Birnbaum
buhnen	noun	Buhne
bußen	noun	Buße
bühle	noun	Bühl
chicks	noun	Chick
chromosomen	noun	Chromosom
clusters	noun	Cluster
diademe	noun	Diadem
dinos	noun	Dino
dolen	noun	Dole
echos	noun	Echo
eise	noun	Eis
epsilons	noun	Epsilon
esplanaden	noun	Esplanade
fakes	noun	Fake
fanale	noun	Fanal
faune	noun	Faun
fauni	noun	Faun
fese	noun	Fes
filze	noun	Filz
flexionen	noun	Flexion
florette	noun	Florett
foltern	noun	Folter
friktionen	noun	Friktion
geleite	noun	Geleit
girls	noun	Girl
glottides	noun	Glottis
gnomen	noun	Gnom
gnome	noun	Gnom
greife	noun	Greif
grinde	noun	Grind
gurgeln	noun	Gurgel
harne	noun	Harn
hauen	noun	Haue
hektare	noun	Hektar
hellenen	noun	Hellene
hetzen	noun	Hetze
hiebe	noun	Hieb
homonyme	noun	Homonym
hübe	noun	Hub
höllen	noun	Hölle
ichs	noun	Ich
interjektionen	noun	Interjektion
jare	noun	Jar
kabinen	noun	Kabine
kais	noun	Kai
kalifate	noun	Kalifat
kalke	noun	Kalk
katalysen	noun	Katalyse
katen	noun	Kate
käufe	noun	Kauf
kefen	noun	Kefe
kimmen	noun	Kimme
kitte	noun	Kitt
kladden	noun	Kladde
klappern	noun	Klapper
klarinettisten	noun	Klarinettist
kleinwägen	noun	Kleinwagen
klemmen	noun	Klemme
klopse	noun	Klops
knuste	noun	Knust
kojen	noun	Koje
kokospalmen	noun	Kokospalme
köge	noun	Koog
koren	noun	Kore
korruptionen	noun	Korruption
kuratoren	noun	Kurator
läger	noun	Lager
laoten	noun	Laote
laufvögel	noun	Laufvogel
lecke	noun	Leck
lexeme	noun	Lexem
lunde	noun	Lund
macken	noun	Macke
madrigale	noun	Madrigal
mails	noun	Mail
majorane	noun	Majoran
make-ups	noun	Make-up
makrelen	noun	Makrele
mangroven	noun	Mangrove
metronome	noun	Metronom
minusse	noun	Minus
monogramme	noun	Monogramm
mulden	noun	Mulde
nachlässe	noun	Nachlass
neophyta	noun	Neophyt
numeralia	noun	Numerale
obsidiane	noun	Obsidian
ohme	noun	Ohm
ohms	noun	Ohm
oligopole	noun	Oligopol
optima	noun	Optimum
örter	noun	Ort
papyri	noun	Papyrus
paradoxe	noun	Paradox
paradoxa	noun	Paradoxon
pastelle	noun	Pastell
pastöre	noun	Pastor
pelotons	noun	Peloton
pelzmäntel	noun	Pelzmantel
phantome	noun	Phantom
piccolos	noun	Piccolo
pölster	noun	Polster
polygone	noun	Polygon
polyseme	noun	Polysem
privatdozenten	noun	Privatdozent
pulte	noun	Pult
quartette	noun	Quartett
rapse	noun	Raps
regenten	noun	Regent
riefen	noun	Riefe
runzeln	noun	Runzel
safes	noun	Safe
schleppen	noun	Schleppe
schubse	noun	Schubs
scoops	noun	Scoop
selleries	noun	Sellerie
seraphim	noun	Seraph
seraphin	noun	Seraph
sermone	noun	Sermon
siamesen	noun	Siamese
signaturen	noun	Signatur
skrota	noun	Skrotum
soge	noun	Sog
spinate	noun	Spinat
sprösslinge	noun	Sprössling
stative	noun	Stativ
stenografen	noun	Stenograf
stereotype	noun	Stereotyp
stricke	noun	Strick
sumachs	noun	Sumach
tetragone	noun	Tetragon
thinge	noun	Thing
thoraces	noun	Thorax
trappen	noun	Trappe
tribute	noun	Tribut
triumvirate	noun	Triumvirat
tuche	noun	Tuch
turbane	noun	Turban
urine	noun	Urin
velodrome	noun	Velodrom
versos	noun	Verso
vetos	noun	Veto
weißen	noun	Weißer
weißen	noun	Weiße
wische	noun	Wisch
würzen	noun	Würze
zaddikim	noun	Zaddik
zwirne	noun	Zwirn
oberin	noun	Ober
-innen	noun	-in
stelen	noun	Stele
phlöem	noun	Phloëm
gentlemen	noun	Gentleman
grannen	noun	Granne
mauß	noun	Maus
säers	noun	Säer
datasets	noun	Dataset
stracciatelle	noun	Stracciatella
poetry slam	noun	Poetry-Slam
hunte	noun	Hunt
abstrakta	noun	Abstraktum
streben	noun	Strebe
sangrias	noun	Sangria
törns	noun	Törn
kipfel	noun	Kipfl
metonyme	noun	Metonym
ruthe	noun	Rute
e-formen	noun	e-Form
abandons	noun	Abandon
softwares	noun	Software
kieze	noun	Kiez
reviews	noun	Review
aspergers	noun	Asperger
gummis	noun	Gummi
galiciens	noun	Galicien
liebestode	noun	Liebestod
spath	noun	Spat
feldspath	noun	Feldspat
gelaß	noun	Gelass
erlaß	noun	Erlass
verlaß	noun	Verlass
kraß	adjective	krass
kwaß	noun	Kwass
baß	noun	Bass
blaß	adjective	blass
erlasse	noun	Erlass
paparazze	noun	Paparazza
haxe	noun	Hachse
interrobangs	noun	Interrobang
nuten	noun	Nut
sonntages	noun	Sonntag
donnerstages	noun	Donnerstag
kippah	noun	Kippa
oktan	noun	Octan
pullen	noun	Pulle
ritzes	noun	Ritz
cabans	noun	Caban
matzes	noun	Matz
propsts	noun	Propst
wingerts	noun	Wingert
linker	noun	Linke
cörper	noun	Körper
renken	noun	Renke
carte	noun	Karte
molden	noun	Molde
armer	noun	Arme
weibels	noun	Weibel
skates	noun	Skate
schalke	noun	Schalk
stullen	noun	Stulle
mice	noun	Mouse
diminutive	noun	Diminutiv
fatwas	noun	Fatwa
kappas	noun	Kappa
pis	noun	Pi
sterze	noun	Sterz
basse	noun	Bass
außerirdischer	noun	Außerirdische
pfannenstiels	noun	Pfannenstiel
suk	noun	Souk
muffs	noun	Muff
merks	noun	Merk
tupfen	noun	Tupf
matzen	noun	Matze
kuders	noun	Kuder
desktops	noun	Desktop
loth	noun	Lot
kotters	noun	Kotter
hijab	noun	Hidschab
lohen	noun	Lohe
krampi	noun	Krampus
kilts	noun	Kilt
corpus	noun	Korpus
verschluß	noun	Verschluss
reißverschluß	noun	Reißverschluss
heterosexuelle	noun	Heterosexueller
holocausts	noun	Holocaust
mutters	noun	Mutter
navis	noun	Navi
kollateralschäden	noun	Kollateralschaden
onomatopoetika	noun	Onomatopoetikum
alveolen	noun	Alveole
ninjas	noun	Ninja
ouds	noun	Oud
rens	noun	Ren
straß	noun	Strass
zoonosen	noun	Zoonose
mazze	noun	Matze
überläßt	verb	überlässt
patientia	noun	Patiens
beanies	noun	Beanie
eaux de toilette	noun	Eau de Toilette
stumme	noun	Stummer
festschriften	noun	Festschrift
tag-und-nacht-gleiche	noun	Tagundnachtgleiche
frühjahrs-tag-und-nacht-gleiche	noun	Frühjahrs-Tagundnachtgleiche
frühlings-tag-und-nacht-gleiche	noun	Frühlings-Tagundnachtgleiche
recensent	noun	Rezensent
potte	noun	Pott
etalons	noun	Etalon
étangs	noun	Étang
euer	pronoun	Ihr
hoatzins	noun	Hoatzin
wests	noun	West
aspergern	noun	Asperger
schlichters	noun	Schlichter
wanderworte	noun	Wanderwort
barchenten	noun	Barchent
parts	noun	Part
helgens	noun	Helge
omiramba	noun	Omuramba
mätze	noun	Matz
poltergeists	noun	Poltergeist
olms	noun	Olm
olme	noun	Olm
magentas	noun	Magenta
cremen	noun	Creme
grauweißes	noun	Grauweiß
grauweisses	noun	Grauweiss
zwergspitzes	noun	Zwergspitz
zwergspitze	noun	Zwergspitz
einrichtungsgegenstände	noun	Einrichtungsgegenstand
pfannenstieles	noun	Pfannenstiel
pfannenstiele	noun	Pfannenstiel
dashboards	noun	Dashboard
knowhow	noun	Know-how
grummets	noun	Grummet
wiener schnitzels	noun	Wiener Schnitzel
flammeris	noun	Flammeri
bijous	noun	Bijou
martingals	noun	Martingal
martingale	noun	Martingal
milans	noun	Milan
rechter	noun	Rechte
belarusischen	noun	Belarusisch
ranks	noun	Rank
rankes	noun	Rank
reicher	noun	Reiche
generalbaß	noun	Generalbass
mistes	noun	Mist
staatenlose	noun	Staatenloser
posts	noun	Post
stati	noun	Status
statūs	noun	Status
verba	noun	Verbum
einundfünfzigecke	noun	Einundfünfzigeck
alleinstehender	noun	Alleinstehende
alleinstehende	noun	Alleinstehender
unterstände	noun	Unterstand
unterstands	noun	Unterstand
schauprozeß	noun	Schauprozess
viragos	noun	Virago
bodybags	noun	Bodybag
wanderjahre	noun	Wanderjahr
