δύο	numeral
λύκος	noun
δημοκρατία	noun
νίκη	noun
μέλι	noun
φῶς	noun
μία	numeral
μελῳδία	noun
ἵππος	noun
καί	conjunction
ἐρώμενος	noun
ἐραστής	noun
ἀνήρ	noun
ὁ	pronoun
ἄγω	verb
ἀλλά	conjunction
βασίλεια	noun
γῆ	noun
εἰ	conjunction
κόρη	noun
ἄγγελος	noun
ἄνευ	preposition
ἄνθρωπος	noun
κυριακή	noun
γραμματική	noun
γραμματική	adjective
φόβος	noun
ἄστρον	noun
ἄλφα	noun
ι	numeral
πνεῦμα	noun
κύριος	adjective
κύριος	noun
θεός	adjective
θεός	noun
ἅγιος	adjective
ἅγιος	noun
θάνατος	noun
ἔθνος	noun
σοφία	noun
βίβλος	noun
λόγος	noun
ἀγάπη	noun
ἰατρός	noun
νέος	adjective
ὀλίγος	adjective
ἡδονή	noun
καρδία	noun
πλῆθος	noun
τρεῖς	numeral
ἀρχή	noun
ἑπτά	numeral
ἐκκλησία	noun
ἐρυθρός	adjective
καιρός	noun
ἀγαπάω	verb
ὀφθαλμός	noun
πεντηκοστή	noun
ἰουδαία	adjective
ἰουδαία	noun
ψυχή	noun
ὅλος	adjective
ἀπόστολος	noun
ἀσθένεια	noun
μάχαιρα	noun
ἕλλην	noun
βάρβαρος	adjective
ἡμέρα	noun
ζωή	noun
ἰουδαῖος	noun
ἀγαθός	adjective
νόμος	noun
ἀλήθεια	noun
σάρξ	noun
ὕπνος	noun
πρωτοτόκος	adjective
οὐρανός	noun
ἀμήν	adverb
φαρισαῖος	noun
ἀκούω	verb
ἀρχαῖος	adjective
ταχύ	adjective
ἀριστερός	adjective
σῶμα	noun
ὀδούς	noun
ἥλιος	noun
ἐλεημοσύνη	noun
ὑποκριτής	noun
ἀγρός	noun
κακία	noun
εὑρίσκω	verb
ἰχθύς	noun
ὥρα	noun
ἀνθρακιά	noun
στῆθος	noun
ἔξοδος	noun
αἴνιγμα	noun
ἄνθος	noun
ἄνθος	noun
βίος	noun
ὄνομα	noun
αἷμα	noun
πρῶτος	adjective
φοῖνιξ	noun
κάμηλος	noun
ὕδωρ	noun
ἀκάθαρτος	adjective
ᾄδω	verb
ἄλλος	adjective
διά	preposition
διά	adverb
εἰρήνη	noun
κράτος	noun
λέων	noun
μέλας	adjective
οὖς	noun
ῥέω	verb
στέφανος	noun
ταῦρος	noun
υἱός	noun
εὖ	adverb
ἀγαπητός	adjective
αἰών	noun
ἀεί	adverb
πυρετός	noun
πυρά	noun
πυρά	noun
πῦρ	noun
σύν	preposition
φίλος	adjective
φίλος	noun
παρά	preposition
λύω	verb
ἀήρ	noun
ὑγιής	adjective
ποιέω	verb
πρῶτον	adjective
ἀδελφός	adjective
ἀδελφός	noun
ῥίζα	noun
αὐξάνω	verb
ἑκατόν	numeral
εὐθέως	adverb
εὐθέως	adjective
ἄκαρπος	adjective
ὅμοιος	adjective
σίναπι	noun
ὑπό	preposition
μόνος	adjective
πρός	preposition
ὕψος	noun
δίς	adverb
ἄρχομαι	verb
ἔτος	noun
πιστεύω	verb
πείθω	verb
πατριά	noun
ἀδελφή	noun
ἀποκεφαλίζω	verb
ἀπό	preposition
γάμος	noun
γένεσις	noun
γενεά	noun
πρό	preposition
πρό	adverb
ἥμισυ	adjective
ἅμα	adverb
ἅμα	preposition
ἀββα	noun
πτῶμα	noun
ἰδέα	noun
ἴδιος	adjective
ἄγριος	adjective
μετά	preposition
μετά	adverb
σάλος	noun
ἑλληνικός	adjective
ἰῶτα	noun
χάρις	noun
ἀβαρής	adjective
ῥωμαϊκός	adjective
ῥωμαῖος	adjective
ῥωμαῖος	noun
νᾶνος	noun
καλός	adjective
γάρ	conjunction
τῷ	conjunction
τοῦ	pronoun
πούς	noun
δοῦλος	adjective
δοῦλος	noun
ξανθός	adjective
αὐτός	pronoun
δέ	particle
δέ	conjunction
αὐτοῦ	adverb
αὐτοῦ	pronoun
ἐγώ	pronoun
σύ	pronoun
ὅπλα	noun
εἰμί	verb
ἐν	preposition
εἰς	preposition
ἐκ	preposition
ἐξ	preposition
ἐπί	preposition
ἀνά	preposition
ἀνδρός	noun
ζῷον	noun
ἔρχομαι	verb
λύομεν	verb
λύετε	verb
λύουσι	verb
λύουσιν	verb
λύῃς	verb
λύῃ	verb
λύωμεν	verb
λύητε	verb
λύωσι	verb
λύωσιν	verb
πάθος	noun
κερασός	noun
ὁδός	noun
ὁδοῦ	noun
θεά	noun
θεά	noun
θεᾶς	noun
νεφέλη	noun
ἔργου	noun
ἔργου	verb
ἀνθρώπου	noun
θεοῦ	noun
παιδεία	noun
θαλάσσης	noun
ψυχῆς	noun
μοῖρα	noun
μοίρας	noun
ἀπροσδόκητος	adjective
ἄδικος	adjective
νεώ	noun
ναοῦ	noun
γλῶσσα	noun
ἀληθείας	noun
ἦχος	noun
στροφῆς	noun
μέλισσα	noun
δῆμος	noun
δῆμος	noun
ἀγγέλου	noun
ὑμήν	noun
ἀγών	noun
ἀγῶνος	noun
στερεός	adjective
κοινή	adjective
πρωΐ	adverb
πρῶϊ	adverb
αἴγαγρος	noun
αἰγάγρου	noun
αἴξ	noun
σοφίας	noun
τις	pronoun
χριστός	adjective
χριστός	noun
γάλα	noun
γαλαξίας	noun
ἄρκτος	noun
ἀρκτικός	adjective
ἀρκτικός	adjective
ἀρκτικός	adjective
μίαν	numeral
τώ	conjunction
ἵνα	conjunction
εἷς	numeral
φυλή	noun
μῦθος	noun
περί	preposition
κάθαρσις	noun
σ'	pronoun
βασιλεία	noun
βασιλεία	adjective
ἥμισυς	adjective
ὀνοματοποιία	noun
λακωνικός	adjective
ῥητορικός	adjective
ἄθεος	adjective
θεῖον	noun
θεῖον	noun
μάγος	noun
ἐπιθυμία	noun
μήν	noun
μήν	particle
ὑβριστικός	adjective
γάζα	noun
σου	pronoun
παράκλητος	adjective
φοῖνιξ	noun
ἕλληνες	noun
γ'	particle
δ'	particle
δ'	conjunction
ἄγραφος	adjective
ὄγκος	noun
ὄγκος	noun
με	pronoun
ἕξ	numeral
ὀκτώ	numeral
ἐννέα	numeral
ἐξουσία	noun
ὑποχόνδριος	adjective
χόνδρος	noun
πλοῦτος	noun
σχολή	noun
νᾶμα	noun
νάω	verb
ἀκατάληπτος	adjective
ἀττικός	adjective
ὀξύς	adjective
ἀψίνθιον	noun
ἄβυσσος	adjective
ἄβυσσος	noun
γλαῦξ	noun
παρθένος	adjective
παρθένος	noun
ζύθος	noun
ἀκακία	noun
ἀκακία	noun
αἰολικός	adjective
εἶδος	noun
δράκων	noun
σῖγμα	noun
ἑβραῖος	adjective
ἑβραῖος	noun
στῦλος	noun
βυσσός	noun
ἀμφί	preposition
ἀκή	noun
ἀκή	noun
ἀκή	noun
ἁψίς	noun
κατά	preposition
ἀκέφαλος	adjective
ὕλη	noun
οὖρος	noun
οὖρος	noun
οὖρος	noun
οὖρος	noun
οὖρος	noun
ἀναρχία	noun
ἄρωμα	noun
ἄρωμα	noun
θρίαμβος	noun
ἱστορία	noun
ἵππου	noun
ὑπερβολή	noun
θήκη	noun
καμηλοπάρδαλις	noun
κένταυρος	noun
κένταυρος	noun
ἰδία	adjective
ἴδιον	adjective
ἀποστασία	noun
ἔχω	verb
μή	particle
ὅς	pronoun
ὅς	determiner
ἄγνοια	noun
σε	pronoun
λαός	noun
ἄκρα	noun
ἄκρα	adjective
ἄκρα	adjective
σοφόν	adjective
ἀσεβής	adjective
ἄθεοι	adjective
γότθος	noun
σκλάβος	noun
ὀνομαστικός	adjective
ὀνομάζω	verb
ἄρκτου	noun
βάρεος	noun
ἀγάπης	noun
ἀγνοίας	noun
ἀγροῦ	noun
ἀδελφῆς	noun
ἀδύτου	noun
αἵματος	noun
αἰνίγματος	noun
αἰσθήσεως	noun
ἀκακίας	noun
οὗννος	noun
ἄραψ	noun
ἀκάνθου	noun
ἀκῆς	noun
ἀναρχίας	noun
ἄνθους	noun
ἀνθρακιᾶς	noun
ἀποκαλύψεως	noun
τρωάς	noun
λυκία	adjective
ἀρμενία	adjective
ἰκαρία	adjective
ἄκανθος	noun
πύργος	noun
ἀθηναία	adjective
βίβλος	noun
καδμεία	noun
δάν	noun
ἄγνωστος	adjective
χάλυψ	noun
χυδαῖος	adjective
κωκυτός	noun
ἀβδηρίτης	noun
αἰτωλίς	noun
ἀλβανός	noun
ἀσιανός	noun
βλάχος	noun
ἰλλύριος	noun
ἰνδός	noun
ἰταλός	noun
ποτέ	adverb
νύξ	noun
οἶκος	noun
οἰκία	noun
χθές	adverb
πως	adverb
ξυνός	adjective
ἀγεωμέτρητος	adjective
ἁγνός	adjective
ῥίς	noun
δίκη	noun
φιλῶ	verb
ἁγνή	adjective
ἁγία	adjective
φῦλον	noun
μάχη	noun
ἀγγελία	noun
ἠχώ	noun
δάρδανος	noun
δελφίς	noun
δωρίς	noun
ἔλυμος	noun
ἠπειρώτης	noun
γέτης	noun
γίγας	noun
ἄφθα	noun
ἴων	noun
λακωνική	adjective
στρατός	noun
νίκης	noun
φωσφόρος	adjective
δουλεία	noun
μῆδος	noun
νῦ	noun
κανδάκη	noun
μυσός	noun
νομάς	noun
ἀποκόπτω	verb
τευκρός	noun
ἦτα	noun
ἁρμός	noun
νομός	noun
λύγξ	noun
λύγξ	noun
οὐρανοῦ	noun
οἶνος	noun
ἱερός	adjective
ἠριγένεια	noun
ὕω	verb
ὀρθός	adjective
ὄχλος	noun
ὤρα	noun
χείρ	noun
τίγρις	noun
ὕαινα	noun
ἀλώπηξ	noun
κῆτος	noun
ἄω	verb
ἄω	verb
ἄω	verb
ἄω	verb
ἰά	noun
ἐτυμολογία	noun
θέω	verb
πέμπτος	adjective
ἴς	noun
κρίνω	verb
μήνη	noun
κωμῳδία	noun
ᾠδή	noun
ἰδιοσυγκρασία	noun
λιμός	noun
ἄκμων	noun
ἄκμων	noun
κῦδος	noun
δρῦς	noun
τε	particle
τε	conjunction
ᾠόν	noun
βακτηρία	noun
φαλός	adjective
παχύς	adjective
ψιλός	adjective
κύδος	noun
εἰρωνεία	noun
ῥάβδος	noun
μαντεία	noun
μένω	verb
unsupported titles/ancient greek dish	noun
αἶθος	noun
γε	particle
ἄρα	conjunction
ὕδρος	noun
ὕδρα	noun
ὅτι	conjunction
μῦς	noun
ἤπειρος	noun
ἔκτασις	noun
μανία	noun
ἁρμονία	noun
πορνογράφος	noun
ἀκτή	noun
ἀκτή	noun
ἰλλυριός	noun
ἀμαυρός	adjective
μαυρός	adjective
ἀμέλγω	verb
φωτεινός	adjective
κῆρ	noun
κρόκος	noun
ἀπορία	noun
πόρος	noun
κάραβος	noun
περιστερά	noun
ἀλεκτρυών	noun
οὗτος	determiner
ἔδω	verb
εἶμι	verb
ὀρφανός	adjective
ἐστί	verb
μονή	noun
πλατεία	adjective
πόλεων	noun
ἄργυρος	noun
εἴκοσι	numeral
αὐλή	noun
ἁγιασμός	noun
δολιχός	adjective
ἀετός	noun
τεῖχος	noun
ἐλευθερία	noun
ἐλεύθερος	adjective
βατταλογέω	verb
χθών	noun
ὀσμή	noun
ὄζον	noun
θυμός	noun
ἴσος	adjective
χεῖλος	noun
κε	particle
ὄϊς	noun
οἶς	noun
νέων	adjective
προσῳδία	noun
μένος	noun
ἄκρις	noun
ὄκρις	noun
αὐτόματος	adjective
ἐπιστολή	noun
πέρνα	noun
πέρνα	verb
ὄφις	noun
ἀδηφάγος	adjective
πρᾶος	adjective
πόντος	noun
ἐνέργεια	noun
κρατήρ	noun
ἐπίκουρος	adjective
κριός	noun
κλύδων	noun
κάλλος	noun
κηρός	noun
κηρός	noun
γέρανος	noun
φαιδρός	adjective
ἕνος	adjective
ἑβδομήκοντα	numeral
ἕρπω	verb
ὠλένη	noun
ἀδήν	noun
εὕω	verb
εὔχομαι	verb
ὦμος	noun
ἔαρ	noun
ἔαρ	noun
οἶος	adjective
ἀμνός	noun
αἴτιος	adjective
αἴτιος	noun
ἄλκη	noun
ἄνεμος	noun
αὐγή	noun
ἠώς	noun
ἀντί	preposition
ἄρκευθος	noun
ὄζος	noun
ὠμός	adjective
οὐρά	noun
ὄρχις	noun
ὀμφαλός	noun
ἧπαρ	noun
κάρα	noun
ὑφή	noun
λῆνος	noun
ἁρπάζω	verb
ἀγγαρεύω	verb
γέρων	noun
λεία	noun
λεία	noun
λεία	adjective
μῆνιγξ	noun
βρότος	noun
βροτός	noun
βουνός	noun
ὄρος	noun
χίμαιρα	noun
ναῦς	noun
ἀνεψιός	noun
νῦν	adverb
λαιός	adjective
λαιός	noun
βασιλικός	adjective
δημιουργός	noun
μητρός	noun
ἤ	conjunction
φυλακή	noun
ἕσπερος	adjective
ἕσπερος	noun
ἑσπέρα	noun
σύνοδος	noun
ζώνη	noun
τῆλε	adverb
ὁρμή	noun
πότε	adverb
ἀφρός	noun
ἀλφάβητος	noun
ἰός	noun
ἰός	noun
ἰός	noun
ἰός	adjective
ἀρετή	noun
ὁρίζω	verb
ὅρος	noun
ὑπόστρωμα	noun
σκορπίος	noun
ἀμύνομαι	verb
ἐλαία	noun
θρῆνος	noun
γῦρος	noun
οὐδείς	pronoun
εἶ	noun
εἶ	verb
στρογγύλος	adjective
στρογγύλη	adjective
ἐπίσκοπος	noun
ἐπίσκοπος	adjective
ἔχιδνα	noun
οἰσοφάγος	noun
κάστωρ	noun
κύκνος	noun
πειθώ	noun
ὠκεανός	noun
σελήνη	noun
θερμός	adjective
θερμός	noun
ἵζω	verb
ῥῆμα	noun
ξῖ	noun
νῆσος	noun
φορά	noun
ἀγορά	noun
βουλή	noun
κόνις	noun
τύχη	noun
πηγή	noun
δραχμή	noun
ζῶον	noun
ἀγωγός	adjective
ἀγωνιστής	noun
εὐχαριστία	noun
σχῆμα	noun
σῴζω	verb
ἔβενος	noun
ἱπποπόταμος	noun
ξενία	noun
ξενία	adjective
ἔντερα	noun
ῥαιβός	adjective
ποιϝέω	verb
ἀμυγδάλη	noun
ἀνατομή	noun
ἄγκυρα	noun
ἔλεος	noun
σχέδιος	adjective
σταυρός	noun
κάστανα	noun
αὐτονομία	noun
μαργαρίτης	noun
φάρος	noun
φάρος	noun
φάρος	noun
φάρος	noun
ἵ	pronoun
ὀδών	noun
ὀγδοήκοντα	numeral
ῥυθμός	noun
ἀγγέλλω	verb
οἴαξ	noun
πόθεν	adverb
ποῦ	adverb
που	adverb
πῶς	adverb
ποῖος	adjective
τίς	pronoun
τίς	pronoun
αἰσθάνομαι	verb
καινός	adjective
κῶμα	noun
μονοπώλια	noun
μονοπωλία	noun
ἀρτηρία	noun
θεία	noun
θεία	adjective
πάγος	noun
εὐλογία	noun
εἰκών	noun
ἰδιώτης	noun
κοῖος	pronoun
ῥόμβος	noun
σῦριγξ	noun
οὐ	particle
ἁμαρτία	noun
πᾶς	determiner
ἐκεῖνος	pronoun
βέλος	noun
ἐλπίς	noun
κυπάρισσος	noun
ὄνος	noun
σκέπη	noun
εὐνή	noun
ἐρυσίπελας	noun
ἀσθενής	adjective
καρκίνος	noun
κονίς	noun
μῆκος	noun
κέρασος	noun
ἀββᾶς	noun
ὄρρος	noun
ὄρρος	noun
ἀρμένιος	adjective
τρίγωνον	noun
ἀριθμός	noun
ἔρως	noun
πέτρος	noun
ὄφελος	noun
ἐξαφανίζω	verb
ὀστοῦν	noun
μῆδος	noun
ἰατρεύω	verb
πάσχα	noun
ὀφείλω	verb
ἐμοῦ	pronoun
ἐμοῦ	verb
ἱστορίας	noun
ψυχῇ	noun
σοῦ	pronoun
σοῦ	adjective
ὀνείρων	noun
ᾧ	pronoun
εἶναι	verb
αὐλός	noun
πᾶν	determiner
ἕδρα	noun
δάφνη	noun
τοξότης	noun
βαρεία	adjective
βαρεία	noun
κέφαλος	noun
σχεδία	noun
κύτος	noun
ἀπών	adjective
ῥύγχος	noun
γεωργία	noun
δρυμός	noun
ὀφειλέτης	noun
νοῦς	noun
ἄρσις	noun
οὔτις	pronoun
πευκέδανος	noun
ἀσπίς	noun
κυδνός	adjective
τι	pronoun
πώς	adverb
πώς	noun
ὄπισθεν	adverb
πίτα	noun
κρυφᾷ	adverb
πλατεῖα	adjective
κουρά	noun
ὄργια	noun
ὑπηρέτης	noun
μᾶζα	noun
ἐμπειρία	noun
πηλός	noun
ἀργός	adjective
ἀργός	adjective
ἀτμός	noun
ἔξω	adverb
ἕξω	verb
ἄρχων	noun
φάγος	noun
ἀπάτη	noun
θέα	noun
ἄγνωτος	adjective
σῆμα	noun
βουβών	noun
κυνικός	adjective
χρῶμα	noun
τυρός	noun
ἀποθήκη	noun
εὔφημος	adjective
χερσόνησος	noun
θέρμη	noun
ἐπιστήμη	noun
πρόγονος	noun
κλίμα	noun
ἄξιος	adjective
ἄξιος	interjection
ἀξίωμα	noun
ἀφορίζω	verb
ἐντροπία	noun
ἀληθής	adjective
ἠθικός	adjective
ἐπαγωγή	noun
κατοικία	noun
δεῖγμα	noun
πλάκα	noun
πρᾶγμα	noun
θεῖος	adjective
θεῖος	noun
νίκῃ	noun
νικῶν	noun
καμάρα	noun
ἐργάζομαι	verb
ἀνάγκη	noun
μῖσος	noun
ἴχνος	noun
ἀποκαλύπτω	verb
δῆλος	adjective
ὕβρις	noun
μῖμος	noun
ῥεῦμα	noun
ἐποχή	noun
παρῳδία	noun
εὐφορία	noun
πολύ	adjective
πολύ	adverb
ἐργάτης	noun
χῶρος	noun
λειτουργία	noun
ψῆφος	noun
διάρροια	noun
πολιτικός	adjective
ἕκαστος	determiner
γυρῖνος	noun
σφαῖρα	noun
θ'	conjunction
κυρία	adjective
κυρία	noun
λῆμμα	noun
ἐγκέφαλος	adjective
ἐγκέφαλος	noun
κακή	adjective
χλιαρός	adjective
ὀπτικός	adjective
ἀξία	noun
ἀξία	adjective
ἐνθουσιασμός	noun
αὐστηρός	adjective
ἐρωτικός	adjective
θολός	noun
δρᾶμα	noun
γένη	noun
φημί	verb
λευκή	adjective
λευκούς	adjective
ἀμνηστία	noun
λύσις	noun
ἁμάρτημα	noun
πόσος	adjective
αἴλουρος	noun
ἀλόη	noun
ἀνοικτός	adjective
ἄνοικτος	adjective
ἀστρολογία	noun
ἀδάμας	noun
ἀδάμας	adjective
ἀκμή	noun
σιωπή	noun
γέννα	noun
τινες	pronoun
διψάς	noun
ζύθε	noun
ζύθοι	noun
ζύθων	noun
ὑποθέσει	noun
θείων	adjective
θείων	noun
ἄθλημα	noun
χρόνια	adjective
χρόνων	noun
μόνου	adjective
μόνη	adjective
μόνης	adjective
μόνοι	adjective
μόνους	adjective
μόνων	adjective
μόνα	adjective
μόνα	adjective
πρώτα	adjective
μάχης	noun
ὑλικός	adjective
-ισσα	noun
κτήματος	noun
κτήματα	noun
κτημάτων	noun
κυρίου	adjective
κυρίου	noun
κυρίων	adjective
κυρίων	noun
κυρίους	adjective
κυρίους	noun
κύριε	adjective
κύριε	noun
κεφαλαία	adjective
κεφάλαια	noun
κεφάλαια	adjective
ἅμαξα	noun
φώς	noun
πού	adverb
κατ'	preposition
καθ'	preposition
ἀράχνη	noun
σταφυλή	noun
φίλων	adjective
φίλων	noun
φάσις	noun
φάσις	noun
πολέμων	noun
ἑτοιμάζω	verb
ἁμαρτωλός	adjective
ἁμαρτωλός	noun
βαρβάρου	adjective
βαρβάρων	adjective
βαρβάρους	adjective
ὅπερ ἔδει δεῖξαι	phrase
μέτρια	adjective
πάλη	noun
πάλη	noun
δίδω	verb
ξένη	adjective
ξένη	noun
ξένων	adjective
ξένων	noun
ξένης	adjective
ξένης	noun
ὑγρός	adjective
μῆνις	noun
τοι	particle
σύρτις	noun
μ'	pronoun
μετ'	preposition
μεθ'	preposition
ποικίλων	adjective
ποικίλους	adjective
ψιλή	adjective
κακά	adjective
πιστά	adjective
πιστά	adjective
φιλοσοφική	adjective
ἐντολή	noun
ἀδικία	noun
χαρά	noun
φόρος	noun
διπλάσια	adjective
παλαιάς	adjective
ἔρις	noun
ἔρις	noun
δουλείας	noun
ὦ	interjection
ὦ	verb
βάτος	noun
βάτος	noun
κύρια	adjective
κυρίας	adjective
κυρίας	noun
καταρρέω	verb
ἐχθρός	adjective
πρόξενος	noun
εὔξεινος	adjective
τί	pronoun
τί	adverb
αἶσχος	noun
λήθη	noun
οὗ	pronoun
οὗ	pronoun
οὗ	adverb
οὗ	adjective
οὗ	verb
ἀστεῖος	adjective
ταχεία	adjective
σπουδή	noun
περίοικος	adjective
περίοικος	noun
γλαυκός	adjective
βλῆμα	noun
ἄρακος	noun
θόλος	noun
ἄγνος	noun
ἆθλος	noun
αἰσχρός	adjective
ἀμίαντος	adjective
ἀνδριάς	noun
ἀραιός	adjective
ἀστράγαλος	noun
ἀστρολόγος	adjective
ἀστρονομία	noun
ἀφορισμός	noun
βασίλειος	adjective
βῆτα	noun
βόσκω	verb
ἐγείρω	verb
εἰδωλολάτρης	noun
ἐκεῖ	adverb
ἔμετος	noun
ἕνδεκα	numeral
κῦμα	noun
ἔννοια	noun
ἑορτή	noun
ἐπαινετός	adjective
ἐπιεικής	adjective
ῥέπω	verb
μυρίοι	adjective
ἐργασία	noun
ἕρπης	noun
ζῆτα	noun
ὡς	adverb
ὡς	conjunction
ὡς	adverb
θαῦμα	noun
θῆτα	noun
θύμος	noun
εὐθύς	adjective
εὐθύς	adverb
ἰτέα	noun
ἰσοψηφία	noun
χοῖρος	noun
κυμίνου	noun
εὐφορίας	noun
θέρμης	noun
ἄγαμος	adjective
μεῖον	adjective
μισθοῦ	noun
οἴα	adjective
οὐράς	noun
πολιτικῇ	adjective
κίων	noun
κλειτός	adjective
εὔφρων	adjective
κοῖλος	adjective
κολοφών	noun
κορωνίς	noun
κορωνός	adjective
κυνικός	noun
φαίδρα	adjective
ἀληθές	adjective
ἀποθήκης	noun
λοιμός	noun
ἀμύλου	noun
ἀμύλου	noun
ἄξια	adjective
ἄρσεως	noun
ἐνεργείας	noun
ἐπιστήμης	noun
ὀπτική	adjective
ἠθική	adjective
οἶστρος	noun
ὁπλή	noun
ὁπλίτης	noun
ὅραμα	noun
ὅρκος	noun
πεῖ	noun
πῖλος	noun
πλείων	adjective
πῆχυς	noun
φαῦλος	adjective
ῥανίς	noun
ῥοπή	noun
ῥυτίδα	noun
σταφυλῆς	noun
σκοτία	noun
σκότος	noun
σκύλαξ	noun
χρῆμα	noun
φοβερά	adjective
τετάρτη	adjective
ἕκτος	adjective
ἕκτη	adjective
ἕβδομος	adjective
ἑβδόμῃ	adjective
ὄγδοος	adjective
ὀγδόη	adjective
ἔνατος	adjective
ἐνάτη	adjective
δεκάτη	adjective
ἑνδέκατος	adjective
ἑνδεκάτη	adjective
δωδεκάτη	adjective
εἰκοστός	adjective
ἑκατοστός	adjective
ἑκατοστή	adjective
ταὐτολογία	noun
τραγῳδία	noun
χριστιανικός	adjective
ἀρχῆς	noun
ἀόρατος	adjective
ἐπάνω	adverb
ἀβύσσου	noun
ἡμέρας	noun
ἕν	numeral
καιροῦ	noun
μέγα	adjective
ἐλάσσων	adjective
ἔλασσον	adjective
ἔλασσον	verb
ἐξάγω	verb
πετεινοῦ	noun
ἀθλητής	noun
χλόη	noun
χλόης	noun
ζῆλος	noun
ἀνώνυμος	adjective
ἀταραξία	noun
κτῆνος	noun
εὐοῖ	interjection
σός	adjective
ἄπειρος	adjective
ἄπειρος	adjective
ἄπειρος	noun
πήρα	noun
θεό-	noun
ἄμορφος	adjective
χονδρός	adjective
ἀκρίς	noun
ϝοῖκος	noun
ἄλλως	adverb
βάλετε	verb
βάλε	verb
ὑπόδημα	noun
θήρα	noun
πω	particle
ἄκανθα	noun
ζεῦγμα	noun
ἁλιάετος	noun
τραῦμα	noun
γαῖα	noun
θάμβος	noun
αἶνος	noun
πωρός	adjective
μέν	particle
ἀκίς	noun
ἀνέμου	noun
ἀνέμῳ	noun
ἀνέμω	noun
ἄνεμε	noun
ἄνεμοι	noun
ἀνέμων	noun
ἀνέμους	noun
ἄβακα	noun
ἄβακες	noun
ἀβάκων	noun
ἄβακας	noun
ἀβακίσκῳ	noun
ἀβακίσκω	noun
ἀγῶνα	noun
ἀγῶνες	noun
ἀγώνων	noun
ἀγῶνας	noun
ἱστορικός	adjective
ἱστορικός	noun
ἡρωίνη	noun
ἡρωίνης	noun
ἡρωΐνη	noun
εὐσεβής	adjective
ὑλικοῦ	adjective
ὑλική	adjective
ὑλικῷ	adjective
ὑλικέ	adjective
ὑλικῆς	adjective
ὑλικῇ	adjective
ὑλικώ	adjective
ὑλικά	adjective
ὑλικοί	adjective
ὑλικῶν	adjective
ὑλικούς	adjective
ἴυγξ	noun
ἀθυμία	noun
ἀκρίδες	noun
ἁμαρτάνω	verb
ἀνθρωπόλογος	adjective
ἀορτή	noun
ἀργία	noun
αὐλητής	noun
διδαχῆς	noun
ἐθνάρχης	noun
ἐνθυμία	noun
ἕξεις	verb
ἕξεις	noun
εὑρετικός	adjective
ἠθολογία	noun
εὐφυΐα	noun
ἰχθυοφάγος	adjective
ἀποκρίνομαι	verb
ἄν	particle
ἄν	conjunction
μακεδονικός	adjective
ἀθηναῖος	adjective
ὑποθετικός	adjective
ἀποθετικός	adjective
ἐπιθετικός	adjective
ὑπερθετικός	adjective
ὑστέρα	noun
ὑστέρα	adjective
αἰσθητικός	adjective
πλέξις	noun
ἀέρινος	adjective
ἐαρινός	adjective
ἥβη	noun
ὑάκινθος	noun
βύβλος	noun
ἀγωνία	noun
αἰώνιος	adjective
ἐνάρετος	adjective
ὑφαίνω	verb
ἀποστολή	noun
ὀμίχλη	noun
ἄπφα	noun
ἀπφά	noun
μάμμη	noun
μαῖα	noun
ἁδρός	adjective
μακάριος	adjective
ἄμμος	noun
ἥρωες	noun
ἐάν	conjunction
ἐάν	particle
ἀπροσδοκήτου	adjective
ἄριστος	adjective
εἰσέρχομαι	verb
ἕως	noun
ἕως	particle
ἕως	conjunction
ἕως	adverb
βιός	noun
κλίσις	noun
ἀποστέλλω	verb
ὅταν	conjunction
ὅτε	adverb
δεῖ	verb
αἴρω	verb
ἄρτος	noun
οἰκονομία	noun
μάραθον	noun
πιθήκου	noun
πιθήκων	noun
πιθήκους	noun
τέως	particle
τέως	adverb
ἔναντι	adverb
κάκα	noun
οὔτε	adverb
ὅπου	adverb
ἱστός	noun
μᾶλλον	adverb
ἁπλόος	adjective
ἀνοίγω	verb
πλοῖον	noun
ἀπολύω	verb
εἴτε	conjunction
ἤδη	adverb
ὑπάρχω	verb
ἀσπάζομαι	verb
ὅπως	adverb
ὅπως	conjunction
ἐρωμένη	noun
ἀριθμοί	noun
ἀλείφω	verb
παρασκευή	noun
ἐρῆμος	adjective
σκῶρ	noun
ὄναρ	noun
ἄστυ	noun
ὁμίχλη	noun
ἀσφάλεια	noun
οὐαί	interjection
μνημοσύνη	noun
ἀναγκάζω	verb
ἐγγίζω	verb
μόρος	noun
ἱκανός	adjective
ἥ	pronoun
ὅ	pronoun
ᾗ	adverb
ᾗ	pronoun
ᾗ	verb
ὥ	pronoun
ἅ	pronoun
καλῶς	adverb
ὀργή	noun
ἐπιστρέφω	verb
ναί	adverb
ἐγγύς	adverb
ὑπομονή	noun
πλήν	preposition
πλήν	conjunction
ἐλπίζω	verb
ἀγοράζω	verb
ἰσχυρός	adjective
ἴδε	verb
ἴδε	verb
ἀληθινός	adjective
ἁγιάζω	verb
ἰσχύω	verb
ἐκεῖθεν	adverb
ἀκοή	noun
ἀμπελών	noun
ἄπιστος	adjective
σκεῦος	noun
λέσβια	adjective
λεσβία	adjective
ἐκλέγω	verb
κοιλία	noun
ὑπακούω	verb
καρτερώ	adjective
ἀκόλουθος	adjective
ῥάπτω	verb
αἰτία	noun
ἕτοιμος	adjective
ἑτοῖμος	adjective
πρίν	adverb
πρίν	conjunction
μελέτη	noun
ἀστραπή	noun
ἀλοιφή	noun
λήγω	verb
ὑψηλός	adjective
ἄφρων	adjective
ἐπειδή	conjunction
ἀδύνατος	adjective
ἔνοχος	adjective
αἰγύπτιος	adjective
ἄμπελος	noun
ἐκτός	adverb
ἐκτός	preposition
ἀπέναντι	adverb
εἴσοδος	noun
ἀγαθοποιός	adjective
ἀγαθωσύνη	noun
ἀγέλη	noun
ἀγενής	adjective
ἀγκάλη	noun
ἁγνισμός	noun
ἀγοραῖος	adjective
ᾖ	verb
ἆ	verb
ἄγρα	noun
ἀγράμματος	adjective
γλαύξ	noun
ἀγρυπνία	noun
ποῖ	adverb
κύπρος	noun
οἷος	determiner
ὅσος	adjective
πεμπτός	adjective
ἐΰς	adjective
πλεῖστος	adjective
ὅδε	pronoun
κόσμων	noun
νήσοι	verb
οἰνοχόος	noun
ἔπειτα	adverb
ὀξύτονος	adjective
οὐσία	noun
ὕστερος	adjective
ὡρολόγιον	noun
ἄκαπνος	adjective
ῥαββί	noun
ἀρχιμανδρίτης	noun
δημός	noun
ἐφραιμίτης	noun
ταῦ	noun
ὖ ψιλόν	noun
φεῖ	noun
ὑποδιαστολή	noun
κάμιλος	noun
λαύρα	noun
ἠμί	verb
ἐφήμερος	adjective
ἀγαθωσύνῃ	noun
ἀδάπανος	adjective
ἀθανασία	noun
ἀδελφοί	adjective
ἀδελφοί	noun
μόρα	noun
μόραι	noun
μόρᾳ	noun
ἅρμα	noun
φῖλος	noun
φωνῆς	adjective
ἱστάς	verb
τιμῶν	noun
ποιῶν	verb
ἀμέθυστος	adjective
ἀμέθυστος	noun
δασεία	adjective
δασεία	noun
γένῃ	verb
βαρεῖα	noun
βαρεῖα	adjective
ὀξεῖα	noun
ὀξεῖα	adjective
ὀξείας	adjective
ὀξείας	noun
ὀξεῖαι	adjective
ὀξεῖαι	noun
ὀξείᾳ	adjective
ὀξείᾳ	noun
δασεῖα	noun
δασεῖα	adjective
ἐξωτικός	adjective
βραχύ	adjective
ἔχον	verb
τινά	pronoun
γραμματικῶν	adjective
γραμματικῶν	noun
ὑπ'	preposition
ἐφραϊμίτης	noun
τεῦχος	noun
ὠφέλεια	noun
βαρείᾳ	adjective
βαρείᾳ	noun
ἀνταλλαγή	noun
διαφοράς	noun
γλεῦκος	noun
ἀντιστοιχία	noun
πρωτότοκος	adjective
ἄλσος	noun
κερατία	noun
κεράτια	noun
κεράτια	noun
ὀνόματος	noun
ὀνόματι	noun
ὀνόματα	noun
ὀνομάτων	noun
ἀφαιρετικός	adjective
ὀκρίς	adjective
ἀδέσποτος	adjective
αἰγίδες	noun
βότρυς	noun
ἀβουλία	noun
ἀφαιρετική	adjective
ἀφαιρετική	noun
διαλυτός	adjective
διάλυτος	adjective
ἀκρεμών	noun
λιγνύς	noun
φωνῆεν	noun
φωνῆεν	adjective
ἀντίθετος	adjective
κλείω	verb
κλείω	verb
κλείω	verb
διάλυτον	adjective
διαλυτόν	adjective
ἄναξ	noun
ἔριδα	noun
ἔριδας	noun
ἐρίδων	noun
ἔριδες	noun
ἀθάνατος	adjective
ἀθάνατος	noun
αἱμο-	noun
ποιός	adjective
ἀσύνδετος	adjective
ἰδίωμα	noun
ἀραμαῖοι	noun
σηρικός	adjective
ἱών	pronoun
τού	pronoun
διήρκεσα	verb
ὄρυζα	noun
ἀξιοπρεπής	adjective
ἀξιοπρέπεια	noun
ἑξηκοστός	adjective
ἄλλοθι	adverb
αὐτόθι	adverb
ἔσω	adverb
πρωτός	adjective
τριάς	noun
κωκυτός	noun
κυριακή	adjective
λάμια	noun
οἰκεῖος	adjective
ἁλουργίδα	noun
κάκη	noun
κύκλων	noun
παράβαλε	verb
παραβάλετε	verb
παραβάλλετε	verb
παράβαλλε	verb
ἡμίονος	noun
οὔ	particle
οὔ	particle
ἀόριστος	adjective
ἀνταρκτικός	adjective
λέμμα	noun
νομάς	noun
ἄραβες	noun
σταδιεύς	noun
βόλος	noun
βόλῳ	noun
βόλω	noun
θεσσαλικά	adjective
θεσσαλικά	adjective
μουσεῖον	noun
ἁβρός	adjective
στηλῶν	noun
γραπτῶν	adjective
ἑλληνικῆς	adjective
ἔστιν	verb
ζωγραφικός	adjective
ζωγραφική	noun
ζωγραφική	adjective
ζωγραφικῆς	adjective
ζωγραφικῆς	noun
ζῳγραφικός	adjective
ζῳγραφική	noun
ζῳγραφική	adjective
ζῳγραφικῆς	adjective
ζῳγραφικῆς	noun
ἄξων	noun
ἔφορος	noun
ἐφόρου	noun
εὕρηκα	verb
ὀκτάπους	adjective
ὀκτάπους	noun
ζωγραφία	noun
ζῳγραφία	noun
ζωγραφίαι	noun
ζῳγραφίαι	noun
ἀνασκαφή	noun
ἔρευνα	noun
ἔρευναι	noun
δωρεά	noun
τυμβαύλης	noun
σέ	pronoun
δοτική	noun
δοτική	adjective
ἑτέρα	adjective
ἕτερα	adjective
ἐμπειρική	noun
ἐμπειρική	adjective
εὐχή	noun
ἕλος	noun
κριταί	noun
ἡσυχία	noun
φαρμακός	noun
φάρμακος	adjective
φάρμακος	noun
εὐτυχία	noun
πηγαῖος	adjective
ὑπογράφω	verb
ἀμβρόσιος	adjective
χθόνια	adjective
χθονίᾳ	adjective
χθονίῳ	adjective
χθονίω	adjective
θρόνῳ	noun
θρόνω	noun
χρυσελεφαντίνῃ	adjective
χρυσελεφαντίνη	adjective
χρυσελεφαντίνω	adjective
χρυσελεφαντίνῳ	adjective
χρυσελεφαντίνα	adjective
χρυσελεφάντινα	adjective
ὑπόγειος	adjective
ὑπογείου	adjective
ὑπογείου	noun
ὑπογείω	adjective
ὑπογείω	noun
ὑπόγεια	adjective
ὑπόγεια	noun
ὑπογείων	adjective
ὑπογείων	noun
ὑπογείους	adjective
ὑπογείῳ	adjective
ὑπογείῳ	noun
ὑπόγειε	adjective
ὑπόγειοι	adjective
μύρρα	noun
εἰσαγωγή	noun
ἐκεῖνα	pronoun
δελφίς	noun
ληθαργία	noun
ληθαργίᾳ	noun
ἔκδοσις	noun
ἐκδόσεως	noun
ἐκδόσεις	noun
ἐκδόσεων	noun
ἐκδόσις	noun
ἐσωτερικός	adjective
ὁδούς	noun
ἀνώμαλος	adjective
καδμεία	noun
ὄσσα	noun
θεάς	noun
ἆρα	particle
χείρων	adjective
ἄκοιτις	noun
ἀπροσδοκήτῳ	adjective
ἀπροσδόκητε	adjective
ἀπροσδοκήτω	adjective
ἀπροσδόκητοι	adjective
ἀπροσδόκητα	adjective
ἀπροσδοκήτων	adjective
ἀπροσδοκήτους	adjective
ἦ	verb
ἦ	conjunction
ἐπιγραφή	noun
ἀντίπατρος	noun
ἄπο	preposition
ἅπαξ	adverb
ἀγορεύω	verb
ἡμῶν	pronoun
δῖος	adjective
ἄμη	noun
ἐνί	preposition
ἐς	preposition
ἠέλιος	noun
ἱππότης	noun
ἀναλαμβάνω	verb
ἕ	pronoun
πόθι	adverb
ἐπινομίς	noun
ἀνατολή	noun
τάττω	verb
λάμια	noun
τμῆμα	noun
ἀσφόδελος	noun
ἀσφοδελός	adjective
διπλοῦς	adjective
ἁπλοῦς	adjective
πείσω	verb
ἦν	verb
εἶσι	verb
εἶσιν	verb
καλῶ	verb
αὑτός	adjective
ἀθλητικός	adjective
ἀμαθής	adjective
περ	particle
περ	preposition
αὐτή	verb
αὐτό	verb
αὕτη	pronoun
αὑτή	pronoun
τοῦτο	pronoun
ἴα	verb
ἴα	noun
ἄστεα	noun
εἰπέ	verb
βατός	adjective
βατή	adjective
ποσός	adjective
ἔντομα	noun
ἠδέ	conjunction
φωτεινός	noun
τιμῆς	noun
τίνες	pronoun
ὄις	noun
ἱερέας	noun
νημερτής	adjective
πώλης	noun
αἰδώς	noun
ταχεῖα	adjective
ὅμιλος	noun
παρ'	preposition
ἑρμηνεύω	verb
ἑρμηνεία	noun
ἀεργός	adjective
ὑποθήκη	noun
ἐπίλογος	noun
πορφύρα	noun
γνώσεις	noun
ὄλισβος	noun
ὕσσωπος	noun
ἄσφαλτος	noun
πασπάλη	noun
βαρβάρα	noun
αἰδώς	noun
αἰσχύνη	noun
κούρα	noun
μά	particle
τούτου	adjective
ποθι	adverb
πόσε	adverb
ποθεν	adverb
μέδων	noun
ἰχθυοπώλης	noun
ἰχθυόφαγος	adjective
ἑτέρᾳ	adjective
ἐκείνα	adjective
ζωγραφίᾳ	noun
ζῳγραφίᾳ	noun
ὀλιγάρχης	noun
ὀλιγαρχία	noun
ὀλιγαρχικός	adjective
ὑπερῴα	noun
ᾦον	noun
ᾠοειδής	adjective
ἔ	interjection
εἶμεν	verb
ᾖς	verb
εἶτε	verb
ἐσχάριῳ	noun
ἐσχάριω	noun
ὀλιγαρχίᾳ	noun
ἀρχῇ	noun
εὐκτική	noun
ἱεραρχία	noun
ἱεράρχης	noun
δημοκρατίᾳ	noun
δημοκρατίαιν	noun
δημοκρατιῶν	noun
ἅλας	noun
χάλυψ	noun
μοῦσα	noun
ζῦθος	noun
ζῦθοι	noun
ζῦθε	noun
ζῦθον	noun
ζύθον	noun
ζυθῶν	noun
ἄτη	noun
ἄτης	noun
δικαιαδίκῳ	adjective
δικαιαδίκω	adjective
τέττιξ	noun
αἰθαλίων	adjective
αἴθαλος	noun
αἴθαλος	adjective
αἰθαλός	noun
αἰθαλός	adjective
θεῷ	noun
ἐνεργητικός	adjective
αἰτιατική	adjective
αἰτιατική	noun
ἀδικίας	noun
τ'	conjunction
τ'	particle
ὥς	adverb
ἤν	conjunction
οἵ	pronoun
οἵ	adjective
ἀνδρῶν	noun
ῥα	conjunction
ἵππους	noun
θεῶν	noun
νῆας	noun
ἄλλοι	adjective
αὐτῷ	pronoun
ἠέ	conjunction
τρῶας	noun
κεν	particle
αὖτε	adverb
ὅν	pronoun
ὅν	adjective
ἄρ	conjunction
ἄρ'	conjunction
ἐπ'	preposition
ῥ'	conjunction
εἴ	conjunction
αἵ	pronoun
αἵ	adjective
κ'	particle
αὖτ'	adverb
σκευή	noun
σοι	pronoun
σοί	pronoun
σοί	adjective
ἔργα	noun
αἴ	interjection
τοί	pronoun
τοί	adjective
ἐπικός	adjective
πᾶσα	determiner
τέ	conjunction
τέ	pronoun
κέ	particle
νύ	particle
νυ	particle
ἅμ'	adverb
ἅμ'	preposition
ἄρρυθμος	adjective
ἀρρυθμία	noun
ἀρρυθμίας	noun
ἀπ'	preposition
βουλῆς	noun
ἤτοι	conjunction
ποτε	adverb
πάρ	preposition
πάρος	adverb
πάρος	conjunction
πάρος	preposition
κέν	particle
ἐπιστάτης	noun
ἀνθρώπων	noun
ἄλλων	adjective
ἵππων	noun
ἵπποι	noun
δῶρα	noun
ῥά	conjunction
βῆμα	noun
ἀντίον	adverb
ἀντίον	preposition
ἀντίον	noun
ἀντίον	adjective
ἄνδρα	noun
ἐρημία	noun
τινα	pronoun
ἐξομολόγησις	noun
διοπετής	adjective
αὔδα	verb
αὐδᾷ	verb
ἰσχνός	adjective
δρακόντιον	noun
δρακόντιος	adjective
κρείων	noun
νάρκισσος	noun
βίου	noun
βίων	noun
βίους	noun
βίοι	noun
κς	noun
κυ	noun
πᾶχυς	noun
κηφῆνας	noun
κηφῆνες	noun
κηφῆνα	noun
κηφῆνες	noun
ἔρεσθαι	verb
ἐρέσθαι	verb
δρυάς	noun
δρύας	noun
φορεῖ	verb
φόρει	verb
νή	adverb
ἔπαινος	noun
ὄλεθρος	noun
εἰσί	verb
εἰσίν	verb
ἐστίν	verb
ἔστε	verb
ὄκνος	noun
κέρασι	noun
ϼ	noun
εἶπε	verb
βιῶ	verb
βιῷ	noun
βιώ	noun
βίῳ	noun
βίω	noun
βιοῖς	noun
βιοῖς	verb
βίοις	noun
βιοῖ	verb
βιοί	noun
βιοῦ	noun
βιοῦ	verb
βιῶν	noun
βιούς	noun
βίον	noun
βιόν	noun
ἕλκω	verb
γένεα	noun
δῖον	adjective
ἰών	pronoun
ἥν	pronoun
ἥν	adjective
πάτερ	noun
ἐστιν	verb
πρῶτα	adjective
πρῶτα	adverb
ἄλλο	adjective
δῖα	adjective
δία	adjective
δίᾳ	adjective
ἴδον	verb
κεῖνος	pronoun
ἑ	pronoun
λύοις	verb
νέω	verb
νέω	verb
νέω	verb
νέω	adverb
ἔστι	verb
ἐστι	verb
ὤ	interjection
ἐσσι	verb
ἐσσί	verb
ἄλλα	adjective
γυιόν	adjective
γυῖον	noun
γυῖα	noun
γυιά	adjective
ἥκιστα	adjective
ἥκιστα	adverb
γαίης	noun
δόμον	noun
ἔγχεϊ	noun
δήμῳ	noun
ἄζωτος	adjective
ἀγνῶτος	adjective
ἄγνωτα	adjective
ἀγνῶτα	adjective
ἀγνῶτε	adjective
ἄγνωτε	adjective
ἀγνώτῳ	adjective
ἀγνώτω	adjective
διγενής	adjective
κρινῶ	verb
μενῶ	verb
οὕς	pronoun
οὕς	adjective
δι'	preposition
πολιός	adjective
πολιός	noun
βρότων	noun
βροτῶν	noun
ξενῶν	noun
θεῖα	adjective
θειῶν	noun
νεῶν	noun
ὀξέϊ	adjective
ὀξεῖ	adjective
πώ	particle
καμπή	noun
κάμπη	noun
κάμπη	noun
ἅλα	noun
ὑβρίς	noun
πέρ	particle
ἔνι	preposition
ὕπο	preposition
ἑνί	numeral
οἷ	adverb
κύανος	noun
πέρι	preposition
ἀλκή	noun
ἀλκῆς	noun
δήν	adverb
τελευταία	adjective
δρεπάνη	noun
ἀγωγή	noun
πόσιν	noun
δαίς	noun
ἀν'	preposition
γυναῖκας	noun
ποσίν	noun
ἐΰ	adverb
ἧς	pronoun
ἧς	adjective
πάρα	preposition
πάρα	verb
ἀγῶν	noun
ὤμων	noun
ὠμῶν	adjective
ἰδέ	conjunction
ἰδέ	verb
ἀμβλύς	adjective
θολερός	adjective
ἀμοιβή	noun
ἀμνησία	noun
ἐλαφρός	adjective
κοῦφος	adjective
ὦμον	noun
ὠμόν	adjective
δαΐς	noun
δάϊς	noun
δαΐσι	noun
δαισί	noun
κτῆμα	noun
πατέρ'	noun
νῆσοι	noun
σιωπῇ	noun
σιωπῇ	adverb
εἰσι	verb
τοῖχος	noun
ἠελίοιο	noun
ἅς	pronoun
ἅς	adjective
κήρ	noun
αἰνός	adjective
διογενής	adjective
πευκεδανός	adjective
ὁμῶς	adverb
ὅμως	adverb
ἀπληστία	noun
εὔνοια	noun
ἄνοια	noun
ἅγια	adjective
ἀλκῶν	noun
κρέων	noun
ὀρχήστρα	noun
ἀναγωγή	noun
ἀναφορά	noun
κυριῶν	noun
ἀγορᾶς	noun
βορᾶς	noun
ἀνάλογος	adjective
ἄνοδος	noun
ἠχοῦς	noun
ἀγελαῖος	adjective
ἄνισος	adjective
ἄσυλος	adjective
φοίνικος	noun
ἄναρχος	adjective
ἄναρθρος	adjective
ἥπατος	noun
ἄνδρε	noun
μῆτερ	noun
ὅσσα	adjective
ὅσσα	adverb
σῷ	adjective
ἦε	conjunction
ᾖε	verb
λέγομεν	verb
ἀνθρώπινος	adjective
ἡνία	noun
μῆτις	noun
κᾷτα	conjunction
εὐνοῦχος	noun
εὖρος	noun
ἴχνους	noun
οὐκοῦν	conjunction
ποίει	verb
θές	verb
λαβέ	verb
βοήθει	verb
ἕς	verb
σκόπει	verb
βάλλε	verb
βοηθέω	verb
ῥώμη	noun
ἄγαλμα	noun
ἀνωμαλία	noun
ἐπιτήδευμα	noun
ἀδίκημα	noun
γενναῖος	adjective
ἀναγκαῖος	adjective
τελευταῖος	adjective
γελοῖος	adjective
εἰσβολή	noun
πῇ	adverb
ἀποχή	noun
ἀνοχή	noun
ἡφαιστεῖον	noun
ἐκπομπή	noun
ἀποστροφή	noun
κρῖμα	noun
ἀποδοχή	noun
ὑποδοχή	noun
ἐπιστροφή	noun
ἐκδοχή	noun
module:user:erutuon/grc	noun
module:user:erutuon/grc	adjective
module:user:erutuon/grc	verb
module:user:erutuon/grc	verb
ἐπιλογή	noun
μιᾷ	numeral
μιᾷ	verb
ὀνομαστική	noun
ὀνομαστική	adjective
δείδω	verb
ἀποτροπή	noun
κῆπος	noun
ὀροφή	noun
ἐνοχή	noun
ἀκριβής	adjective
εἰσφορά	noun
σή	adjective
εὐσέβεια	noun
ἀποκοπή	noun
ἀσέβεια	noun
ἄγροικος	adjective
ἱκάνω	verb
ἱκανώ	adjective
ἱκανῷ	adjective
ἱκανῶ	verb
ἥδε	pronoun
ὀρύσσω	verb
ἐθναρχῶν	noun
ἐθνάρχαι	noun
ἐθνάρχας	noun
αὖθις	adverb
ζεῦγος	noun
αἴθων	noun
σής	noun
ὑποτείνουσα	noun
ἐπίρρημα	noun
ἐμπλοκή	noun
ἀγορῶν	noun
ἀγοράς	noun
αἱρῶ	verb
ἆρον	verb
ὑποδήματος	noun
ὑποδήματα	noun
ὑποδημάτων	noun
ἐντούτοις	adverb
μήκων	noun
πίσος	noun
ἶρις	noun
μνημῶν	noun
τεχνολογιῶν	noun
πίθων	noun
πίθον	noun
ποικίλον	adjective
ποικίλαι	adjective
ποικιλώτερος	adjective
ποικιλώτατος	adjective
λαιστρυγών	noun
τίνα	pronoun
τίνων	pronoun
γονυπετοῦς	adjective
γονυπετῆ	adjective
γονυπετεῖς	adjective
γονυπετεῖς	verb
γονυπετῶν	adjective
γονυπετεῖ	adjective
γονυπετεῖ	verb
γονυπετῶς	adverb
ἐγέρθητι	verb
ἐγέρθητε	verb
ἐγερθήτω	verb
εἰκονικός	adjective
παρακειμένου	noun
παρακειμένων	noun
παρακειμένους	noun
παρακειμένῳ	noun
παρακείμενον	noun
παρακειμένω	noun
παρακειμένοιν	noun
παρακειμένοις	noun
ἐνίκησα	verb
πομφόλυγες	noun
περιοδικόν	adjective
περιοδική	adjective
περιοδικῇ	adjective
περιοδικῆς	adjective
περιοδικῶν	adjective
περιοδικῷ	adjective
περιοδικοῖν	adjective
περιοδικαῖν	adjective
περιοδικοῖς	adjective
περιοδικαῖς	adjective
περιοδικώ	adjective
περιοδικοῦ	adjective
λύσετε	verb
λυθῶ	verb
λυθεῖτε	verb
ἔλυσα	verb
ἔλυσας	verb
ἔλυσε	verb
ἐλύσατε	verb
ἔλυσαν	verb
λύσῃ	verb
λῦσαν	verb
ἄστυ	noun
εὐσεβείας	noun
εὐσεβειῶν	noun
ἀσεβείας	noun
ἀσεβειῶν	noun
εὐσεβοῦς	adjective
εὐσεβεῖ	adjective
εὐσεβῆ	adjective
εὐσεβές	adjective
εὐσεβεῖς	adjective
εὐσεβῶν	adjective
ἀῶ	verb
ἀάσθω	verb
ἄασας	verb
ἄασαν	verb
ἀάσθης	verb
ἀάσθη	verb
ἀάσθητον	verb
ἀάσθητε	verb
ἀασθῶ	verb
ἀασθῇς	verb
ἀασθῇ	verb
ἀασθῆτον	verb
ἀασθῆτε	verb
ἀάσας	verb
ἀᾶσαν	verb
ἀγαθοεργεῖ	verb
ἀγαθοέργει	verb
λύετον	verb
λύητον	verb
λύοι	verb
λύοιτον	verb
λυοίτην	verb
λύοιμεν	verb
λύοιτε	verb
λύοιεν	verb
λυέτων	verb
ἀγαθοποιεῖ	verb
ἀγαθοποίει	verb
ἔχεις	verb
εἶχες	verb
εἶχε	verb
ἁγίας	adjective
κοιτίδος	noun
κοιτίδες	noun
ἐρρίνου	noun
ἐρρίνων	noun
ἔρρινα	noun
ἀγαπῶ	verb
ἀγαπῷ	verb
ἀγγελοῦ	verb
ἤγειρε	verb
ἤγειρα	verb
ἤγειρας	verb
ἤγειραν	verb
ἀγείραι	verb
ἠγειράσθην	verb
ἄγειραι	verb
ἠγέρθησαν	verb
ὀφιοειδοῦς	adjective
ὀφιοειδῆ	adjective
ὀφιοειδές	adjective
ὀφιοειδεῖς	adjective
ὀφιοειδῶν	adjective
λευκοῦ	adjective
λευκῷ	adjective
λευκώ	adjective
λευκόν	adjective
λευκῆς	adjective
λευκῇ	adjective
λευκήν	adjective
λευκοῖν	adjective
λευκαῖν	adjective
λευκῶν	adjective
λευκοῖς	adjective
λευκαί	adjective
λευκαῖς	adjective
λευκάς	adjective
ἡροδότου	noun
ἡρόδοτε	noun
σοφοῦ	adjective
σοφῷ	adjective
σοφώ	adjective
σοφῆς	adjective
σοφῇ	adjective
σοφήν	adjective
σοφοῖν	adjective
σοφαῖν	adjective
σοφῶν	adjective
σοφοῖς	adjective
σοφούς	adjective
σοφαί	adjective
σοφαῖς	adjective
ποικιλωτέρου	adjective
πόλιος	noun
ἰπνός	noun
ἀρετῶν	noun
τυράννων	noun
τυράννων	adjective
προτέρῳ	adjective
φᾶρος	noun
σπεῖρα	noun
σπεῖρα	noun
ἐρεθίζω	verb
σαός	adjective
ἕλκος	noun
ἑστία	noun
ἴτυς	noun
χειλῶν	noun
-ποιήσεως	noun
-ποιήσεις	noun
-ποιήσεων	noun
κλύσμα	noun
ζώων	noun
φυτικοῦ	adjective
φυτικῷ	adjective
φυτικόν	adjective
φυτική	adjective
φυτικῆς	adjective
φυτικῇ	adjective
φυτικώ	adjective
φυτικοῖν	adjective
φυτικαῖν	adjective
φυτικῶν	adjective
φυτικοῖς	adjective
φυτικαῖς	adjective
εὔχεται	verb
φρύνη	noun
βοηθῶ	verb
βοηθῶ	verb
νοῶ	verb
αἴγλη	noun
κἀν	phrase
ζητῶ	verb
κυήματος	noun
κυήματι	noun
κυήματα	noun
κυημάτων	noun
κυήμασι	noun
κυήμασιν	noun
ἀποκυήματος	noun
ἀποκυήματα	noun
ἐξήρθην	verb
σαῦλος	adjective
ἧτα	noun
ϙόππα	noun
λασιών	noun
σκόμβρος	noun
κρεμῶ	verb
ἐξετέλεσα	verb
ἐκτελῶ	verb
ἐξετελέσθην	verb
ἀδικοῦμαι	verb
ἀδικῶ	verb
ἀπασχολῶ	verb
ἀπασχολοῦμαι	verb
λορδός	adjective
ἀποκλείομαι	verb
ἀπέκλεισα	verb
ἀποκλείεται	verb
ἀποκλείετε	verb
ἐγκλείομαι	verb
ἐνέκλεισα	verb
ἐμπερικλείομαι	verb
ἐμπεριέκλεισα	verb
ἔσεισα	verb
ἀποσείομαι	verb
ἀπέσεισα	verb
ἐπισείομαι	verb
ἐπέσεισα	verb
ἔκρουσα	verb
ἀνέκρουσα	verb
ἀνακρούομαι	verb
ἀντικρούομαι	verb
ἀντέκρουσα	verb
ἀποκρούομαι	verb
ἀπέκρουσα	verb
ἐκκρούομαι	verb
ἐξέκρουσα	verb
ἑλκύομαι	verb
εἵλκυσα	verb
ἕλκομαι	verb
εἰσακούομαι	verb
ἀνελκύομαι	verb
σκῶλος	noun
σκάρφη	noun
σχοῖνος	noun
ἀπεκλείσθη	verb
τειχεσιπλῆτα	noun
ἐνέπνευσα	verb
ἐμπνέομαι	verb
εἰσέπνευσα	verb
εἰσπνέομαι	verb
ἀνέπνευσα	verb
ἀπέπνευσα	verb
ἔπνευσα	verb
ἀνέπλευσα	verb
ἐπέπλευσα	verb
ἔπλευσα	verb
ἔρρευσα	verb
εἰσέρρευσα	verb
κώρυκος	noun
τανάγρα	noun
μίδας	noun
ἐξέπλευσα	verb
εἰσέπλευσα	verb
ἀναποδίζω	verb
ξουθός	adjective
ἔκλεισα	verb
ἄναυρος	noun
σκῦρος	noun
ἱδρύομαι	verb
ἵδρυσα	verb
ἀπολύομαι	verb
ἀπέλυσα	verb
ἀθήρ	noun
κυφός	adjective
παραβύστω	adjective
παραβύστῳ	adjective
παραβύστοιν	adjective
παραβύστοις	adjective
βύσσος	noun
ἀστακός	noun
καλλίας	noun
ἴδη	noun
βῆσσα	noun
κωλύομεν	verb
δῶ	noun
δῶ	verb
δῶ	verb
χ'	particle
σφ'	pronoun
λάβε	verb
ἀγήνωρ	adjective
ἄλκιμος	adjective
ἔν	preposition
ἶσος	adjective
υἱέ	noun
εἰσιν	verb
ἄλλ'	pronoun
ἔλυμος	noun
ἔλυμος	noun
προτέρω	adjective
σεῦ	pronoun
θέμις	noun
οἷς	pronoun
οἷς	determiner
ἀνίδρυσα	verb
ἀνιδρύομαι	verb
ἐγκαθιδρύομαι	verb
πῃ	adverb
ἐγγράφομαι	verb
οὖτα	verb
οὔτα	verb
οὐτᾷ	verb
ξύν	preposition
ἴον	noun
σοφίαιν	noun
οὐδεμία	pronoun
οὐδεμία	pronoun
οὐδεμιᾷ	pronoun
κἄν	phrase
ἄρχοντα	noun
ἀπῆλθον	verb
καῖρος	noun
τινάς	pronoun
τῳ	pronoun
ἥσυχος	adjective
ἔτει	noun
ἐπιπλέω	verb
χίων	adjective
χῖοι	adjective
χῖον	adjective
οἶα	adjective
κίον	verb
ὅμηρος	noun
οἷα	determiner
ἄρχοντες	noun
ἔφραξα	verb
κροτών	noun
ῥύπος	noun
μύσος	noun
ἀπέσταξα	verb
ἔσταξα	verb
αἰόλος	adjective
πάτρια	noun
πάτρια	adjective
ἐᾶν	verb
θρύον	noun
σπίνος	noun
ποι	adverb
ὖ	noun
ἄραδος	noun
αὑτῷ	pronoun
ῥίον	noun
ἴσαι	adjective
ἵδρυμα	noun
ἤπια	adjective
ἤπια	adjective
ἐφιάλτης	noun
ἑορτάζομαι	verb
ἀκιρίς	noun
ἐπιλέγω	verb
ἐξελέγην	verb
ἐκλέγομαι	verb
ἐξέλεξα	verb
γαυλός	noun
ἀναγκάζομαι	verb
ἐξαναγκάζομαι	verb
ἐθαύμασα	verb
θῖνα	noun
νεός	noun
ἀπέδειξα	verb
ἀπεδείχθη	verb
ἀποδείξεις	noun
ἀποδείξεις	verb
ἀπεδείχθησαν	verb
ἀπέδειξε	verb
θοάς	adjective
ζωόν	adjective
ἔβαλε	verb
ἐξώστης	noun
ἕλον	verb
υἷος	noun
θάψος	noun
ἀκτέα	noun
ἰῷ	noun
ἰῷ	adjective
πάτρα	noun
πάτρα	noun
πατρία	adjective
ταρσός	noun
γαληψός	noun
γεωγραφικόν	adjective
ὄχθη	noun
λέρος	noun
κυνηγῶ	verb
υἷε	noun
ἴλη	noun
ἀρτέμων	noun
ἰσθμός	noun
οἴω	adjective
οἴῳ	adjective
σῇ	adjective
σχῖνος	noun
ἄμ	preposition
ζώω	verb
ζωῷ	adjective
ζῴῳ	noun
ζώῳ	noun
κρειῶν	noun
ἔπεμψα	verb
βάν	verb
ἔτερψα	verb
δόμων	noun
μέροψ	noun
ἀπέπεμψα	verb
ἀποπέμπομαι	verb
ἔδρεψα	verb
ἔλειψα	verb
ἐκλείψεις	noun
ἐκλείψεις	verb
εἴα	verb
εἶα	interjection
ἔτρεψα	verb
ἐτράπην	verb
ἀνέτρεψα	verb
ἀνατρέπομαι	verb
ἀνετράπην	verb
ἀπέτρεψα	verb
ἀποτρέπομαι	verb
ἀπετράπην	verb
ἐπέτρεψα	verb
ἐπιτρέπομαι	verb
ἐπετράπην	verb
ἐπιτρέπετε	verb
ἐπιτρέπεται	verb
ἐξέτρεψα	verb
ἐκτρέπομαι	verb
ἐξετράπην	verb
κλῆμα	noun
ἐφάπτομαι	verb
ἀρία	noun
ὀρός	noun
σίδη	noun
ἠέλιος	noun
ἠελίοιο	noun
ἀνέκαμψα	verb
ἐνέσκηψα	verb
ἄρον	noun
σκῆψις	noun
πολέων	adjective
μέσῳ	adjective
κρατός	noun
γάνος	noun
γάνος	noun
γάνος	noun
ὑπέκρυψα	verb
ἀνεκάλυψα	verb
ἀνακαλύπτομαι	verb
ἀνεκαλύφθην	verb
ἀνακαλύψεις	noun
ἀνακαλύψεις	verb
ἀπέκρυψα	verb
βλάπτει	verb
βλάπτῃ	verb
ἔκαμψα	verb
ἀπεκάλυψα	verb
ἀποκαλύπτομαι	verb
ἀπεκαλύφθην	verb
ἀποκαλύψεις	noun
ἀποκαλύψεις	verb
ἀπέρριψα	verb
ἀπορρίπτομαι	verb
ἀπερρίφθην	verb
ἀπορρίψεις	noun
ἀπορρίψεις	verb
ἐκκολάψεις	noun
ἐκκολάψεις	verb
ἀνεσκάφην	verb
ἀνέσκαψα	verb
ἀνασκάπτομαι	verb
σευ	pronoun
κλύον	verb
ἀνέκοψα	verb
ἀνακόπτομαι	verb
ἀνεκόπην	verb
ἀπέκοψα	verb
ἀποκόπτομαι	verb
ἀπεκόπην	verb
ἀγόν	noun
ἔγχει	noun
θύμβρα	noun
ὀλός	noun
θινός	noun
εἰμεν	verb
εἰμέν	verb
ἀνανήψεις	noun
ἀνανήψεις	verb
ἔστεψα	verb
ἐστέφθην	verb
κτεῖναι	verb
κτείναι	verb
ἔβαλον	verb
συγγραφεῖς	noun
ἀναγράφομαι	verb
ἀνέγραψα	verb
ἀνεγράφην	verb
καταγραφεῖς	noun
ὦτος	noun
λιπῶν	noun
ϝοῖνος	noun
ὑπογράφομαι	verb
ὑπογράφεις	verb
ὑπογραφεῖς	noun
ὑπογράφει	verb
ἀναστρέφομαι	verb
ἐπιστρέφομαι	verb
ἐπέστρεψα	verb
ἷξον	verb
ἔστρεψα	verb
πῶρος	noun
συγγραφεῖ	noun
συγγράφεις	verb
συγγραφῆς	noun
συγγραφῆς	noun
συγγραφῆς	verb
συγγράφῃς	verb
συγγραφῇς	verb
συγγράφει	verb
συγγράφῃ	verb
συγγραφῇ	noun
συγγραφῇ	verb
συγγραφῆ	noun
ἀπείρων	adjective
ἀπείρων	noun
ἀπείρων	adjective
τιτᾶνες	noun
τιτάνων	noun
τιτᾶνα	noun
δαίμονι	noun
κελεός	noun
χῖε	adjective
μαλλός	noun
δυσκέλαδος	adjective
ὀθόνη	noun
ἀρωγή	noun
κύπρινος	adjective
ψῆφε	noun
ψῆφοι	noun
παρέγραψα	verb
ἔκλεψα	verb
ἐκλάπην	verb
ἐτάφην	verb
τελαμών	noun
ἐλεός	noun
ἐλεός	noun
ἔρραψα	verb
ἄκατος	noun
ἐνδιέτριψα	verb
ἀνάσσω	verb
ἀνετράπη	verb
ἀνετράπησαν	verb
ἀπετράπη	verb
ἀπετράπησαν	verb
ἐπετράπη	verb
ἐπετράπησαν	verb
ἐνεγράφη	verb
ἐνεγράφησαν	verb
σῆς	adjective
κιλλός	adjective
μυνδός	adjective
ἀναδείξεις	noun
ἀναδείξεις	verb
πλαγίασα	verb
ἀνία	noun
ἱκέτευσα	verb
ἐπιγράφομαι	verb
ἐπέγραψα	verb
φάλος	noun
βῖκος	noun
βῖκος	noun
ῥέα	adverb
σμύρνα	noun
πείρατα	noun
πειρατά	noun
ἐπαρχία	noun
ἐπαρχίας	noun
ἐπαρχιῶν	noun
ἔφθασα	verb
κατάνη	noun
ὑπερῷα	noun
χορεύομεν	verb
ληνός	noun
ἐκινδύνευσα	verb
ἐκινδύνευσε	verb
ἐκινδύνευε	verb
ἐκινδύνευεν	verb
μύλαι	noun
ποταμῶν	noun
δοῦλοι	adjective
δοῦλοι	noun
ἰσχυροί	adjective
ἀγγεῖα	noun
μαντεῖα	noun
ὄλυνθος	noun
κάμψα	noun
πιστεύομεν	verb
βουτός	noun
μναῖ	noun
σῦρ	noun
κοράκινος	adjective
ἔθελον	verb
ἐπροφήτευσα	verb
εἰσ'	verb
στερήσεις	noun
στερήσεις	verb
στεροῦμεν	verb
ὑστέρησα	verb
ὑστερῶ	verb
οἶκοι	noun
ψοῖθος	noun
κοράλλιον	noun
βάλλετε	verb
ἔβαλλον	verb
ἔβαλεν	verb
βάλλεται	verb
παρέβαλλον	verb
παραβάλλεται	verb
ἁλί	noun
ἴδῃ	noun
ἴδῃ	verb
ἵπταμαι	verb
μάγδωλος	noun
ἀποβάλλομαι	verb
ἀποβάλω	verb
ἀπέβαλον	verb
ἀπέβαλλον	verb
ἀποβάλλετε	verb
ἀποβάλετε	verb
ἀπόβαλλε	verb
ἀπόβαλε	verb
καταβάλω	verb
κατέβαλον	verb
κατέβαλλον	verb
καταβάλλετε	verb
καταβάλετε	verb
κατάβαλλε	verb
κατάβαλε	verb
κατέβαλε	verb
κατέβαλεν	verb
κατέβαλλεν	verb
κατέβαλλε	verb
δαιμόνι'	adjective
οἰκονόμος	noun
ἴπνος	noun
ποτής	noun
ἀποβάθρα	noun
ἰγνύα	noun
ἠῶ	noun
ἀνᾴσσω	verb
ἀριστεύς	noun
πάδος	noun
μῆνιγξ	noun
ὑπηρεσία	noun
ἔτεινα	verb
τείνομεν	verb
ἀνέτεινα	verb
ἀνατείνομαι	verb
ἀνατείνομεν	verb
κρίνομεν	verb
ἔκρινα	verb
ἀνέκρινα	verb
ἀνακρίνομαι	verb
ἀνακρίνομεν	verb
ἀπέκρινα	verb
ἔκλινα	verb
δῆρις	noun
ἔρανος	noun
μεταφέρομεν	verb
τινῶν	pronoun
τινων	pronoun
ἐμπορία	noun
ἐμπόρια	noun
σύρος	noun
ἔπαυσα	verb
ὀρυά	noun
γαῦλος	noun
ἀκιδωτός	adjective
ἀκιδωτός	noun
τισί	pronoun
βῶλος	noun
φαῖνοψ	noun
δῆλοι	adjective
δηλοῖ	verb
περίνεος	noun
ῥοδανός	adjective
ἀλωή	noun
συνάπτομεν	verb
συνῆψα	verb
πέλλα	noun
πέλλα	noun
ξένια	adjective
ξένια	noun
δόλιχος	noun
ἐπισυνάπτομαι	verb
ἐπισυνάπτομεν	verb
ἐπισυνήφθην	verb
ἐπισυνήφθη	verb
ἐπισυνήφθησαν	verb
ἐπισυνῆψα	verb
περιπλέκομεν	verb
ἠπειρώτης	noun
ἐγείρομαι	verb
ἐγείρομεν	verb
ἠϊών	noun
παλαιᾶς	adjective
μόψος	noun
ἄϋλος	adjective
ἔξυσα	verb
ἐκλήθην	verb
ἐκλήθη	verb
ἐκλήθησαν	verb
μέτα	adverb
μετρίᾳ	adjective
μετρία	adjective
ὠχρός	adjective
οἰωνός	noun
τορύνη	noun
ἴαχον	verb
ῥάμφος	noun
εὐρωπαῖος	adjective
ἄειραν	verb
κοσμοπολίτῃ	noun
κοσμοπολίτα	noun
κοσμοπολίτᾳ	noun
κοσμοπολίταν	noun
κοσμοπολιτᾶν	noun
κοσμοπολιτῶν	noun
κοσμοπολῖτα	noun
κορακῖνος	noun
δύναι	verb
δῦναι	verb
πλωϊμώτερα	adjective
πλωϊμωτέρα	adjective
σάρος	noun
θείω	verb
θείω	verb
θείω	adjective
θείω	noun
θειῶ	verb
κυπρῖνος	noun
τορός	adjective
ἄρχε	verb
ἀρχέ	noun
ἕκτα	adjective
ἔκτα	verb
ὄπ'	noun
ἐφημερίδα	noun
ἐφημερίδες	noun
ἐφημερίδας	noun
ἐφημερίδων	noun
μητέρ'	noun
ἐλαίη	noun
πορφυρίων	noun
ἴψος	noun
αἰδώ	noun
αἰδῶ	noun
ἀλίνδα	noun
καταστῆναι	verb
λέπας	noun
ψωρός	adjective
ἠρώτησα	verb
ἐρωτῶμαι	verb
ἐρωτῶ	verb
τέκον	verb
φύγον	verb
πάλμυς	noun
οἴκοι	adverb
ἄρρητος	adjective
νεῦρα	noun
νευρά	noun
θύον	noun
ἐδάφη	noun
πεῖσμα	noun
πεῖσμα	noun
βῶλαξ	noun
ἁπαλός	adjective
θρῦλος	noun
δημῷ	noun
ἀγόρευσον	verb
συρία	noun
λεπάς	noun
ὑποδεέστερα	adjective
ὑποδεεστέρα	adjective
διπλασία	adjective
φανερᾶς	adjective
φανεράς	adjective
οὔκουν	adverb
ἐνδεεστέρα	adjective
ἐνδεέστερα	adjective
ἐνδεεστέρᾳ	adjective
ὀστέ'	noun
πρόσκωπος	noun
περίνεως	noun
ἀλαλητός	noun
οὐρός	noun
δοιῷ	adjective
δοιώ	adjective
ψήν	noun
ὄχημα	noun
ἀλθαία	noun
τῆ	interjection
ἀνέμη	noun
αὐτώ	pronoun
χρονίᾳ	adjective
χρονία	adjective
ἅλωσιν	noun
ἁλῶσιν	verb
κυπαρισσίας	noun
πᾶγος	noun
πνοιῇς	noun
πνοιῆς	noun
περσέα	noun
ἔρυσσαν	verb
ἴωνας	noun
ὁμαλός	adjective
ὅρα	verb
ὁρᾷ	verb
πλῆξις	noun
χαλκίς	noun
παλτός	adjective
βασίλειαι	adjective
βασιλεῖαι	noun
ὦπα	noun
δωρίς	noun
οἴκων	noun
βράγχος	noun
βότρυς	noun
ὕδη	noun
ἥμων	noun
ἁφή	noun
ἄχθος	noun
σίνων	noun
ζῴων	noun
ῥώθων	noun
ἀλφάβητον	noun
ἀλφάβητον	noun
ἀλφαβήτου	noun
ἀλφαβήτου	noun
ἀλφαβήτων	noun
ἀλφαβήτων	noun
ἀλφάβητα	noun
ἀλφάβητοι	noun
ἀλφαβήτους	noun
ὕστερα	adjective
ὑπερηφανία	noun
ὑπερήφανος	adjective
ὑπεράφανος	adjective
ἔπ'	preposition
τελευταῖα	adjective
ὑψήνωρ	adjective
ἀπειλή	noun
ἀϊδής	adjective
αἰώρα	noun
εὑ	pronoun
ἔλυμα	noun
μεταμωνία	adjective
μεταμώνια	adjective
ἐρινεός	noun
ἅλμη	noun
ἀτολμοτέρα	adjective
ἀτολμότερα	adjective
ἀκροποσθία	noun
ἔτεϊ	noun
ἄδολος	adjective
καθίστασαν	verb
ὄσιρις	noun
ἄγρυπνος	adjective
ἄδεια	noun
κάρπιον	noun
ὄρουσαν	verb
κέστρος	noun
γνωτόν	adjective
γνωτόν	noun
γνῶτον	verb
ψοιθός	adjective
διαφανῶν	adjective
λάμος	noun
ὅμοιον	adjective
ὁμοῖον	adjective
λάμος	noun
βαγαῖος	adjective
ἀμυδρός	adjective
ἐπανιουσαι	verb
πολεμία	adjective
πολέμια	adjective
ὀξύρρυγχος	adjective
ὀξύρρυγχος	noun
ὑποτελής	adjective
ὑποτελεῖς	adjective
ὑποτελεῖς	verb
ἀποφάσεως	noun
ἀποφάσεως	noun
ἄδουλος	adjective
ἐπιχωρία	adjective
ἐπιχώρια	adjective
ἔπεϊ	noun
ἔπει	noun
ἄκριτος	adjective
λαρινός	adjective
εἴων	verb
ψαλμοί	noun
βέρρης	noun
ὀροφύλαξ	noun
φοῖβος	adjective
δόμοι	noun
δόμῳ	noun
θαύμαζον	verb
καλοῦ	adjective
καλῷ	adjective
ἀλλαγή	noun
κατάλογον	noun
ἴσσα	interjection
ἀδιάβατος	adjective
γνώσει	noun
γνῶσι	noun
ἐφελκύσει	noun
ἐφελκύσι	noun
ἐφέλκυσι	noun
ἐφελκύσεις	noun
ἐφελκύσις	noun
δρίος	noun
ὀσφυαλγία	noun
ἐφιαλτικός	adjective
εἶδες	verb
ἱκεσία	noun
ἀνακτόριον	noun
ὁροφύλαξ	noun
ἔβρος	noun
ἀρχαία	adjective
ἀρχαῖα	adjective
φαρία	noun
ἀκρίβεια	noun
ἀπόλοιτο	verb
ἀπολοῖτο	verb
σπάδων	noun
ἴσως	adverb
αἰθιοπίς	noun
γάλλος	noun
ἕξει	verb
ἕξει	noun
ἔξει	verb
στριφνός	adjective
ἑλένη	noun
σιφνός	adjective
ἱδρύω	verb
ἴω	noun
ἴω	verb
ἔλευσις	noun
ἐλεγειακός	adjective
μοῦστος	noun
ἀποτρέπω	verb
ὁδηγός	noun
ὁδηγοῦ	noun
ὁδηγοί	noun
ὁδηγῷ	noun
ὁδηγόν	noun
ὁδηγῶν	noun
ὁδηγούς	noun
ὁδηγέ	noun
νηάς	noun
βουδόρος	adjective
ἀντίδωρον	noun
σῶς	adjective
κήρινθος	noun
ῥᾴθυμος	adjective
ἄρχοι	verb
ἀρχοί	noun
κύψελος	noun
διαφορᾶς	noun
πῖσος	noun
βώκαρος	noun
συγκλήτῳ	adjective
συγκλήτῳ	noun
σύγκλητον	adjective
σύγκλητον	noun
συγκλήτων	adjective
συγκλήτων	noun
συγκαλέω	verb
συγκαλῶ	verb
συγκαλοῦμαι	verb
συγκλητικοῦ	adjective
συγκλητικοῦ	noun
συγκλητική	adjective
συγκλητικῷ	adjective
συγκλητικῷ	noun
συγκλητικόν	adjective
συγκλητικόν	noun
συγκλητικοί	adjective
συγκλητικοί	noun
συγκλητικέ	adjective
συγκλητικέ	noun
συγκλητικῆς	adjective
συγκλητικῶν	adjective
συγκλητικῶν	noun
συγκλητικοῖς	adjective
συγκλητικοῖς	noun
συγκλητικαί	adjective
συγκλητικαῖς	adjective
συγκλητικῇ	adjective
εἰσπλέω	verb
ῥιπή	noun
