het	verb	hātan
inc	pronoun	ġit
for	verb	faran
his	pronoun	hē
his	pronoun	hit
tide	noun	tīd
bad	verb	bīdan
gripe	verb	grīpan
us	pronoun	wē
we	pronoun	ic
me	pronoun	iċ
him	pronoun	hē
him	pronoun	hit
him	pronoun	hīe
nose	noun	nosu
worden	verb	weorþan
flat	verb	flītan
wand	verb	windan
mot	verb	motan
ge	pronoun	þu
am	verb	wesan
tu	numeral	tweġen
wan	verb	winnan
legen	verb	licgan
rad	verb	ridan
bead	verb	bēodan
wit	pronoun	iċ
dom	verb	dōn
bere	verb	beran
wiccan	noun	wiċċa
wiccan	noun	wiċċe
abad	verb	ābīdan
beo	verb	bēon
muð	noun	mūþ
að	noun	āþ
saga	verb	seċġan
bogan	noun	boga
hwy	pronoun	hwa
hwy	pronoun	hwæt
þe	pronoun	þū
recede	verb	reċċan
hire	pronoun	hēo
rune	noun	run
rune	noun	rūn
slat	verb	slītan
twa	numeral	twēġen
ulan	noun	ūle
wean	noun	wēa
hie	pronoun	hēo
sett	verb	settan
mec	pronoun	iċ
maga	noun	mǣġ
maga	noun	magu
lamp	verb	limpan
min	pronoun	iċ
sind	verb	wesan
wann	verb	winnan
com	verb	cuman
boca	noun	boc
fand	verb	findan
meare	noun	mearh
nat	verb	nytan
ara	noun	ār
nam	verb	niman
mæg	verb	magan
hafa	verb	habban
hatte	verb	hātan
fet	noun	fōt
monaþ	verb	manian
bidon	verb	bīdan
stod	verb	standan
bearn	verb	beirnan
wurde	verb	weorþan
witan	noun	wita
seo	determiner	sē
seo	pronoun	sē
þone	determiner	sē
þone	pronoun	sē
þy	determiner	sē
þy	pronoun	sē
þa	determiner	sē
þa	pronoun	sē
cwene	noun	cwēn
þis	determiner	þēs
þis	pronoun	þēs
þas	determiner	þes
þas	pronoun	þes
unc	pronoun	wit
eow	pronoun	ġē
wod	verb	wadan
moras	noun	mōr
hlið	noun	hliþ
esa	noun	ōs
runa	noun	rūn
wes	verb	wesan
bec	noun	bōc
garas	noun	gār
minum	pronoun	mīn
carles	noun	carl
þrym	noun	þrymm
hine	pronoun	hē
biþ	verb	bēon
byþ	verb	bēon
wong	noun	wang
tunas	noun	tūn
weras	noun	wer
menn	noun	mann
suna	noun	sunu
wenden	verb	wendan
baþu	noun	bæþ
eower	pronoun	ġē
wera	noun	wer
ure	pronoun	wē
stoc	noun	stocc
wiste	verb	witan
wiste	noun	wist
fremede	verb	fremman
taht	verb	tǣċan
bist	verb	bēon
wanga	noun	wang
þin	pronoun	þū
wæg	verb	wegan
feng	verb	fōn
forman	adjective	forma
cy	noun	cū
longe	adverb	lange
neart	verb	nesan
dogga	noun	docga
urum	noun	ūr
enda	noun	ende
gebad	verb	ġebīdan
frean	noun	frēa
gardena	noun	Gārdene
wearþ	verb	weorþan
þah	verb	þēon
þara	determiner	sē
þara	pronoun	sē
wæs	verb	bēon
wæs	verb	wesan
sende	verb	sendan
folce	noun	folc
fyrenþearfe	noun	fyrenþearf
sceal	verb	sculan
cume	verb	cuman
wære	verb	bēon
wære	verb	wesan
brimes	noun	brim
bæd	verb	biddan
ahte	verb	āgan
hyþe	noun	hȳþ
mæste	adjective	mǣst
flodes	noun	flod
lacum	noun	lāc
segen	noun	seġn
hyrde	verb	hȳran
ænne	adjective	ān
yþe	noun	ȳþ
burgum	noun	burh
soþe	noun	sōþ
soþe	adjective	sōþ
læg	verb	liċġan
leas	noun	lēah
sint	verb	wesan
godas	noun	god
bugon	verb	bugan
wordes	noun	word
stunda	noun	stund
holdne	adjective	hold
titta	noun	titt
lafe	noun	lāf
glæde	adjective	glæd
wolde	verb	willan
sangas	noun	sang
magon	verb	magan
wunne	verb	winnan
worð	noun	worþ
eorþ	noun	eorþe
eorð	noun	eorþ
eorðe	noun	eorþe
cotas	noun	cot
eom	verb	wesan
mægþe	noun	mæġþ
mægðe	noun	mæġþe
mægðe	noun	mæġð
sealde	verb	sellan
naman	noun	nama
fyrene	noun	fyren
eorþan	noun	eorþe
folca	noun	folc
wille	verb	willan
sorgum	noun	sorh
dorste	verb	durran (EModE [[durst]])
meares	noun	mearh
mearas	noun	mearh
meara	noun	mearh
sumur	noun	sumor
dala	noun	dæl
dalum	noun	dæl
sanga	noun	sang
bolde	noun	bold
sange	noun	sang
bispel	noun	bīspell
þec	pronoun	þū
wos	noun	wōh
bræð	noun	bræþ
wolcne	noun	wolcen
endes	noun	ende
wrað	adjective	wrāþ
wrað	verb	wrīðan
briddes	noun	bridd
bridde	noun	bridd
swamm	verb	swimman
soð	adjective	sōþ
soð	noun	sōþ
sanges	noun	sang
cann	verb	cunnan
drehtest	verb	dreċċan
drehte	verb	dreċċan
halga	adjective	hāliġ
wange	noun	wang
wæron	verb	bēon
wæron	verb	wesan
bacas	noun	bæċ
mearum	noun	mearh
eart	verb	wesan
ꝥ	pronoun	þæt
sindon	verb	wesan
hwon	adverb	hwā
hwon	adverb	hwæt
eorðan	noun	eorðe
sniðan	verb	snīþan
ðæt	pronoun	þæt
dæla	noun	dǣl
næs	verb	nesan
ægres	noun	ǣġ
ægre	noun	ǣġ
ægra	noun	ǣġ
ægrum	noun	ǣġ
fiscum	noun	fisċ
fisce	noun	fisċ
sunum	noun	sunu
ðurh	preposition	þurh
þys	determiner	þes
þys	pronoun	þes
ceapa	verb	ċēapian
fream	noun	frēa
orðanc	noun	orþanc
orðanc	adjective	orþanc
dalu	noun	dæl
nære	verb	nesan
ricu	noun	rīċe
friest	verb	frēosan
hwæm	pronoun	hwa
hwæm	pronoun	hwæt
stunde	noun	stund
fyrenðearfe	noun	fyrenþearfe
wæren	verb	bēon
wæren	verb	wesan
sumer	noun	sumor
morað	noun	mōraþ
dæle	noun	dǣl
dæle	noun	dæl
þam	determiner	sē
þam	pronoun	sē
berie	noun	berġe
clawe	noun	clawu
monað	noun	mōnaþ
swince	verb	swincan
susle	noun	susl
susla	noun	susl
wolcnu	noun	wolcen
barum	adjective	bær
næren	verb	nesan
bodum	noun	boda
sece	verb	secan
drana	noun	drān
drane	noun	drān
byrg	noun	burg
