portmanteau	pɔːɹtˈmæntoʊ
gratis	ˈɡɹætɪs
pond	pɑnd
crow	kɹoʊ
december	dɪ.ˈsɛm.bəɹ
february	ˈfɛb.ɹuˌɛɹi
march	mɑɹtʃ
april	ˈeɪ.pɹəl
september	sɛpˈtɛmbəɹ
october	ɑkˈtoʊbəɹ
november	noʊˈvɛmbəɹ
tuesday	ˈt(j)uzdeɪ
minute	maɪˈn(j)ut
barter	ˈbɑɹtɚ
quid pro quo	ˌkwɪd.pɹoʊˈkwoʊ
verb	vɝb
craft	kɹæft
substantive	ˈsʌbstəntɪv
sesquipedalianism	ˌsɛskwəpəˈdeɪli.ənɪzm̩
a-	ə
aam	ɑm
aardvark	ˈɑɹd.vɑɹk
abatvoix	ɑ.ˌbɑv.ˈwɑ
abbacy	ˈæb.ə.si
abderian	æbˈdɪɹ.i.ən
abderite	ˈæb.dəˌɹaɪt
abdicable	ˈæb.də.kə.bəl
abditory	ˈæb.dɪt.ɹi
abdomen	ˈæb.də.mən
abdominoscopy	æbˌdɑm.ɪnˈɑs.kə.pi
abdominothoracic	æbˌdɑm.ɪ.noʊ.θɔɹˈæs.ɪk
abdominous	æbˈdɑm.ə.nəs
abduct	æbˈdʌkt
abear	ə.ˈbɛɚ
abearance	əˈbɜɹ.əns
abearing	əˈbɛɹ.ɪŋ
abecedarian	ˌeɪ.biˌsiˈdɛ.ɹi.ən
abecedary	ˌeɪ.bi.ˈsi.dɚ.i
abed	əˈbɛd
abele	əˈbil
abelian	əˈbi.li.ən
abelmosk	ˈeɪbəlˌmɑsk
aberr	əˈbɝ
aberration	ˌæb.əˈɹeɪ.ʃn̩
aberrational	ˌæb.əˈɹeɪ.ʃən.l̩
abetment	əˈbɛt.mənt
abettal	əˈbɛt.l̩
abetter	əˈbɛt.ɚ
abevacuation	æb.iˌvæk.juˈeɪ.ʃn̩
abeyancy	əˈbeɪ.ənt.si
abhor	æbˈhɔɹ
abhorrence	əbˈhɔɹ.n̩s
abhorrently	æbˈhɔɹ.ənt.li
abhorrible	æbˈhɑ.ɹɪb.l̩
abhorring	æbˈhɔɹ.ɪŋ
abib	ɑˈviv
abidance	əˈbaɪd.n̩s
abider	əˈbɑɪ.dɚ
abiding	əˈbaɪ.dɪŋ
abidingly	əˈbaɪ.dɪŋ.li
abietene	ˈæb.i.əˌtin
abietic	ˌæb.iˈɛt.ɪk
abigail	ˈa.bɪ.ɡeɪl
ability	əˈbɪl.ə.ti
abiogenetic	ˌeɪ.bai.oʊ.dʒɛˈnət.ɪk
abiogenist	ˌeɪ.baiˈɑ.dʒɛ.nəst
abiogenous	æb.iˈɑd͡ʒ.ə.nəs
abiological	ˌeɪ.baɪ.əˈlɑdʒ.ɪ.kl̩
abirritant	æbˈɪɹ.ɪ.tn̩t
abirritate	æbˈɪɹ.ɪˌteɪt
abirritation	ˌæb.ɪɹ.ɪˈteɪ.ʃn̩
abirritative	ˌæb.ɪɹ.ɪˈteɪ.tɪv
abjectedness	ˌæbˈd͡ʒɛkt.əd.nəs
abjectness	æbˈd͡ʒɛkt.nəs
abjudge	ˈæbˌd͡ʒəd͡ʒ
abjuratory	æbˈd͡ʒʊɹ.əˌtɔɹ.i
abjure	æbˈdʒʊɹ
ablastemic	ˈeɪ.blæˌsti.mɪk
ablative	ˈæb.lə.tɪv
ablaut	ˈɑbˌlaʊt
ablaze	əˈbleɪz
able	ˈeɪ.bl̩
able-bodied	ˈei.bl̩ˌbɑ.did
ableness	ˈeɪ.bl̩.nəs
abler	eɪ.blɚ
ablins	ˈeɪ.blɪnz
abloom	əˈbluːm
ablush	əˈblʌʃ
ablutionary	əˈblu.ʃəˌnɛ.ɹi
ably	ˈeɪ.bli
abnegation	ˌæbnɪˈɡeɪʃən
abnet	ˈæb.nət
abnormality	ˌæbˌnɔɹˈmæl.ət.i
abnormally	æbˈnɔɹ.mə.li
abnormity	æbˈnɔɹ.mɪ.ti
abnormous	ˈæbˌnɔɹ.məs
aboard	əˈbɔɹd
abode	əˈboʊd
abodement	əˈboʊd.mn̩t
aboding	əˈboʊ.dɪŋ
abolish	əˈbɑl.ɪʃ
abolishable	əˈbɑl.ɪʃ.ə.bl̩
abolisher	əˈbɑl.ɪʃ.ɚ
abolishment	əˈbɑl.ɪʃ.mənt
abolitionism	ˌæb.əˈlɪʃ.əˌnɪz.m̩
abolitionist	ˌæ.bə.ˈlɪʃ.n̩.ɪst
abolitionize	ˌæb.əˈlɪʃ.n̩ˌaɪz
abominableness	əˈbɑm.ə.nə.bl̩.nəs
abominably	əˈbɑm.ə.nə.bli
abord	əˈbɔɹd
aboriginal	ˌæb.əˈɹɪd͡ʒ.n̩.l̩
aboriginality	æb.əˌɹɪd͡ʒ.əˈnæl.ə.ti
aboriginally	ˌæb.əˌɹɪd͡ʒ.n̩.ə.li
abort	əˈbɔɹt
aborticide	əˈbɔɹ.tɪˌsaɪd
abortifacient	əˌbɔɹ.təˈfeɪ.ʃn̩t
abortion	əˈbɔɹ.ʃn̩
abortional	əˈbɔɹ.ʃn̩.l̩
abortionist	əˈbɔɹ.ʃə.nɪst
abortively	əˈbɔɹ.tɪv.li
abortiveness	əˈbɔɹ.tɪv.nəs
abought	əˈbɔt
abound	əˈbaʊnd
above-cited	əˈbʌvˌsaɪt.əd
above-mentioned	əˈbʌvˌmɛnʃn̩d
abox	əˈbɑks
abracadabra	ˌæ.bɹə.kəˈdæ.bɹə
abrahamic	eɪ.bɹəˈhæm.ɪk
abraham man	ˈeɪ.bɹəˌhæm mæn
abranchial	eɪˈbɹæŋ.ki.l̩
abranchiata	eɪˈbɹæŋ.kiˌɑ.tə
abranchiate	eɪˈbɹæŋ.ki.ɪt
abrase	əˈbɹeɪz
abrasion	əˈbɹeɪ.ʒn̩
abraum	ˈɑˌpɹaʊm
abraxas	əˈbɹæk.səs
abrenounce	ˌæb.ɹiˈnaʊnts
abrenunciation	ˌæb.ɹi.nʌn.siˈeɪ.ʃn̩
abridge	əˈbɹɪd͡ʒ
abridger	əˈbɹɪ.d͡ʒɚ
abridgment	əˈbɹɪd͡ʒ.mn̩t
abroach	əˈbɹoʊt͡ʃ
abroad	əˈbɹɔd
abrood	əˈbɹud
abrook	əˈbɹʊk
abruption	əˈbɹʌp.ʃn̩
abruptly	əˈbɹʌp.li
abruptness	əˈbɹʌp.nəs
abscind	əbˈsɪnd
abscision	æbˈsɪ.ʒn̩
absciss	ˈæb.sɪs
absciss	æbˈsɪs
abscondence	æbz.ˈkɑn.dn̩ts
odd	ɑd
nu	nu
winter	[ˈwɪntʰɚ]
mouse potato	maʊs pəʊ.teɪ.təʊ
robot	ˈɹoʊbɑt
english	ˈɪŋɡlɪʃ
absentation	ˌæb.sənˈteɪ.ʃn̩
absentee	ˌæb.sn̩ˈti
absenteeism	ˌæb.sənˈtiˌɪz.m̩
absently	ˈæb.sn̩t.li
absent-minded	ˌæb.sn̩tˈmaɪn.dɪd
absentness	ˈæb.sn̩t.nəs
absinth	ˈæb.sɪnθ
absinthin	ˈæbˌsɪn.θɪn
absinthism	ˈæb.sənˌθɪz.m̩
absinthium	æbˈsɪn.θi.m̩
absolutely	ˌæb.səˈlut.li
absoluteness	ˈæb.səˌlut.nəs
absolution	ˌæb.səˈl(j)u.ʃn̩
absolutistic	ˈæb.səˌluˌtɪs.tɪk
absolutory	æbˈsɑl.jəˌtɔɹ.i
absolvable	æbˈzɑlv.ə.bl̩
absolve	æbˈzɑlv
absolvent	æbˈzɑlv.n̩t
absonous	ˈæb.sə.nəs
absorbability	əbˌsɔɹb.əˈbɪl.ɪ.ti
absorbedly	æbˈsɔɹb.ɪd.li
absorber	əbˈsɔɹ.bɚ
absorbing	æbˈzɔɹ.bɪŋ
absorpt	æbˈsɔɹpt
absorptivity	æbˌsɔɹpˈtɪvə.ti
abstainer	æbˈsteɪ.nɚ
abstentious	æbˈstɛn.ʃəs
absterge	æbˈstɝd͡ʒ
abstersion	æbˈstɝ.ʒn̩
abstersiveness	æbˈstɝ.sɪv.nəs
abstinent	ˈæb.stɪ.nn̩t
abstinent	ˈæb.stə.nn̩t
abstinently	ˈæb.stɪ.nn̩t.li
abstinently	ˈæb.stə.nn̩t.li
abstracted	əb.ˈstɹæk.tɪd
abstractedly	əbˈstɹæk.tɪd.li
abstractedly	æbˈstɹæk.tɪd.li
abstractedness	æbˈstɹæk.tɪd.nəs
abstracter	æbˈstɹkæ.tɚ
abstractional	æbˈstɹæk.ʃnl̩
abstractionist	æbˈstɹæk.ʃən.əst
abstractively	æbˈstɹæk.tɪv.li
abstractiveness	æbˈstɹæk.tɪv.nəs
abstractness	æbˈstɹæk.nəs
abstrusely	æbˈstɹus.li
abstruseness	æbˈstɹus.nəs
abstrusity	æbˈstɹu.sə.ti
absurdity	æbˈsɝd.ɪ.ti
absurdly	æbˈsɝd.li
absurdness	æbˈsɝd.nəs
abundantly	əˈbʌn.dn̩t.li
aburst	əˈbɝst
abusable	əˈbju.zə.bl̩
abusively	əˈbju.sɪv.li
abusiveness	əˈbju.sɪv.nəs
abuttal	əˈbʌt.l̩
abutter	əˈbʌ.tɚ
abysmally	əˈbɪz.ml̩.i
abyssinian	ˌæb.ɪˈsɪn.i.ən
academian	ˌæk.əˈdi.mi.n̩
academically	ˌæk.əˈdɛm.ɪk.ə.li
academicism	ˌæk.əˈdɛm.əˌsɪz.m̩
academism	əˈkæd.əˌmɪz.əm
academist	əˈkæd.ɪ.mɪst
acadian	əˈkeɪ.di.n̩
acaleph	ˌæk.əˈlɜf
acalycine	ˌeiˈkeɪ.lə.saɪn
acanthaceous	ˌæk.n̩ˈθeɪ.ʃəs
acanthopterygian	ˌæk.ænˌθɑp.təˈɹɪdʒ.i.n̩
acapsular	ˌeɪˈkæp.sə.lɚ
acaroid	ˈæk.ə.ˌɹɔɪd
acceptability	ˌæk.ˌsɛp.tə.ˈbɪl.ət.i
acceptableness	æk.ˈsɛp.tə.bəl.nəs
acceptably	æk.ˈsɛp.tə.bli
acceptive	æk.ˈsɛp.tɪv
accessibility	ækˌsɛs.əˈbɪl.ət.i
accessibly	æk.ˈsɛs.ə.bli
accessional	æk.ˈsɛʃ.nəl
accessorial	æk.sə.ˈsoɹ.i.əl
accipiter	æk.ˈsɪp.ə.tɚ
acclimate	ˈæk.lɪ.meɪt
according	ə.ˈkɔɹd.ɪŋ
accordingly	ə.ˈkɔɹ.dɪŋ.li
accordion	ə.ˈkɔɹ.di.ən
accountableness	ə.ˈkaʊn.tə.bəl.nəs
accountantship	ə.ˈkaʊnt.ənt.ˌʃɪp
accumulative	ə.ˈkjum.jə.ˌleɪ.tɪv
accurately	ˈæk.jə.ɹɪt.li
outer space	ˌaʊtɚ ˈspeɪs
avatar	ˈæv.ə.tɑɹ
autumn	ˈɔtəm
polish	ˈpoʊlɪʃ
premature	ˌpɹi.məˈtʊɹ
star	stɑɹ
obfuscate	ˈɑːbfʌskeɪt
o	oʊ
zero	ˈzɪɹ(ˌ)oʊ
oxymoron	ˌɑksiˈmɔɹɑn
parole	[pə.ˈɹoʊɫ]
mexico	ˈmɛk.sɪ.koʊ
dotcom	ˌdɑtˈkɑm
dotcom	ˈdɑtˌkɑm
one	wʌn
two	tu
few	fju
beer	bɪɹ
pseudo	ˈsuːdoʊ
steganography	ˌstɛ.ɡʌnˈɔ.ɡɹʌ.fi
mondegreen	ˈmɑndəɡɹiːn
resile	ɹəˈzaɪl
cod	kɑd
accordionist	ə.ˈkɔɹd.i.ə.nəst
lol	ˌɛl.ˌoʊ.ˈɛl
bot	bɑt
adverb	ˈæd.vɝb
because	biˈkɔz
grok	ˈɡɹɑk
everybody	ˈɛvɹibʌdi
brassiere	bɹəˈzɪɹ
stock	stɑk
nato	ˈneɪ.toʊ
music	ˈmjuzɪk
euro	ˈjʊɹoʊ
perfunctory	pɚˈfʌŋk.tɚ.i
iraq	ɪˈɹæk
eurovision	ˈjɝ.əˌvɪ.ʒ(ə)n
meticulous	mɨˈtɪkjɨlɨs
germany	ˈd͡ʒɝ.mə.ni
france	fɹæns
european	ˌjʊɹəˈpi.ən
estonia	ɛsˈtoʊ.ni.ə
norway	ˈnɔɹ.weɪ
poland	ˈpoʊ.lənd
solomon islands	ˈsɑ.lə.mən ˈaɪ.ləndz
urban	ˈɝbən
slow	sloʊ
policy	ˈpɑləsi
gratuitous	ɡɹəˈtu.ɪt.əs
vapourware	ˈveɪpɚwɛɹ
aborigine	ˌæb.əˈɹɪdʒ.ə.ni
market	ˈmɑɹkɪt
meeting	ˈmitɪŋ
aliveness	əˈlaɪvnəs
also	ˈɔl.soʊ
acacia	əˈkeɪ.ʃə
network	nɛtwɝk
mobile	ˈmoʊbəl
mobile	ˈmoʊbil
mobile	ˈmoʊbəl
careful	ˈkɛ(ə)ɹfəl
andorra	ænˈdɔɹ.ə
antigua and barbuda	ænˌti.ɡ(w)ə ænd bɑɹˈbju.də
armenia	ɑɹˈmi.ni.ə
angola	æŋˈɡoʊlə
argentina	ˌɑɹ.d͡ʒən.ˈti.nə
bulgaria	bʌlˈɡɛɹ.i.ə
bolivia	boʊ.ˈlɪv.i.ə
botswana	bɑːtˈswɑːnə
switzerland	ˈswɪt.sɚ.lənd
chile	ˈt͡ʃiː.leɪ
dominican republic	doʊˌmɪn.ɪ.kən ɹəˈpʌb.lɪk
pseudonym	ˈsudoʊnɪm
ecuador	ˈɛk.wə.dɔɹ
ghana	ˈɡɑnə
honduras	hɑnˈdʊɹ.əs
iran	ɪˈɹɑːn
italy	ˈɪtəli
colon	ˈkoʊ.lən
colon	ˈkoʊlən
colon	kəˈloʊn
liberia	laɪˈbɪɹi.ə
monaco	ˈmɑ.nə.koʊ
madagascar	mædəˈɡæskɑɹ
marshall islands	ˈmɑɹ.ʃəl ˈaɪ.ləndz
mongolia	mɑːŋˈɡoʊli.ə
mauritania	ˌmɔːɹɪˈteɪni.ə
malta	ˈmɑl.tə
malawi	məˈlɑːwi
nicaragua	ˌnɪk.əˈɹɑ.ɡwə
proprietary	pɹəˈpɹaɪ.ə.tɛ.ɹi
oman	oʊˈmæn
french polynesia	ˈfɹɛntʃ pɑ.lɪˈni.ʒə
papua new guinea	ˈpæp.u.ə ˌnu ˈɡɪn.i
paraguay	ˈpɛɹ.ə.ɡweɪ
qatar	ˈkæˌtɑɹ
romania	ɹoʊˈmeɪ.ni.ə
sudan	suˈdæn
slovenia	sloʊˈvi.ni.ə
slovakia	sloʊˈvɑ.ki.ə
san marino	ˌsæn məˈɹi.noʊ
tonga	ˈtɑŋ.ɡə
trinidad and tobago	ˌtɹɪn.ɪ.dæd ænd toʊˈbeɪ.ɡoʊ
ukraine	juˈkɹeɪn
vietnam	(ˈ)vjɛtˈnɑm
automatic	ˌɔtəˈmætɪk
computer	kəmˈpjutɚ
amigo	əˈmiɡoʊ
absorbency	æb.sɔɹ.bn̩.si
absolute	ˈæb.səˌlut
absorption	æbˈsɔɹp.ʃn̩
abstract	ˌæbˈstɹækt
abstractionism	æbˈstɹæk.ʃn̩ˌɪz.m̩
absurd	æbˈsɝd
abutment	əˈbʌt.mn̩t
abyss	əˈbɪs
abysm	əˈbɪz.m̩
acanthus	əˈkæn.θəs
acclaim	ə.ˈkleɪm
accomplice	ə.ˈkɑm.pləs
acclimatization	ə.ˌklaɪ.mə.tə.ˈzeɪ.ʃən
bio	ˈbaɪoʊ
ufo	ˌjuˌɛfˈoʊ
accountability	ə.ˌkaʊn.tə.ˈbɪl.ət.i
accountancy	ə.ˈkaʊnt.ən.si
accredit	ə.ˈkɹɛd.ɪt
accreditation	[əˌkɹɛd.ɨˈteɪ.ʃən]
accretion	ə.ˈkɹi.ʃən
accuracy	ˈæk.jɚ.ə.si
accuse	əˈkjuz
barbados	bɑɹˈbeɪ.doʊs
burkina faso	bəɹˈkiːnə ˈfɑsoʊ
benin	bəˈnin
belarus	ˌbɛləˈɹus
tuvalu	tuːˈvɑː.luː
burp	bɝp
acerbity	əˈsɝbɪdi
accomplishable	ə.ˈkɒm.plɪʃ.ə.bəl
general	ˈd͡ʒɛnəɹəl
choir	kwaɪɚ
storm	stɔɹm
genome	ˈdʒiː.noʊm
money	ˈmʌni
jupiter	ˈdʒupɪtɚ
brotus	ˈbɹoʊ.təs
stylized	ˈstaɪl.aɪzd
croatia	ˌkɹoʊˈeɪ.ʃə
dominica	ˌdɑ.mɪ.ˈniː.kə
eritrea	ˌɛɹɪˈtɹi.ə
fiji	ˈfi.dʒi
moldova	mɔlˈdoʊ.və
puerto rico	ˌpɔɹtəˈɹikoʊ
new caledonia	ˈnu ˌkæl.ɪˈdoʊ.ni.ə
samoa	səˈmoʊ.ə
american samoa	əˈmɛɹ.ɪ.kən səˈmoʊ.ə
micronesia	ˌmaɪ.kɹoʊˈniː.ʒə
guam	ɡwɑm
norfolk island	ˈnɔɹ.fɔk ˈaɪ.lənd
abominable snowman	əˈbɑm.ə.nə.bl̩ ˈsnoʊ.mæn
yeti	ˈjɛ.ti
macedonia	ˌmæs.əˈdoʊ.ni.ə
security	səˈkjɔɹ.ɪˌti
o'clock	əˈklɑk
abscissin	ˈæb.sə.sən
absinthe	ˈæb.sɪnθ
bomb	bɑm
smalls	smɔlz
tomato	[tʰə̥ˈmɑɾoʊ]
solar system	ˈsoʊ.lɚ ˌsɪs.təm
academician	ˌæ.kə.dəˈmɪʃ.n̩
gold	ɡoʊld
third	θɝd
chinese	ˌt͡ʃaɪˈniz
chinese	ˈt͡ʃaɪˌniz
tuba	ˈtu.bə
yours	jɔːɹz
your	jɔːɹ
copacetic	ˌkoʊ.pəˈsɛt.ɪk
wrought	ɹɔt
written	ˈɹɪtn̩
wound	wund
edible	ˈɛdəbəl
throne	[θɹoʊn]
mouse	maʊs
mouse	maʊs
router	ˈɹuːtə(ɹ)
router	ˈɹaʊtɚ
router	ˈɹaʊtɚ
keyboard	ˈkibɔɹd
dual	ˈd(j)uː.əl
weekend	ˈwiˌkɛnd
aloha	əˈloʊˌhɑ
turkish	ˈtɝ.kɪʃ
turkish	[ˈtɚ.kɪʃ]
of	ʌv
of	ʌv
or	ɔɹ
or	ɚ
fourteen	ˈfɔɹt.tin
fourteen	ˌfɔɹtˈtin
cube	kjub
eleventh	iˈlɛv.ənθ
fourteenth	ˌfɔɹˈtiːnθ
perpendicular	pɝ.pɛnˈdɪk.ju.lɚ
triangle	ˈtɹaɪˌæŋɡəl
polygon	ˈpɑliɡɑn
square	skwɛɚ
quine	kwaɪn
hemisphere	ˈhɛmɪsfɪəɹ
quaff	kwɑf
seventy	ˈsɛv.ən.di
eighty	[ˈ(ʔ)eɪ̯ɾi]
thousand	ˈθaʊz(ə)nd
sol	soʊl
perspicuity	ˌpɚspəˈkjuəti
hydraulic	haɪˈdɹɔːlɪk
zeal	zil
deuce	duːs
currency	ˈkʌɹ.ən.si
blowjob	ˈbloʊdʒɑb
cock	kɑk
percent	pɚˈsɛnt
too	tu
toe	toʊ
unicode	ˈjunɪˌkoʊd
raccoon	ɹæˈkun
epitaph	[ˈɛpɪtæf]
anarchy	ˈæn.ɑɹ.ki
llama	ˈlɑmə
llama	ˈjɑmə
yacht	jɑt
x-ray	ˈɛks ˌɹeɪ
to	tu
to	tə
ate	eɪt
example	ɪɡˈzæmpl̩
her	ˈhɝ
her	ɚ
their	ðɛɚ
concrete	ˌkɑnˈkɹiːt
imperative	ɪmˈpɛɹ.ə.tɪv
copula	ˈkɑpjələ
superlative	suˈpɝː.lə.tɪv
neuter	ˈn(j)uːtɚ
regular	ˈɹɛɡjəlɚ
aussie	ˈɔzi
quarrel	ˈkwɔɹəl
montreal	ˌmɑntɹiˈɔl
almost	ˈɔl.moʊst
any	ˈɛni
approval	əˈpɹuvəl
arm	ɑɹm
art	ɑɹt
a la	ɑ lɑ
accident	ˈæk.sə.dənt
advice	ædˈvaɪs
korea	kəˈɹi.ə
boom	bum
earth	ɝθ
ordinate	ˈɔːɹ.dənɪt
was	wʌz
beeswax	ˈbizwæks
brother	ˈbɹʌðɚ
mother-in-law	ˈmʌ.ðəɹ.ɪnˌlɑː
car	kɑɹ
warm	wɔɹm
lukewarm	ˌlukˈwɔɹm
xerox	ˈziː(ə)ɹ.ɑks
flower	ˈfloʊɚ
norwegian	nɔɹ.ˈwiː.dʒən
hers	ˈhɝz
hers	ɚz
theirs	ðɛɚz
hole	hoʊl
experiment	ɪk.ˈspɛɹ.ə.mənt
azure	ˈæʒɚ
chartreuse	[ʃɑɹˈtɹuːz]
mortgage	ˈmɔɹ.ɡɪdʒ
bombard	ˌbɑmˈbɑɹd
bombard	ˈbɑmˌbɑɹd
finale	fɨˈnɑli
candidate	ˈkæn.dɪ.deɪt
atmosphere	ˈætməsˌfɪɹ
indigo	ˈɪndɪˌɡoʊ
turtle	ˈtɝtəl
bronze	bɹɑnz
unutterable	ˌʌnˈʌtɚəbl̩
backbone	ˈbækˌboʊn
hobby	ˈhɑ.bi
orchid	ˈɔɹ.kɪd
olive	ˈɑlɪv
copper	ˈkɑ.pɚ
ochre	ˈoʊkɚ
rose	ɹoʊz
turquoise	ˈtɚ.k(w)ɔɪz
however	haʊˈɛvɚ
helicopter	ˈhɛlɨˌkɑptɚ
hello	hɛˈloʊ
primrose	ˈpɹɪm.ɹoʊz
amber	ˈæm.bɚ
city	ˈsɪɾi
clergy	ˈklɝdʒi
minister	ˈmɪnɨstɚ
mustard	[ˈmʌs.tɚd]
strawberry	ˈstʃɹɔˌbɛɹi
diesel	ˈdisəl
fascist	ˈfæʃɪst
cinnamon	ˈsɪn.ə.mən
epilogue	ˈɛpɪlɔɡ
auburn	ˈɔ.bɚn
sapphire	ˈsæf.aɪ̯ɚ
hamster	ˈhæm(p)stɚ
overweight	ˌoʊvɚˈweɪt
overweight	ˈoʊvɚweɪt
stamina	ˈstæmənə
luck	lʌk
melancholy	ˈmɛl.ənˌkɑl.i
handmaid	ˈhændˌmeɪd
proverb	ˈpɹɑːvɝːb
able-bodiedness	ˈei.bl̩ˌbɑ.did.nəs
pronoun	ˈpɹoʊ.naʊn
soak	soʊk
so	soʊ
talk	tɔk
song	sɔŋ
bran	ˈbɹæn
la	[ˌɛɫ ˈlej]
positron	ˈpɑ.zɪ.tɹɑn
-able	ə.bl̩
vers	vɝs
vert	vɝt
oral	ˈɔɹəl
graffiti	ɡɹəˈfiti
us	əs
us	əs
gracias	ˈɡɹɑ.si.əs
cadre	ˈkɑ.dɹeɪ
he	hi
she	ʃi
me	mi
taiwanese	ˌtaɪwɑˈniːz
ear	ɪɹ
knee	ni
canary	kəˈnɛəɹi
mongrel	ˈmɑŋ.ɡɹəl
molar	ˈmoʊlɚ
accurateness	ˈæk.jə.ɹət.nəs
unmask	ʌnˈmæsk
roach	ɹoʊtʃ
matador	ˈmætədɔɹ
do	doʊ
bulgarian	bʌlˈɡɛɹi.ən
arabic	ˈæɹəbɪk
penang	pəˈnɑŋ
british	[ˈbɹɪɾ.ɪʃ]
surfeit	ˈsɝː.fɪt
although	ɔlˈðoʊ
alas	əˈlæs
mass	mæs
law	lɔ
liberal	ˈlɪbəɹəl
accordance	əˈkɔɹ.dəns
eventually	ɪ.ˈvɛn.t͡ʃu.ə.li
palm	pɑm
aforementioned	əˈfɔɹˌmɛn.ʃənd
against	əˈɡɛnst
accused	ə.ˈkjuzd
vocal	ˈvoʊ.kəl
galaxy	ˈɡæləksi
gumdrop	ˈɡʌm.dɹɑːp
hither	ˈhɪðɚ
hitherto	ˈhɪðɚˌtu
raspberry	ˈɹæzˌbɛɹi
jerk	d͡ʒɝk
citizen	ˈsɪtɪzən
human	ˈ(h)ju.mən
eyesore	ˈaɪsɔɹ
were	wɝ
were	wɚ
become	bəˈkʌm
befall	bɪˈfɔl
befall	bɪˈfɑl
lrrp	lɝp
blown	bloʊn
brought	bɹɔt
burnt	ˈbɜɹnt
caught	[kʰɔt]
caught	[kʰɑt]
caught	[kʰɒt]
chose	tʃoʊz
chosen	ˈtʃoʊ.zən
icon	ˈaɪ.kɑːn
come	kʌm
dove	doʊv
done	dʌn
fought	fɔt
flown	ˈfloʊn
foresee	fɔɹˈsi
foresaw	fɔɹ.ˈsɔ
foretell	[fɔɹ.ˈtɛɫ]
foretold	ˈfɔɹ.toʊld
grow	ɡɹoʊ
pigeon	ˈpɪ.dʒən
learned	ˈlɝnɪd
learned	lɝnd
participle	ˈpɑɹtɪˌsɪpəl
lost	lɔst
archaic	ɑɹ.ˈkeɪ.ɪk
cliché	kliːˈʃeɪ
rod	ɹɑd
legal	ˈliɡəl
lingo	ˈliŋ.ɡoʊ
internal	ɪnˈtɝnəl
rhetorical	ɹɪˈtɔɹɪkəl
skirt	skɝt
e.g.	ˌiˈdʒi
zenith	ˈzi.nɪθ
mow	moʊ
mow	moʊ
goiter	ˈɡɔɪtɚ
outdo	aʊtˈdu
outgrow	ˌɑʊtˈɡɹoʊ
overcome	ˌoʊvəɹˈkʌm
overcame	ˌoʊvəɹˈkeɪm
overdo	ˌoʊ.vəɹˈdu
verbal	ˈvɝ.bəl
metaphor	ˈmɛt.ə.fɔɹ
scissors	ˈsɪzɚz
circle	[ˈsɝ.kəɫ]
card	kɑɹd
complex	kəmˈplɛks
complex	ˈkɑmplɛks
overdrew	oʊ.vɚ.dɹu
overeat	ˌoʊvɚˈit
overeaten	oʊ.vɚ.it.ən
overhang	ˈoʊvəɹˌhæŋ
overhear	oʊ.vɚˈhɪɚ
overheard	oʊ.vɚ.hɝd
overlaid	oʊ.vɚ.leɪd
overlain	oʊ.vɚ.leɪn
overpay	oʊ.vɚ.peɪ
overpaid	oʊ.vɚ.peɪd
override	oʊ.vəɹˈɹaɪd
override	ˈoʊ.vəɹˌɹaɪd
overrun	oʊvəˈɹʌn
overrun	ˈoʊvəˌɹʌn
overran	oʊ.vɚ.ɹan
oversaw	oʊ.vɚ.sɔ
overseen	oʊ.vɚ.sin
oversell	oʊ.vɚ.sɛl
overshoot	ˈoʊ.vɚˌshut
overshoot	ˌoʊ.vɚˈshut
overshot	ˈoʊ.vɚˌʃɑt
overslept	oʊ.vɚ.slɛpt
overtook	oʊ.vɚ.tʊk
overthrew	oʊ.vɚ.θɹu
overthrown	oʊ.vɚ.θɹoʊn
proven	ˈpɹuvən
rebound	ˈɹibaʊnd
democracy	dɪˈmɑkɹəsi
re-lay	ˌɹiˈleɪ
rewound	ɹi.waʊnd
rewrite	ˈɹi.ɹaɪt
rewrite	ɹiˈɹaɪt
rewrote	ɹi.ɹoʊt
rode	ˈɹoʊd
parasol	ˈpɛɹəˌsɑl
saw	sɔ
sought	sɔt
sewed	ˈsəʊd
shear	ʃiɹ
sheared	ˈʃiɹd
anomaly	əˈnɑməli
arid	ˈæ.ɹɪd
arid	ˈɛə.ɹɪd
circuitous	sɚˈkjuːətəs
engender	ɛnˈdʒɛn.dɚ
gregarious	ɡɹɨˈɡɛɹ.i.əs
ponderous	ˈpɑn.dɚ.əs
repeal	ɹəˈpiːl
spurious	ˈspjʊ.ɹi.əs
brusque	bɹʌsk
carp	ˈkɑɹp
curtail	kɚˈteɪl
dogged	dɔɡd
dogged	ˈdɔɡɪd
showed	ˈʃoʊd
shown	ˈʃoʊn
spoken	ˈspoʊkən
sprung	ˈspɹʌŋ
strewn	ˈstɹun
swear	swɛɚ
taught	tɔt
thought	θɔt
throw	θɹoʊ
won	wɑn
era	ˈɛɹ.ə
limo	ˈlɪ.moʊ
diphthong	ˈdɪfθɔŋ
comb	koʊm
committee	[kɑmɪˈtiː]
skylark	ˈskaɪ.lɑɹk
mallard	ˈmælɚd
international phonetic alphabet	ˌɪntɚˈnæʃ(ə)n(ə)l fəˈnɛtɪk ˈælfəˌbɛt
collar	ˈkɑ.lɚ
cuckoo	ˈkuː.kuː
applaud	əˈplɔd
bacteria	bækˈtɪɹ.i.ə
drawl	dɹɔl
acotyledon	ˈeɪ.kɔt.l̩.iːdˌn̩
drawer	dɹɔɹ
drawer	ˈdɹɔ.ɚ
violin	ˌvaɪəˈlɪn
bankrupt	ˈbæŋk.ɹəpt
penis	ˈpinɪs
falcon	ˈfælkən
falcon	ˈfɑːlkən
rooster	ˈɹustəɹ
swallow	ˈswɑloʊ
common gull	ˈkɑːmən ˌɡʌl
sparrow	ˈspæɹoʊ
authority	əˈθɔɹəti
partridge	ˈpɑɹtɹɪd͡ʒ
woodpecker	ˈwʊdˌpɛkɚ
green woodpecker	ɡɹinˈwʊdpɛkə(ɹ)
turtle dove	ˈtɝtəldʌv
blackbird	ˈblækˌbɚd
buffalo	ˈbʌf.ə.loʊ
otter	ˈɑtɚ
marten	ˈmɑɹ.tən
wild boar	ˈwaɪld ˈboɹ
mole	mol
mole	mol
mole	mol
mole	mol
laser	ˈleɪzɚ
modem	ˈmoʊdəm
occitan	ˈɑksɪˌtæn
goggles	ˈɡɑ.ɡəlz
rom	ɹoʊm
logic	ˈlɑdʒɪk
expletive	ˈɛksplətɪv
true	tɹu
low	loʊ
low	loʊ
low	loʊ
low	loʊ
tall	tɔl
shallow	ˈʃæl.oʊ
high	haɪ
metal	[ˈmɛ.ɾɫ̩]
salt	sɔlt
near	nɪɹ
old	ˈoʊld
vomit	ˈvɑmɪt
pull	[pʰʊːɫ]
fog	fɑɡ
smoke	smoʊk
everyone	ˈɛv.ɹi.wʌn
none	noʊn
somebody	ˈsʌmbʌdi
nobody	ˈnoʊ.bə.di
many	ˈmɛni
snow	snoʊ
ice floe	ˈaɪs.floʊ
castling	ˈkæstlɪŋ
castling	ˈkæsəlɪŋ
apostrophe	əˈpɑːs.tɹə.fi
courage	ˈkʌɹɪdʒ
energy	ˈɛnɚd͡ʒi
europe	ˈjʊɹəp
malleable	ˈmæli.əbəl
artery	ˈɑɹ.təɹɪ
princess	ˈpɹɪnsɛs
duke	d(j)uːk
earl	ɝl
organism	ˈɔɹ.ɡən.ɪ.zəm
monarch	ˈmɑnɚk
analog	ˈæ.nə.lɔɡ
antarctica	ænˈtɑɹ(k)tɪkə
dictatorship	ˈdɪkteɪtəɹʃɪp
totalitarian	ˌtoʊtəlɪˈtɛəɹiən
communist	ˈkɑː.m.jə.nɪst
daimyo	ˈdaɪ.mjoʊ
katana	kəˈtɑnə
longsword	ˈlɑŋsɔɚd
tanto	ˈtɑntoʊ
u	ʌ
z	ziː
klingon	ˈklɪŋɑn
de facto	ˌdeɪˈfæktoʊ
romaji	ˈɹoʊmədʒi
throttle	ˈθɹatəl
shock	ʃɑk
mare	ˈmɛ(ə)ɹ
colt	koʊlt
tracer	ˈtɹeɪsɚ
gram	ˈɡɹeəm
dew	du
muffler	ˈmʌflɚ
hammer	ˈhæmɚ
prostitute	ˈpɹɑːstətuːt
perch	pɝtʃ
beard	bɪɹd
profile	ˈpɹoʊfaɪl
abundant number	əˈbʌn.dn̩t ˈnʌm.bɚ
home	hoʊm
workshop	ˈwɝk.ʃɑp
manga	ˈmɑŋɡə
doujinshi	doʊˈdʒɪnʃi
objective	əbˈd͡ʒɛk.tɪv
asset	ˈæsɛt
loan	loʊn
hanja	ˈhɑn.dʒə
civilization	ˌsɪv.ə.ləˈzeɪ.ʃən
eidolon	aɪˈdoʊlɑn
mock	mɑk
black hole	blæk ˈhoʊl
proton	ˈpɹoʊ.tɑn
weer	wiː.ɚ
obsolete	ɑbsəˈliːt
zoology	zoʊˈɑlədʒi
gourmet	ɡʊɹˈmeɪ
mildew	ˈmɪl.d(j)u
molding	ˈmoʊl.dɪŋ
abye	əˈbaɪ
hallucinatory	həˈluː.sɪ.nə.tɔːr.i
halm	hɔm
academical	ˌæk.əˈdɛm.ɪ.kl̩
academicals	ˌæk.əˈdɛm.ɪ.kl̩z
synergy	ˈsɪnɚdʒi
mark	mɑːk
mark	mɑɹk
forever	fəˈɹɛvɚ
webster	ˈwɛbstɚ
wire	ˈwaɪɚ
want	wɑnt
rhinoceros	ɹaɪˈnɑsəɹəs
acalycinous	ˌeɪ.kəˈlɪs.n̩.əs
accusatorial	ə.ˌkju.zə.ˈtɔɹ.i.əl
armenian	ɑːɹˈmiːni.ən
angolan	æŋˈɡoʊlən
gender	ˈdʒɛndɚ
vociferation	voʊˌsɪf.əˈɹeɪ.ʃən
mediterranean	ˌmɛdɪtəˈɹeɪnɪən
aberrancy	æ.ˈbɛɹ.n̩.si
nadir	ˈneɪ.dɪɹ
masked	mæskt
masseur	məˈsuːɹ
masseuse	məˈsuːs
acarpellous	ˌeɪ.ˈkɑɹ.pə.ləs
britain	ˈbɹɪ.tn̩
neurotomy	nʊəˈɹɑtəmi
hawaii	həˈwaɪ(j)i
ursula	ˈɝ.sə.lə
masturbation	ˌmæstɚˈbeɪʃən
handkerchief	ˈhæŋkɚtʃɪf
handmade	ˈhændˌmeɪd
itinerary	aɪˈtɪnəɹɛɹi
acatalectic	ˌeɪ.ˌkæt.ə.ˈlɛk.tɪk
acatalepsy	eɪˈkæ.tə.lɛp.si
acaudate	eɪ.ˈkɔ.ˌdeɪt
acaulescent	ˌæk.ɔ.ˈlɛs.ənt
hangeul	ˈhɑnˌɡul
flanders	ˈflæn.dɚz
synthesizer	ˈsɪn.θəˌsaɪ.zɚ
postulate	ˈpɑstʃələt
postulate	ˈpɑstʃələt
postulate	ˈpɑstʃəˌleɪt
aggression	əˈɡɹɛʃən
corsican	ˈkɔɹsəkən
brat	bɹæt
brat	bɹɑt
churn	tʃɝn
information	ˌɪnfəɹˈmeɪʃən
cardinal	ˈkɑɹdɪnəl
daystar	ˈdeɪstɑɹ
genoa	ˈdʒɛn.ou.ə
cwm	kuːm
cornet	kɔɹˈnɛt
diurnal	daɪˈɝ.nəl
additive	ˈæ.də.tɪv
kernel	ˈkɝnəl
tournament	ˈtʊɹnəmənt
video game	ˈvɪ.di.oʊ̯ˌɡeɪm
astray	əˈstɹeɪ
nitrogen	ˈnaɪ.tɹə.dʒən
airplane	ˈɛəɹˌpleɪ̯n
edit	ˈɛdɪt
zeroth	ˈzɪɹ(ˌ)oʊθ
quadrillion	kwɑˈdɹɪli.ən
oddball	ˈɑːdˌbɔl
labour	ˈleɪ.bɚ
window	ˈwɪndoʊ
refresh	ɹɪˈfɹɛʃ
sartorial	sɑɹˈtɔɹ.i.əl
eng	ɛŋ
bowels	baʊ.əlz
abomasus	ˈæ.boʊˌmeɪ.səs
photography	fəˈtɑɡɹəfi
covey	ˈkoʊvi
host	hoʊst
flock	flɑk
avocation	ævoʊˈkeɪʃən
gaelic	ˈɡeɪlɪk
wishy-washy	ˈwɪʃ.iˌwɔ.ʃi
feeler	ˈfiːləɹ
magic	ˈmædʒɪk
splash	splæʃ
uh-oh	ˈʌ.oʊ
oh	oʊ
tare	tɛɚ
jaguar	ˈdʒæɡwɑɹ
due	du
ogre	ˈoʊ.ɡɚ
kimono	kəˈmoʊnoʊ
duo	ˈdu.oʊ
moo	mu
beta	ˈbeɪtə
coke	koʊk
download	ˈdaʊnˌloʊd
universe	ˈjuːnəˌvɝs
nippon	nɪˈpɑn
moscow	ˈmɑskaʊ
eta	ˈeɪtə
theta	ˈθeɪtə
iota	aɪˈoʊtə
linear	ˈlɪn.i.ɚ
sphere	sfɪɹ
laryngitis	læɹɪnˈdʒajtɪs
kilometer	kəˈlɑmɪtəɹ
taxonomy	tækˈsɑːnəmi
genus	ˈdʒiːnəs
chaos	ˈkeɪ.ɑs
semicolon	ˈsɛmikoʊlən
thrice	[θɾ̪̊äɪs]
once	wʌn(t)s
prom	pɹɑm
metre	ˈmiːtəɹ
café	ˌkæˈfeɪ
mu	mjuː
california	ˌkæl.ɪˈfɔɹ.njə
fuel	[ˈfjuwəɫ]
ashkenazi	ˌɑːʃkɪˈnɑːzi
premier	pɹɪˈmɪəɹ
kilometre	kəˈlɑmɪtəɹ
pressure	[ˈpɹɛʃ.ɚ]
area	ˈæɹ.i.ə
echolocation	ˌɛkoʊloʊˈkeɪʃən
milligram	ˈmɪlɪɡɹæm
density	ˈdɛn.sə.ti
magnesium	ˌmæɡˈnizi.əm
magnesium	ˌmæɡˈniʒəm
aluminium	ˌæl.(j)uˈmɪn.i.əm
phosphorus	ˈfɑsfɚəs
sulfur	ˈsʌl.fɚ
argon	ˈɑːɹɡɒn
calcium	ˈkælsi.əm
chromium	ˈkɹoʊmi.əm
manganese	ˈmæŋɡəniz
cobalt	ˈkoʊ.bɑlt
germanium	dʒɚˈmeɪni.əm
arsenic	ˈɑɹsənɪk
arsenic	ɑɹˈsɛnɪk
bromine	ˈbɹoʊmin
antimony	ˈæn.tɪˌmoʊ.ni
xenon	ˈzinɑn
xenon	zinən
mercury	ˈmɝkjəɹi
polonium	pəˈloʊni.əm
francium	ˈfɹænsi.əm
protactinium	ˌpɹoʊ.tækˈtɪn.i.əm
einsteinium	aɪnˈstaɪni.əm
dubnium	ˈduːbniəm
roentgenium	ɹɛntˈɡɛniəm
astatine	ˈæstəˌtin
accentual	æk.ˈsɛn.tʃu.əl
accede	ækˈsid
accedence	æk.ˈsid.əns
accelerometer	æk.ˌsɛl.ə.ˈɹɑm.ə.tɚ
cassowary	ˈkæs.ə.ˌwɛɹ.i
co	koʊ
pot	pɑt
deuterium	djuːˈtɪɹi.əm
terminal	ˈtɚmɪnəl
croissant	kɹəˈsɑnt
croissant	[kʰɹəˈsɑnt]
bolt	boʊlt
ho	hoʊ
lombardy	ˈlɑmbəɹdi
persian	ˈpɝʒən
jaundice	ˈdʒɔndɪs
jauntily	ˈdʒɑn.tɪ.li
info	ˈɪnfoʊ
albert	ˈæl.bɚt
bach	bætʃ
lexicon	ˈlɛk.sɪ.kɑn
omega	oʊˈmɛɡə
vulcan	ˈvʌlkən
thank	[θæŋk]
acclamatory	ə.ˈklæm.ə.tɔɹ.i
condom	ˈkɑn.dəm
fire engine	faɪɚ.ɛn.dʒɪn
acclimation	æk.lə.ˈmeɪ.ʃən
onus	ˈoʊnəs
real	ɹeɪˈɑl
real	ɹeɪˈɑl
cognition	kɑɡˈnɪʃən
pennsylvanian	pɛnsʊlˈveɪ̯njɪn
depose	diˈpoʊz
fertilizer	ˈfɜːɹtəlaɪzəɹ
monopoly	məˈnɑpəˌli
boolean	ˈbuli.ən
paradigm	ˈpæɹ.ə.daɪm
restaurant	ˈɹɛs.t(ə)ˌɹɑnt
utopia	juˈtoʊ.pi.ə
labor	ˈleɪ.bɚ
accompanist	əˈ.kʌm.pə.nɪst
laurite	ˈlɔɹ.aɪt
laurentian	lɑˈɹɛnʃən
laureled	ˈlɔɹəld
prescience	ˈpɹɛʃɨns
laurel	ˈlɔɹ.əl
laureate	ˈlɔɹ.i.ət
lauraceous	ˌlɔɹˈeɪ.ʃəs
launch	lɔnt͡ʃ
laughter	ˈlæftɚ
ignore	ɪɡˈnɔɹ
halal	həˈlɑːl
laugher	ˈlæfɚ
laughable	ˈlæfəbl̩
accursed	əˈkɝ.sɪd
accusatory	ə.ˈkju.zə.ˌtɔɹ.i
pop	pɑp
christianity	ˌkɹɪstʃiˈænɪti
holy	ˈhoʊli
ordinary	ˈɔɹdɪnɛɹi
pure	ˈpjʊɹ
pure	pjʊɚ
cursed	ˈkɝsɪd
bow	boʊ
armor	ˈɑːɹ.mɚ
slash	slæʃ
rock	ɹɑk
boulder	ˈboʊldəɹ
weird	ˈwiɚd
forest	ˈfɔɹɪst
grove	ɡɹoʊv
muse	mjuz
clash	klæʃ
meal	[miːʟ̩]
dinner	ˈdɪnəɹ
college	ˈkɑlɪd͡ʒ
consume	kənˈsuːm
micro	ˈmaɪ.kɹoʊ
multi-million	ˌmʌltiˈmɪljən
accusingly	ə.ˈkju.zɪŋ.li
cauliflower	ˈkɔl.ɪˌflaʊ.ɚ
vodka	ˈvɑdkə
mania	ˈmeɪ.ni.ə
phone	foʊ̯n
marathon	ˈmæɹəˌθɑn
accustomedness	əˈkʌs.təmd.nɪs
simultaneous	ˌsaɪ̯m.əlˈteɪ̯n.i.əs
simultaneously	ˌsaɪməlˈteɪnɪəsli
simultaneity	ˌsaɪməltəˈniɪti
requiem	ˈɹɛ.kwi.əm
acephalan	eɪˈsɛ.fə.lən
acephalocystic	eɪˌsɛ.fə.loʊˈsɪ.stɪk
acerbic	əˈsɜ(ɹ)bɪk
harp	hɑɹp
protagonist	pɹoʊˈtæ.ɡə.nɪst
epistemology	ɪˌpɪstəˈmɑlədʒi
birthday	ˈbɝθˌdeɪ
acerval	əˈsɚ.vəl
acervative	əˈsɝ.və.tɪv
acetaldehyde	ˌæs.ɪˈtæl.dəˌhaɪd
acetarious	ɑ.sɪˈtɛɚ.i.əs
tagalog	tɑˈɡɑːloɡ
cryptology	kɹɪpˈtɑ.lə.dʒi
homogeneous	ˌhoʊ.moʊˈdʒiː.njəs
accumbency	ə.ˈkʌm.bənt.si
accubation	ˌɑ.kju.ˈbeɪ.ʃən
logarithm	ˈlɑ.ɡə.ɹɪ.ð(ə)m
acetin	əˈsi.tɪn
apothecary	əˈpɑθəˌkɛəɹi
acetone	ˈæ.sə.toʊn
acetous acid	əˈsiːtəs ˈæsɪd
oligarchy	ˈɑːlɪˌɡɑɹki
walnut	ˈwɑlnət
center	ˈsɛn.tɚ
equidistant	i.kwəˈdɪs.tənt
ignominy	ˈɪɡnəˌmɪni
surreptitious	səˌɹɛpˈtɪʃəs
accountably	ə.ˈkaʊn.tə.bli
algebra	ˈæl.dʒɪ.bɹə
dodecahedron	ˌdoʊdɛkəˈhiːdɹən
topsail	ˈtɑp.seɪl
gnu	nuː
esoteric	ˌɛs.əˈtɛɹ.ɪk
acetyl	ˈæsətɪl
south pole	ˌsaʊθ ˈpoʊl
sinecure	ˈsaɪ.nə.kjʊɹ
constant	ˈkɑnstənt
accra	ə.ˈkɹɑ
barcelona	ˌbɑɹsəˈloʊnə
plastic	ˈplæstɪk
legerdemain	ˈlɛdʒ.əɹ.dəˌmeɪn
onomatopoeia	ˌɑnəˌmætəˈpiːə
gear	ɡɪɚ
bar	bɑɹ
hallowed	ˈhæloʊd
guernsey	ˈɡɝnzi
ecology	i.ˈkɑ.lə.dʒi
juggernaut	ˈdʒʌ.ɡɚ.nɑt
xenophobe	ˈzinəfoʊb
hilarious	hɪˈleɹiəs
universalism	ˌjuːnəˈvɝsəlˌɪzəm
bald	bɔld
bald	bɑld
draconian	dɹəˈkoʊ.ni.ən
execrable	ˈɛksɪkɹəbl
somnambulate	sɑːm.ˈnæm.bju.ˌleɪt
rigmarole	ˈɹɪɡməɹoʊl
prosaic	pɹoʊˈzeɪ.ɪk
liguria	lɪˈɡjʊɹiə
nairobi	naɪˈɹoʊbi
snafu	snæːˈfuː
quito	ˈkitoʊ
rome	ɹoʊm
siberia	[saɪˈbɪɹiə]
silesia	saɪˈliʒə
hanover	ˈhænˌoʊvɚ
cola	ˈkoʊlə
explosion	ɛkˈsploʊ.ʒən
wealthy	ˈwɛl.θi
unknown	ʌnˈnoʊn
primary	ˈpɹaɪˌmɛɹi
primary	ˈpɹaɪməɹi
tapas	ˈtæp.əs
payroll	ˈpeɪɹoʊl
tunis	ˈtuːnəs
virginia	vɚˈdʒɪn.jə
warsaw	ˈwɔɹsɔ
zurich	ˈzɜɹ.ɪk
yellowish	ˈjelɔʊɪʃ
alchemist	ˈæl.kə.mɪst
popcorn	ˈpɑp.kɔɹn
sandwich	ˈsænˌ(d)wɪt͡ʃ
saggar	ˈsæɡ.əɹ
qur'an	kəˈɹɑn
dharma	ˈdɑɹ.mə
glass	ɡlæs
strong	stɹɔŋ
barbarian	bɑɹ.ˈbɛəɹ.i.ən
cuban	[ˈkju.bən]
bergamo	ˈbɝɡəˌmoʊ
ugandan	juˈɡɑndən
nucleic acid	nuˈkleɪ.ɪk ˈæsɪd
pole	[pʰoʊ̯ɫ]
puerto rican	ˈpɔɹ.ɾəˌɹiː.kən
turkmen	ˈtɝk.mən
tajik	ˈtɑːdʒɪk
builder	ˈbɪl.dɚ
hamburger	ˈhæmˌbɝ.ɡɚ
magnesian	mæɡˈniʒən
font	fɑnt
ampere	ˈæmˌpɪər
candela	kænˈdēlə
kelvin	ˈkɛlvən
hertz	hɝts
ohm	oʊm
pascal	pæˈskæl
azeri	əˈzɛɹi
saxophonist	ˌsæk.ˈsɔ.fə.nɪst
loquacious	loʊˈkweɪʃəs
byzantine	ˈbɪzəntiːn
somali	soʊˈmɑːli
watt	wɑt
weber	ˈwɛbɚ
swahili	swɑˈhili
worker	ˈwɝ.kɚ
electricity	əˌlɛkˈtɹɪsɪti
giga-	ˈɡɪɡə
milli-	ˈmɪlɪ
nano-	ˈnænoʊ
tera-	ˈtɛ.ɹə
wart	wɔɹt
formosa	fɔɹˈmoʊ.sə
dermatologist	ˌdɝ.mə.ˈtɑ.lə.dʒɪst
psychiatrist	ˌsaɪˈkaɪ.ə.tɹɪst
photograph	ˈfoʊ.tə.ˌɡɹæf
calendarist	ˈkæl.ən.dəɹ.ɪst
banjo	ˈbæn.dʒoʊ
fatwa	ˈfætwɑ
perfume	ˈpɝfjuːm
perfume	pɚˈfjuːm
judo	ˈdʒudoʊ
soju	ˈsoʊdʒuː
gymnasium	dʒɪmˈneɪ.zi.əm
ginger	ˈdʒɪndʒɚ
antwerp	ˈæn.twɝp
arlon	[ˈɑɹ.ɫɔːn]
clover	ˈkloʊ.vɚ
montana	mɒnˈtænə
virgule	ˈvɝ.ɡjul
moniker	ˈmɑn.ɪ.kɚ
occult	əˈkʌlt
factotum	fækˈtoʊ.təm
cylindrical	sɪˈlɪndɹɪkəl
gabardine	ˈɡæbɚˌdin
ladybug	ˈleɪ.di.bʌɡ
waylay	ˈweɪleɪ
monastery	ˈmɑnəstɛɹi
marrow	ˈmæɹoʊ
manual	ˈmænjə(wə)l
moses	ˈmoʊzəz
hexagon	ˈhɛk.sə.ɡɑn
arc	ɑɹk
collage	kəˈlɑʒ
tuna	ˈt(j)u.nə
idolatry	aɪˈdɑ.lə.tɹi
axes	ˈæksiz
sark	sɑɹk
graphite	ˈɡɹæfaɪt
rhombus	ˈɹɑːmbəs
climber	ˈklai.mɚ
aloft	əˈlɔft
offspring	ˈɔfspɹɪŋ
croatian	ˌkɹoʊˈeɪ.ʃən
horn	hɔɹn
something	ˈsʌmθɪŋ
antelope	ˈæn.tə.loʊp
flamingo	fləˈmɪŋɡoʊ
leopard	ˈlɛpɚd
mongoose	ˈmɑŋ.ɡus
scorpion	ˈskɔɹ.pi.ən
baboon	ˌbæˈbuːn
python	ˈpaɪθɑːn
lyre	ˈlaɪ.ɚ
toxic	ˈtɑk.sɪk
erase	ɪˈɹeɪs
atlas	ˈætləs
zeus	zus
fountain	[ˈfaʊn.ʔn̩]
beret	bəˈɹeɪ
horny	ˈhɔɹ.ni
template	ˈtɛm.plɪt
lizard	ˈlɪz.ɚd
sort	sɔɹt
demo	ˈdɛm.oʊ
santorini	ˌsæntəˈɹini
thira	ˈθɪɹə
alopecia	æloʊˈpiː.ʃ(i)ə
avuncular	əˈvʌŋkjʊlɚ
battology	bæˈtɑː.lə.dʒi
ioannina	jɔˈɑninɑ
barrow	ˈbæɹoʊ
proper	ˈpɹɑ.pɚ
video	ˈvɪd.iˌoʊ
producer	pɹəˈduːsɚ
substitution	ˌsʌbstəˈtuʃən
propaganda	[ˌpɹɑp.ə.ˈɡæn.də]
cocoa	ˈkoʊ.koʊ
research	ˈɹi.sɚtʃ
papa	ˈpɑː.pə
hagiography	ˌhæɡiˈɒɡɹəfi
flip-flop	ˈflɪpˌflɑp
awe	ɔ
peanut	ˈpinət
sisters	ˈsɪs.tɚz
juice	d͡ʒus
grasp	ɡɹæsp
they're	ðeɪɚ
we're	wɪɚ
snowman	ˈsnoʊ.mæn
isn't	ˈɪzənt
doesn't	ˈdʌzənt
wouldn't	[wʊdⁿn̩t]
don't	doʊnt
shan't	ˈʃænt
oughtn't	ˈɔt.n̩t
sha'n't	ˈʃænt
yawn	jɔn
paw	pɔ
pause	pɔz
gozo	ˈɡoʊzoʊ
ursine	ˈɝːsaɪn
tobacco	təˈbæk.oʊ
heptagon	ˈhɛp.tə.ɡɒn
decagon	ˈdɛ.kə.ɡɑn
pope	poʊp
erudite	ˈɛɹ.(j)u.daɪt
erudite	ˈɛɹ.(j)ə.daɪt
adversary	ˈæd.vəɹ.sɛɹi
peep	pip
cot	kɑt
raw	ɹɔ
deciduous	dɪˈsɪd.ju.əs
evergreen	ˈɛvɚɡɹin
doppelganger	ˈdɑp(ə)lˌɡɛŋəɹ
poltergeist	ˈpoʊl.tɚˌɡaɪst
ghost	ɡoʊst
nasty	ˈnæs.ti
horrid	ˈhɔɹɪd
saxophone	ˈsæksəfoʊn
blueberry	ˈblu.ˌbɛ.ɹi
poo	puː
informatician	ˌɪnfəɹməˈtɪʃən
compress	ˈkɑmpɹɛs
ersatz	ˈɛəɹsɑts
ersatz	ˈɛəɹzɑts
ersatz	ɛəɹˈsɑːts
ersatz	ɛəɹˈzɑːts
ersatz	ˈɝsæts
ersatz	[ɛəɹˈsɑːts]
horseshoe	ˈhɔːɹs.ʃuː
clitoris	ˈklɪtəɹɪs
samothracian	sæmoʊˈθɹeɪʃən
snooker	ˈsnʊkəɹ
autopsy	ˈɔtɑpsi
grater	ˈɡɹeɪtɚ
decile	ˈdɛs.əl
torres strait creole	ˈtɔːɹɛz stɹeɪt ˈkɹiːoʊl
kriol	ˈkɹiːoʊl
creole	ˈkɹioʊl
mater	ˈmeɪtɚ
mater	ˈmeɪtɚ
mater	ˈmeɪtɚ
row	ˈɹoʊ
row	ɹoʊ
nutrition	nuˈtɹɪ.ʃən
muck	mʌk
lumber	ˈlʌm.bɚ
bicol	ˈbikɔl
malayalam	ˌmɑː.ləˈjɑː.ləm
bureau	ˈbjʊɹ.oʊ
aerial	ˈɛɹ.i.əl
scenario	sɪˈnɛəɹioʊ
mango	ˈmæŋɡoʊ
curry	ˈkʌ.ɹi
harpsichord	ˈhɑɹp.sɪˌkɔɹd
defunct	ˌdiˈfʌŋkt
loo	lu
rope	ɹoʊp
killer	ˈkɪlɚ
crapper	ˈkɹæ.pɚ
hurricane	ˈhʌɹɪˌkeɪn
argue	ˈɑɹ.ɡju
oasis	oʊˈeɪsɪs
phenomenon	fɪˈnɑmənɑn
series	ˈsɪɹiz
stimulus	ˈstɪm.jə.ləs
synopsis	sɪˈnɑpsɪs
tableau	tæˈbloʊ
torso	ˈtɔɹ.soʊ
ager	ˈeɪ.dʒɚ
homo	ˈhoʊ.moʊ
homunculus	həˈmʌŋkjələs
pattern	ˈpætəɹn
trailer	ˈtɹeɪlɚ
venus	ˈvinəs
veto	ˈviːtoʊ
sunrise	ˈsʌnɹaɪz
bottomless	ˈbaɾm̩lɨs
placebo	pləˈsi.boʊ
clothes	kloʊ(ð)z
clothes	kloʊðz
bare	bɛəɹ
whole	hoʊl
chortle	ˈt͡ʃɔɹtəl
ordinance	ˈɔɹd.nəns
ordnance	ˈɔɹdnəns
burglar	ˈbɝɡlɚ
derogatory	dɪˈɹɑɡətɔɹi
rob	ɹɑb
monotonic	ˌmɑnəˈtɑnɪk
rhino	ˈɹaɪ.noʊ
doh	doʊ
fubar	ˈfuːbɑːɹ
spanner	ˈspæn.ɚ
passer	ˈpæsəɹ
nerd	nɝːd
surd	sɝd
thorn	θɔɹn
draught	dɹæft
smog	smɑɡ
smog	smɔɡ
trimester	ˈtɹaɪ.mɛs.təɹ
per	pɝ
semi	ˈsɛmi
interlanguage	ɪnˈtɜɹˈlæŋɡwɪd͡ʒ
turmeric	ˈtɜɹ.məɹ.ɪk
sequoyah	səˈkwɔɪə
alternative	ɔl.ˈtɝ.nə.tɪv
traveller	ˈtɹævəlɚ
traveler	ˈtɹæv.l̩.ɚ
exotic	ɪɡˈzɑtɪk
sheet	ʃit
pyrotechnic	ˌpaɪɹoʊˈtɛknɪk
automobile	ˈɔ.tə.moʊˌbil
vaporware	ˈveɪpɚwɛɹ
yogh	jɔɡ
frog	fɹɑɡ
sow	soʊ
eyrie	ˈɛɹi
aery	ˈɛɹ.iː
grasshopper	ˈɡɹæsˌhɑpəɹ
hop	hɑp
tom	tɑm
tender	ˈtɛn.dɚ
basketball	ˈbæs.kɪt.bɔːl
baa	[bæ]
elephantine	ɛl.ə.ˈfæn.tin
hippo	ˈhɪpoʊ
doe	doʊ
poke	poʊk
pokey	ˈpoʊ.ki
worm	wɝm
spirit	ˈspiɹɪt
observatory	əbˈzəɹvətɔɹi
fingernail	ˈfɪŋɡɚˌneɪl
colored	ˈkʌləɹd
walk	wɔk
rub	ɹʌb
countable	[ˈkʰaʊn(ɾ)əbɫ̩]
opposition	ɑpəˈzɪʃn̩
socialist	ˈsoʊ.ʃə.lɪst
socialist	ˈsoʊˌʃəlɪst
deny	dɪˈnaɪ
passion	[ˈpʰæʃən]
gdańsk	ɡəˈdænsk
azores	ˈeɪzɔːɹz
abstract noun	ˈæbˌstɹækt naʊn
globe	ɡloʊb
comer	ˈkʌmɚ
rogue	ˈɹoʊ̯ɡ
caber	ˈkeɪbɚ
lunacy	ˈluː.nə.si 
endeavor	ɛnˈdɛv.ɚ
geography	dʒiˈɑɡɹəfi
geologist	dʒiˈɑːlədʒɪst
fertility	fɚːˈtɪləti
fertile	ˈfɝːtəl
trio	ˈtɹioʊ
non sequitur	ˌnɑːnˈsɛk.wɪ.tɚ
detail	ˈditeɪl
detail	dɪˈteɪl
leer	lɪɹ
workout	ˈwɚk.aʊt
sprout	spɹaʊt
portal	ˈpɔːɹtəl
vocab	[ˈvoʊ.kæb]
apiary	ˈeɪ.pi.ɛɹ.i
cock-a-doodle-doo	ˌkɑkəˌdudəlˈdu
wreak	ɹik
ocean	ˈoʊ.ʃən
passport	ˈpæspɔɹt
telescope	ˈtɛləˌskoʊp
callipygian	ˌkæ.ləˈpɪ.dʒi.ən
zoo-	ˈzoʊ.ə
balustrade	ˈbæl.ə.stɹeɪd
baluster	ˈbæl.ʌ.stɹ
puritanical	pjɚ.ɪˈtæn.ɪ.kl̩
tor	tɔɹ
ecarte	e.kʌɹˈte
dewlap	ˈdu.læp
aberdonian	ˌæb.ɚˈdoʊn.jən
up	ʌp
caterpillar	ˈkætɚˌpɪlɚ
interregnum	ˌɪntəɹˈɹɛɡnəm
ostensibly	ɑːˈstɛn.sə.bli
squeegee	ˈskwiˌdʒi
bolide	ˈboʊ.laɪd
accredited	əˈkɹɛd.ɪt.əd
acknowledge	ækˈnɑː.lɪdʒ
acquaintance	ʌˈkweɪn.təns
acquittal	əˈkwɪ.d(ə)l
acrobat	ˈæk.ɹə.bæt
kuiper belt	ˈkaɪ.pɚ.bɛlt
buttock	ˈbʌtək
actionable	ˈæk.ʃə.nə.bəl
actionable	ˈæk.ʃən.ə.bəl
adder	ˈædɚ
adequate	ˈæd.ə.kwɪt
adhere	ædˈhiɹ
adhesive	ædˈhi.sɪv
adjoining	ʌˈd͡ʒɔɪn.ɪŋ
spot	spɑt
liaison	li.ˈeɪ.zɑn
administrator	ədˈmɪnɪstɹeɪtɚ
admirably	ˈæd.mɪɹ.əˌbli
napoli	ˈnɑpəli
halve	hæv
adorn	əˈdɔɹn
advance	ədˈvæns
advanced	ədˈvænst
advantage	ədˈvæn.tɪdʒ
adventurer	ædˈvɛn.tʃɚ.ɚ
adventurous	ædˈvɛn.tʃɚ.ʌs
advisability	ædˌvaɪz.əˈbɪl.ə.ti
afresh	ʌˈfɹɛʃ
omen	ˈoʊmən
-er	ɚ
maneuver	məˈnuːvɚ
manioc	ˈmæ.niˌɑk
maraud	məˈɹɔd
burrow	ˈbʌɹoʊ
burrow	ˈbɜɹoʊ
apocryphal	əˈpɑːkɹɪfəl
absent-mindedly	ˌæb.sn̩tˈmaɪn.dɪd.li
marigold	ˈmæɹ.ɪˌɡoʊld
marigold	ˈmɛɹ.ɪˌɡoʊld
hurry	[ˈhɝ.ɹi]
meow	miˈaʊ̯
chattel	[-ɾɫ]
overall	ˌoʊvɚˈɔl
overall	ˈoʊvɚɔl
eutectic	juˈtɛk.tɪk
afterthought	ˈæft.ɚ.θɔt
agate	əˈɡæt
deluxe	dəˈlʌks
cadaver	kəˈdævɚ
aghast	əˈɡæst
agitation	æ.d͡ʒɪˈteɪ.ʃən
agony	ˈæ.ɡə.niː
presto	ˈpɹɛstoʊ
allegro	əˈlɛɡɹoʊ
allegro	əˈleɪɡɹoʊ
agreeable	əˈɡɹiːəbl
air gun	ˈɛɹ.ɡə
airily	ˈeɹ.ə.li
airy	ˈɛəɹ.i
ajar	əˈd͡ʒɑɹ
akin	ʌˈkɪn
chord	kɔɹd
gesticulate	dʒɛsˈtɪkjəleɪt
alertness	əˈlɝt.nəs
alewife	ˈeɪlˌwaɪf
alexandrian	æ.lɛksˈzæn.dɹi.ən
alias	ˈeɪ.li.əs
alibi	ˈæl.ə.baɪ
alive	əˈlaɪv
alkaloid	ˈæl.kə.lɔɪd
alliance	əˈlaɪ.əns
allotment	əˈlɔt.mɛnt
alluring	ɚˈluɚ.ɹɪŋ
allure	əˈl(j)ʊɚ
allusion	əˈlu.ʒən
almoner	ˈæl.mə.nɚ
beekeeper	ˈbiˌkipɚ
alpine	ˈæl.paɪn
alteration	ɔl.tɚˈeɪ.ʃən
alternately	ˈɔl.tɚ.nət.li
alternation	ˈɔl.tɚ.ˌneɪ.ʃən
altogether	ɔl.tuˈɡɛð.ɚ
always	ˈɔl.weɪz
amateur	ˈæ.mə.tɚ
ambassador	æmˈbæs.ə.dɚ
ambassadorial	æm.bæs.əˈdoɹ.iʌl
ambition	æmˈbɪ.ʃən
ambitious	æmˈbɪʃ.əs
blog	blɑɡ
asturian	æsˈtʊɹ.i.ən
bother	[ˈbɑðɚ]
laurel and hardy	ˈlɔɹ.əl ænd ˈhɑɹ.di
amendment	ʌˈmɛnd.mənt
amends	ʌˈmɛnds
amenities	əˈmɛn.ə.tiːz
amiability	eɪ.mi.ʌˈbɪl.ə.ti
amplify	ˈæmp.lɪ.faɪ
amply	ˈæmp.li
analytical	æn.əˈlɪt.ə.kəl
analytically	æn.əˈlɪt.ɪk.əl.li
anarchist	ˈæn.ɑɹ.kɪst
anatomical	æ.nə.ˈtɑ.mɪ.kəl
crocodile tear	ˈkɹɑkədaɪl ˌtɪɹ
buffet	bəˈfeɪ
doo	du
discard	dɪsˈkɑɹd
discard	ˈdɪskɑɹd
toadstool	ˈtoʊdˌstu(ə)l
numismatics	ˌnuː.məzˈmæ.tɪks
malay	ˈmeɪleɪ
vela	ˈvilə
heretic	ˈhɛɹɨtɪk
orthodox	ˈɔːɹθədɑks
scottish	ˈskɑt.ɪʃ
tow	toʊ
tow	toʊ
ancestry	ˈæn.sɛs.tɹi
anger	ˈæŋɡɚ
aquarius	əˈkwɛɹɪəs
scorpio	ˈskɔːɹpɪoʊ
genotype	ˈdʒiːn.oʊ.taɪp
allele	əˈ.liː.l
angular	ˈæŋ.ɡju.lɚ
animation	æn.əˈmeɪ.ʃən
animosity	æn.əˈmɑs.ɪ.ti
aniseed	ˈæ.nɪ.sid
announce	əˈnaʊns
announcement	əˈnaʊns.mɛnt
answerable	ˈæn.səɹ.ə.bl
anteroom	ˈæn.ti.ɹʊm
anthropologic	ˌæn.θɹoʊ.poʊˈlɑd͡ʒ.ɪk
anthropologist	ˌæn.θɹoʊˈpɑl.ə.d͡ʒɪst
antidote	ˈæn.tə.dot
antimacassar	ˌæn.tɪ.məˈkæs.ɚ
antiquarian	ˌæn.tɪˈkwɛɹ.i.ən
antiquity	ænˈtɪk.wə.ti
anxious	ˈæŋ(k).ʃəs
anxiously	ˈæŋ(k).ʃəs.li
anybody	ˈɛn.i.bɑd.i
anyhow	ˈɛn.i.haʊ
anywhere	ˈɛn.i.(h)wɛɹ
aortic	eˈoɹ.tɪk
aperture	ˈæp.ɚ.tʃɚ
apiece	əˈpis
tone	toʊn
niche	nɪt͡ʃ
agnostic	æɡˈnɑstɪk
mellifluous	məˈlɪflu.əs
ornament	ˈɔɹnəmənt
ornament	ˈɔɹnəmənt
dune	duːn
pharaoh	ˈfæɹoʊ
interstitial	ɪntəɹˈstɪʃəl
manager	ˈmæn.ɪ.dʒɚ
copious	ˈkoʊpi.əs
cornucopia	ˌkɔːɹ.nəˈkoʊ.pi.ə
member	ˈmɛmbɚ
taunt	tɔnt
scold	skoʊld
discuss	dɪsˈkʌs
cucumber	ˈkjuːˌkʌmbɚ
ansi	ˈænsiː
baseball	ˈbeɪs.bɔl
apologetic	əˌpɑləˈdʒɛtɪk
apostolic	ˌæpəˈstɑːlɪk
apparel	əˈpæ.ɹəl
apparently	əˈpæɹ.ɨnt.li
appealing	ʌˈpi.əl.ɪŋ
urinal	ˈjʊɹɪnəl
even	ˈivən
asshole	ˈæsˌhoʊl
hotel	hoʊˈtɛl
pico-	ˈpaɪ.koʊ
centurion	sɛnˈtjʊɹ.i.ən
awol	ˈeɪ̯.wɔl
bisexual	baɪˈsɛk.ʃu.əl
lieutenant	l(j)uˈtɛnənt
photo	ˈfoʊ.toʊ
dessert	dɪˈzɝt
starboard	ˈstɑɹbɚd
tanya	ˈtɑnjə
waver	ˈweɪ.vɚ
totter	ˈtɑːtɚ
fertile crescent	ˈfɝːtəl ˈkɹɛsənt
stammer	ˈstæmɚ
stutter	ˈstʌɾɚ
median	ˈmiːdi.ən
bob	bɑb
mighty	ˈmaɪti
over	ˈoʊ.vɚ
under	ˈʌndɚ
anti-	ænti
deluge	ˈdɛl.ju(d)ʒ
roe	ˈɹoʊ
bier	biɚ
nap	næp
vino	ˈviːnoʊ
soup	sup
poly	ˈpoʊli
cacao	kəˈkaʊ̯
shergottite	ˌʃɚ.ɡəˈtaɪt
pit stop	ˈpɪt.stɑp
dos	doʊz
coma	ˈkoʊmə
coda	ˈkoʊ.də
nor	nɔːɹ
only	ˈoʊn.li
lone	loʊn
forehead	ˈfɔɹɛd
thomas	ˈtɑ.məs
joseph	ˈd͡ʒoʊsəf
tier	ˈtaɪ.ɚ
tier	ˈtɪɚ
orb	oɹb
toaster	ˈtoʊstɚ
alcohol	ˈæl.kə.hɔl
constellation	ˌkɑn.stəˈleɪ.ʃən
hectare	ˈhɛk.tɛɹ
caveat emptor	ˈkæv.iˌɑt ˈɛmp.tɔɹ
psychologist	ˌsaɪˈkɑl.ə.d͡ʒɪst
component	kʌmˈpoʊnənt
hydraulics	haɪˈdɹɔːlɪks
crêpe	kɹeɪp
combine	ˈkɑm.baɪn
crepe	kɹeɪp
chapter	ˈt͡ʃæptɚ
work out	ˌwɚk ˈaʊt
paparazzi	ˌpɑpəˈɹɑtsi
xylograph	ˈzaɪ.loʊ.ɡɹɑːf
xenophobia	zinəˈfoʊbiə
racism	ˈɹeɪsɪzm̩
hooker	ˈhʊk.ɚ
provost	ˈpɹoʊvoʊst
coach	koʊtʃ
trainer	ˈtɹeɪnɚ
centre	ˈsɛn.tɚ
hoe	hoʊ
uranus	ˈjʊɹənəs
pluto	ˈplutoʊ
crowbar	ˈkɹoʊˌbɑɹ
hunter	ˈhʌntɚ
librarian	laɪˈbɹɛɹ.i.ən
infinite	ˈɪnfɪnɪt
valais	væˈleɪ
anticlockwise	ˌæntiˈklɑkwaɪz
battle	ˈbætl̩
apprehend	æ.pɹiˈhɛnd
apprehension	æp.ɹiˈhɛn.ʃən
bistro	ˈbiːstɹoʊ
rosemary	ˈɹoʊzˌmɛəɹi
malt	mɑlt
dachshund	ˈdɑks.ˌhʊnt
debris	dəˈbɹiː
rebirth	ɹiˈbɝθ
absolute zero	ˈæb.səˌlut ˈzi.ɹoʊ
gopher	ˈɡoʊfɚ
determine	dɪˈtɝmɪn
château	ʃæːˈtoʊ
until	ʌnˈtɪl
denture	ˈdɛntʃə(ɹ)
porn	pɔɹn
pornography	pɔɹˈnɑ.ɡɹə.fi
sever	ˈsɛv.ɚ
toga	ˈtoʊɡə
-ed	ɪd
-ed	əd
turnip	ˈtɜ˞.nɪp
archer	ˈɑɹtʃɚ
counterpart	ˈkaʊntɚˌpɑɹt
zodiac	ˈzoʊ.dɪ.æk
prophet	ˈpɹɑfɪt
wanna	ˈwɑ.nə
wanna	ˈwɑ.nu
gotta	ˈɡɑtə
outta	ˈaʊɾə
honeymoon	ˈhʌn.iˌmun
wanton	ˈwɑntən
colony	ˈkɔ.lə.ni
octothorpe	ˈɑːktoʊθɔːɹp
wonder	ˈwʌndɚ
novel	ˈnɑvəl
novella	nəˈvɛlə
everywhere	ɛv.ɹi.(h)wɛɹ
palazzo	pəˈlɑtsoʊ
pasta	ˈpɑstə
starter	ˈstɑɹtɚ
approving	ʌˈpɹuv.ɪŋ
term	tɝm
uber-	ˈu.bɚ
umlaut	ˈʊm.laʊt
apropos	ˌæp.ɹəˈpoʊ
aristocrat	əˈɹɪstəkɹæt
petard	pɪˈtɑɹd
protein	ˈpɹoʊtiːn
vicarious	vaɪˈkɛ(ə)ɹi.əs
anno domini	ˈæn.oʊ ˈdɑ.mə.ni
photogenic	ˌfoʊ.toʊˈdʒɛn.ɪk
legato	ləˈɡɑ.toʊ
crescendo	kɹɪˈʃɛn.doʊ
closet	ˈklɑzɪt
medallion	məˈdæljən
medal	[ˈmɛɾ.ɫ̩]
ipe	ˈi.peɪ
lo	loʊ
demigod	ˈdɛmɪɡɑd
cyclops	ˈsaɪˌklɑps
media	ˈmiːdi.ə
media	ˈmiːdi.ə
terms	tɝmz
decimal	ˈdɛsɪməl
bonus	ˈboʊ.nəs
innkeeper	ˈɪnkiːpəɹ
quixotic	kwɪkˈsɑtɪk
meteorology	ˌmiti.əˈɹɑːlədʒi
spruce	spɹuːs
vase	veɪs
hic	hɪk
abkhazian	æbˈkeɪ.zi.ən
abkhazian	æbˈkeɪ.ʒi.ən
converse	kənˈvɝs
converse	ˈkɑnvɝs
fluke	fluk
quicksilver	ˈkwɪkˌsɪlvɚ
super	[ˈsupɚ]
shut up	ʃʌt ˈʌp
epoch	ˈɛp.ək
alto	ˈæl.toʊ
baritone	ˈbɛɹ.ɪ.toʊn
bucolic	bjuˈkɑlɪk
parsimony	ˈpɑɹ.sə.ˌmoʊ.ni
palindrome	ˈpælɪndɹoʊm
hypoallergenic	haɪ.po.æl.ɚˈdʒɛn.ɪk
conclave	ˈkɑn.kleɪv
credophile	ˈkɹɛd.ə.faɪl
coup d'état	ˌkuːdeɪˈtɑː
duplex	ˈduplɛks
amazon	ˈæm.əˌzɑn
barf	bɑɹf
boner	ˈboʊ.nɚ
vulgar	ˈvʌl.ɡɚ
gong	ɡɑŋ
surface	ˈsɝːfəs
ma'am	mæm
madame	məˈdæm
-or	ɚ
enter	ˈɛntɚ
chant	tʃænt
monster	ˈmɑnstɚ
bulwark	ˈbʊl.wɝk
sidereal	saɪˈdɪɹi.əl
ethereal	ɪˈθɪɹ.i.əl
stan	stæn
mono	ˈmɑnoʊ
bowl	boʊɫ
para	ˈpɑːɹə
origami	ˌɔɹəˈɡɑmi
format	ˈfɔːɹ.mæt
donation	doʊˈneɪʃən
manufacture	ˌmænjuˈfæktʃɚ
pebble	ˈpɛb.əl
ergo	ˈɝɡoʊ
ergo	ˈɝɡoʊ
facsimile	fækˈsɪm.ə.li
microorganism	ˌmaɪ.kɹoʊˈɔːɹ.ɡən.ɪ.zəm̩
shoehorn	ˈʃuːˌhɔɹn
protest	ˈpɹoʊ.tɛst
bosnian	ˈbɑːzni.ən
each other	iˈtʃʌðɚ
pedophilia	ˌpɛ.dəˈfi.li.ə
into	ˈɪn.tu
sojourn	ˈsoʊdʒɚn
chiaroscuro	ˌkjɑɹəˈsk(j)ʊɹoʊ
guesstimate	ˈɡɛstəmət
guesstimate	ˈɡɜstəˌmeɪt
braggadocio	ˌbɹæɡ.əˈdoʊ.ʃiˌoʊ
ire	aɪɹ
thrall	θɹɔl
renegade	ˈɹɛnɪˌɡeɪd
frankenword	ˈfɹæŋk(ə)nˌwɝd
yokel	ˈjoʊ.kəl
bromide	ˈbɹoʊ.maɪd
abbe	æ.ˈbeɪ
abductee	ˌæb.dʌkˈti
abdullah	æbˈdʌlə
abelard	ˈæb.ə.ˌlɑɹd
abhorred	æbˈhɔɹd
abided	əˈbaɪd.əd
abington	ˈæb.ɪŋ.tən
abo	ˈæb.oʊ
aba	ˈæ.bə
abbasid	əˈbæs.əd
abner	ˈæb.nɚ
cretin	ˈkɹiːtɪn
ensconce	ɛnˈskɑns
falafel	fəˈlɑfəl
transmogrify	tɹænzˈmɑːɡɹɪfaɪ
indubitably	ɪnˈdu.bɪ.tə.bli
pardon	ˈpɑɹ.dn̩
rote	ɹoʊt
blazar	ˈbleɪz.ɑɹ
transformation	ˌtɹæns.fɔɹˈmeɪ.ʃən
nirvana	nɪɹˈvɑnə
babylon	ˈbæbɪ.lɑn
vast	væst
hooter	ˈhu.tɚ
superfluous	suːˈpɝːflu.əs
caltrop	ˈkæltɹəp
tedious	ˈti.di.əs
ou	oʊ
furniture	ˈfɝnɪtʃɚ
jus	ʒu(s)
earn	ɝn
dough	doʊ
tumor	tuː.məɹ
sob	ˌɛs oʊ ˈbi
eccentric	ɛkˈsɛntɹɪk
duress	duˈɹɛs
coordinate	koʊˈɔɹdənɪt
coordinate	koʊˈɔɹdəˌneɪt
mar	mɑɹ
pronto	ˈpɹɑntoʊ
joke	dʒoʊk
equine	ˈiːkwaɪn
werewolf	ˈwɛəɹwʊlf
girth	ɡɝθ
cerumen	səˈɹuːmɛn
cerumen	səˈɹuːmɪn
past	pæst
circumference	sɝːˈkʌm.fɹəns
embiggen	ɛmˈbɪɡən
status quo	ˌsteɪtəs ˈkwoʊ
offal	ˈɔfl̩
dope	[doʊp]
nondescript	nɑndəsˈkɹɪpt
tribble	ˈtɹɪbl̩
tumbler	ˈtʌmblɚ
obtund	əbˈtənd
olympic	oʊˈlɪm.pɪk
omer	ˈoʊmɛɹ
omer	ˈoʊməɹ
onanism	ˈoʊnəˌnɪzəm
ornithopter	ˈɔɹ.nɪˌθɑp.tɚ
parsimonious	pɑɹ.sɪˈmo͡ʊn.i.əs
par	pɑɹ
park	[pɑɹk]
wordbook	ˈwɝdˌbʊk
perfidy	ˈpɝ.fɪ.di
performance	[pɚ.ˈfɔɹ.məns]
personal	ˈpɜɹ.sən.əl
perspicacious	ˌpɜːɹ.spɪˈkeɪ.ʃəs
pirouette	ˌpɪ.ɹəˈwɛt
quay	ki
quotient	ˈkwoʊʃənt
posse	ˈpɑ.si
aesopian	iːˈsoʊpi.ən
noir	ˈnwɑɹ
dephlogisticate	ˌdiflɑˈd͡ʒɪstɪˌke(ɪ)t
belligerent	bəˈlɪdʒ.ə.ɹənt
activities	ækˈtɪv.ə.tiz
actless	ˈæktləs
onset	ˈɔnˌsɛt
azoth	ˈæzɔθ
azurite	ˈæʒ.əˌɹaɪt
litter	ˈlɪtɚ
axolotl	ˈæk.səˌlɑ.təl
awk	ɔːk
aver	ˈeɪ.vɚ
avoirdupois	ˌævɚdəˈpɔɪz
hurl	hɝl
hollow	ˈhɑ.loʊ
hoax	hoʊks
below	bəˈloʊ
palette	ˈpælɪt
glazier	ˈɡleɪ.ʒəɹ
kolkata	koʊlˈkɑtə
kama	kɑmə
squab	ˈskwɑb
piper	ˈpaɪ.pɚ
lair	lɛəɹ
maker	ˈmeɪk.ɚ
broach	bɹoʊtʃ
brooch	bɹoʊtʃ
archbishop	ɑɹtʃ.bɪʃ.əp
turncoat	ˈtɝn.koʊt
ladybird	ˈleɪ.di.bɝd
lycanthropy	laɪˈkanθɹəpi
chauffeur	ʃoʊˈfɝ
sepulchre	ˈsɛpəlkɚ
merry-go-round	ˈmɛ.ɹi.ɡoʊ.ɹaʊnd
zoologist	zoʊˈɑlədʒɪst
bookseller	ˈbʊksɛlɚ
driver	ˈdɹaɪvɚ
derring-do	ˌdɛɹɪŋˈduː
anniversary	ˌænɪˈvɝs(ə)ɹi
politician	pɑl.ɪˈtɪʃ.ən
pal	pæl
mozarab	moʊˈzæɹəb
alchemy	ˈælkəmi
spaghetti	[spəˈɡɛɾi]
mat	mæt
armpit	ˈɑɹmˌpɪt
silo	ˈsaɪloʊ
determinant	dɪˈtɝmɪnənt
mnemonics	nəˈmɑn.ɪks
mnemonic	nəˈmɑːnɪk
baker	ˈbeɪ.kɚ
goatee	ˌɡoʊˈtiː
serene	səˈɹin
tranny	ˈtɹæ.ni
bro	bɹoʊ
springbok	ˈspɹɪŋbɑk
bittern	ˈbɪtəɹn
sodom	ˈsɑdəm
dot	dɑt
osprey	ˈɑspɹi
crappy	ˈkɹæpi
necessary	ˈnɛsəˌsɛɹi
cicada	sɪˈkeɪ.də
within	wɪðˈɪn
database	ˈdætəˌbeɪs
batty	ˈbæti
chatty	ˈtʃæti
fatty	ˈfæɾ.i
catty	ˈkæti
scuttle	ˈskʌtəl
capybara	ˌkæpiˈbɛɹə
conjecture	kənˈd͡ʒɛk.t͡ʃɚ
homeboy	ˈhoʊm.bɔɪ
evanescence	ˌiː.vəˈnes.n̩s
pod	ˈpɑd
charon	ˈkɛəɹən
charon	ˈʃɛəɹɑn
equity	ˈɛk.wɪ.ti
coupon	ˈkuːˌpɑn
lottery	ˈlɑtɚi
proof	pɹuf
engineering	ˌɛn.d͡ʒɪˈnɪə.ɹɪŋ
liquor	ˈlɪk.ɚ
rematch	ˈɹiː.mætʃ
juliet	ˌdʒuliˈɛt
plenary	ˈpliːnəɹi
favor	ˈfeɪvɚ
presentiment	prɪˈzen.tɪ.mənt
bouncer	ˈbaʊnsə˞
disco	ˈdɪskoʊ
proto-indo-european	ˌpɹəʊ̯təʊ̯ˌɪndə(ʊ̯)ˌjʊə̯ɹəˈpiːən
proto-indo-european	ˌpɹoʊ̯toʊ̯ˌɪndoʊ̯ˌjʊɹəˈpi.ən
yo	joʊ
autonomous	ɔˈtɑnəməs
lima bean	ˈlaɪmə ˌbin
smoker	ˈsmoʊkɚ
malodorous	ˌmælˈoʊ.də.ɹəs
boundary	ˈbaʊndəɹi
capillary	ˈkæpɪˌlɛɹi
integral	ˈɪntəɡɹəl
anglo-saxon	ˌæŋɡloʊˈsæksən
asshat	ˈæshæt
mater lectionis	ˈmeɪtɚ lɛktiˈoʊnɪs
lonely	ˈloʊnli
dearth	dɝθ
vineyard	ˈvɪn.jɚd
grim reaper	ˈɡɹɪm ˈɹipɚ
normal	ˈnɔɹməl
biological	ˌbaɪəˈlɑdʒɪkəl
medusa	məˈduːsə
porpoise	ˈpɔːɹpəs
shakespearean	ʃeɪkˈspɪɹi.ən
milieu	mɪlˈju
apocalypse	əˈpɑkəlɪps
neighborhood	ˈneɪbɚˌhʊd
toccer	ˈtɑk.ɚ
ms	mɪz
ragnarok	ˈɹæɡ.nə.ɹɑk
dose	doʊs
tater	ˈteɪtɚ
velar	ˈviːlɚ
transpire	tɹænˈspaɪ̯ɚ
sophistry	ˈsɑ.fɪ.stɹi
blogger	ˈblɔ.ɡɚ
lier	ˈlaɪ.ɚ
rebate	ˈɹiːbeɪt
boxer	ˈbɑːksɚ
inhale	ɪnˈheɪl
yarmulke	ˈjɑ(ɹ)mə(l)kə
resolve	ɹɪˈzɑlv
resolve	ɹiˈsɑlv
billionaire	ˌbɪl.jəˈnɛɚ
millionaire	ˌmɪl.jəˈnɛɚ
formation	fɔɹ.ˈmeɪ.ʃən
garrulous	ˈɡɛɹ.ə.ləs
dubious	ˈdu.bi.əs
eschew	ɛsˈtʃu
aryan	ˈɛəɹi.ən
blast	blæst
one's	wʌns
sony	ˈsoʊni
duplicitous	duːˈplɪsətəs
recapitulation	ɹiː.kəˌpɪ.tʃəˈleɪ.ʃ(ə)n
blackberry	ˈblækbeɹi
mulberry	ˈmʌlbɛɹi
nudity	ˈnudɪti
black currant	ˈblækˌkɜɹənt
crestfallen	ˈkɹɛstfɔlən
watermelon	ˈwɔtəɹˌmɛlən
purse	pɝs
jones	d͡ʒoʊnz
immortality	ˌɪmɔːɹˈtæləti
cory	ˈkɔɹ.i
mascara	ˌmæsˈkæɹə
thicken	ˈθɪkən
toke	toʊk
sardonic	sɑɹˈdɑːnɪk
cardboard	ˈkɑɹdbɔɹd
meteor	ˈmitiɚ
eternity	ɪˈtɝnɪti
coulee	ˈkuli
despot	ˈdɛs.pət
harbinger	ˈhɑɹbɪndʒəɹ
tierce	ˈtɪɚs
firkin	ˈfɝkɪn
dovecote	ˈdʌv.kɑt
hurdle	ˈhɝdəl
wasn't	ˈwʌzənt
wasn't	[ˈwʌdn̩(t)]
habanero	ˌ(h)ɑbəˈnɛɹoʊ
patella	pəˈtɛlə
pederasty	ˈpɛd.ə.ɹæs.ti
acknow	əkˈnoʊ
collier	ˈkɑliɚ
screenshot	ˈskriːn.ʃɑt
clusterfuck	ˈklʌs.tɚˌfʌk
foyer	ˈfɔɪɝ
foyer	ˈfɔɪ.eɪ
col legno	ˌkoʊl ˈleɪnjoʊ
gratuity	ɡɹəˈtuːətɪ
out of the box	aʊt əv ðə bɑːks
straw	stɹɔ
bygone	ˈbaɪɡɔn
exegesis	ɛksɪˈdʒisɪs
toll	toʊɫ
disaster	dɪˈzæs.tɚ
dyslexia	dɪsˈlɛksi.ə
waterfall	ˈwɔtɚfɔl
bom	bɑm
sit-up	ˈsɪt.ʌp
those	ðoʊz
withhold	wɪθˈhoʊld
later	ˈleɪtɚ
structure	ˈstɹʌktʃɚ
oesophagus	ɪˈsɑfəɡəs
maidan	maɪˈdɑn
military	ˈmɪl.ɪ.tɛɹ.i
dogleg	ˈdɔːɡlɛɡ
d'oh	doʊ(ʔ)
transfer	tɹænsˈfɝ
transfer	ˈtɹænsfɝ
transference	tɹænsˈfəɹəns
really	ˈɹɪli
carder	ˈkɑɹ.dɚ
kettle	ˈkɛ.təl
dogsbody	ˈdɔɡz.bɑ.di
mortmain	ˈmɔɹt.meɪn
ion	ˈaɪ.ɑn
sorbian	ˈsɔːɹbi.ən
fetter	ˈfɛt.ɚ
voluptuous	vəˈlʌp.tʃu.əs
humanity	hjuˈmænɪti
statue	ˈstætʃu
model	ˈmɑdl̩
glucose	ˈɡlukoʊs
fructose	ˈfɹʌk.toʊs
anglo-norman	æŋ.ɡloʊ.nɔːɹ.mən
stapler	ˈsteɪpləɹ
dana	ˈdeɪ.nə
confine	ˈkɑnfaɪn
pulchritude	[ˈpʰʌɫkɹəˌtuːd]
guru	ˈɡʊɹ(ˌ)u
lance	læns
perspicacity	ˌpɜːɹ.spɪˈkæs.ə.tiː
exculpatory	ɛksˈkʌlpəˌtɒɹi
glockenspiel	ˈɡlɔ.kən.ˌʃpil
phonetic	fəˈnɛtɪk
's	ɪz
magnet	ˈmæɡnət
deceleration	dɪˌsɛləˈɹeɪʃən
lateen	læˈtin
ark	ɑɹk
blackout	ˈblækaʊt
hebetude	ˈhɛb.ə.tuːd
anyroad	ˈɛ.ni.ɹoʊd
postcard	ˈpoʊstˌkɑɹd
pastor	ˈpæstɚ
weaver	ˈwi.vɚ
infix	ˈɪnfɪks
infix	ɪnˈfɪks
seiche	seɪʃ
balm	bɑm
excuse	ɪksˈkjuz
excuse	ɪksˈkjus
often	ˈɔf(t)ən
hormone	ˈhɔːɹmoʊn
wordsmith	wɝdsmɪθ
majority	məˈd͡ʒɑɹɪti
cornflower	ˈkɔɹnˌflaʊɚ
defend	dɛˈfɛnd
guarantee	ˌɡɛəɹənˈtiː
hegemony	həˈdʒɛm.ə.ni
giusto	ˈd͡ʒu.stoʊ
trader	ˈtɹeɪdɚ
hall	hɔl
helper	ˈhɛlpɚ
lateral	ˈlæt.ɚ.əl
opera	ˈɑ.pəɹ.ə
imitation	ɪmɪˈteɪʃən
eureka	juˈɹikə
narrator	ˈnæɹeɪtəɹ
igbo	ˈiboʊ
persephone	pɚˈsɛfəniː
demeter	dəˈmiːtəɹ
yogurt	ˈjoʊɡɚt
unnecessary	ʌnˈnɛ.səˌsɛ.ɹi
enzootic	ɛn.zoʊˈɑt.ɪk
paucal	ˈpɑkəl
titration	taɪˈtɹeɪʃən
titre	ˈtaɪtɚ
nevertheless	ˈnɛvɚðəlɛs
pottery	ˈpɑtəɹi
genre	(d)ʒɑn.ɹə
myopic	maɪˈoʊpɪk
paramount	ˈpæ.ɹəˌmaʊnt
persuade	pɚˈsweɪd
scorn	skɔɹn
cyber	ˈsaɪ.bəɹ
hir	hiɹ
oo	ˈoʊoʊ
rider	ˈɹaɪ.dəɹ
spiritual	ˈspɪɹɪtʃuəl
what's	wʌts
gollum	ˈɡɑləm
logomachy	loʊˈɡɑ.mə.ki
aphrodite	æfɹəˈdaɪti
obligation	ɑb.ləˈɡeɪ.ʃən
gubernatorial	ˌɡu.bɚ.neˈtɔɹ.i.əl
wizard	wɪz.ɚd
whirligig	ˈwɝ.lɪ.ɡɪɡ
tomahawk	ˈtɑ.mə.hɔk
ophelimity	ɒf.əˈlɪm.ə.tiː
trachea	ˈtɹeɪki.ə
overseas	ˌoʊvɚˈsiːz
cloak	ˈkloʊk
coward	ˈkaʊɚd
compiler	kəmˈpaɪlɚ
scot	ˈskɑt
compound	ˈkɑmpaʊnd
compound	ˈkɑmpaʊnd
contrary	ˈkɑntɹɛɹi
extol	ɪkˈstoʊl
curl	kɝl
backward	ˈbækwɚd
melee	ˈmeɪˌleɪ
yoruba	ˈjɔːɹəbə
darkness	ˈdɑɹknɪs
prodigal	ˈpɹɑdɪɡəl
decay	di.ˈkeɪ
dawg	dɔːɡ
emo	ˈi.moʊ
niggardly	ˈnɪɡɚdli
condescend	ˌkɑːndɪˈsɛnd
alternatively	ɔl.ˈtɝ.nə.tɪv.li
trouser	ˈtɹaʊzɚ
parvenu	ˈpɑɹ.və.nju
fruition	fɹu.ˈɪʃ.ən
gnome	ɡəˈnoʊm
gnome	noʊm
lather	ˈlæðɚ
amity	ˈæ.mɪ.ti
friends	fɹɛn(d)z
pathos	ˈpeɪˌθoʊs
heterography	hɛt.əˈɹɑ.ɡɹə.fi
marsh	mɑɹʃ
invert	ɪnˈvɝt
invert	ˈɪnvɝt
peevish	ˈpivɪʃ
ref	ɹɛf
adobe	əˈdoʊ.bi
amide	ˈæ.maɪd
amino	əˈminoʊ
anise	æˈnis
anode	ˈæn.oʊd
aorta	eɪˈɔːɹtə
argot	ˈɑɹɡoʊ
arroyo	əˈɹɔɪ.oʊ
atone	əˈtoʊn
augur	ˈɔ.ɡɚ
balsa	ˈbɑlsə
baton	bəˈtɑn
bawdy	ˈbɔdi
biotic	baɪˈɑ.tɪk
boa	ˈboʊ.ə
bolo	ˈboʊ.loʊ
camber	ˈkæm.bɚ
canto	ˈkæntoʊ
carboy	ˈkɑɹ.bɔɪ
carl	kɑɹl̩
cervix	ˈsɝ.vɪks
chard	tʃɑɹd
cole	koʊl
colter	ˈkoʊltəɹ
copter	ˈkɑptɚ
corona	kəˈɹoʊnə
cox	kɑks
rather	ˈɹæðɚ
defence	dɪˈfɛns
cozen	ˈkoʊzən
cur	[kɝ]
diatom	ˈdaɪəˌtɑm
diode	ˈdaɪoʊd
dipole	ˈdaɪˌpoʊl
doer	ˈduː.əɹ
doge	doʊdʒ
dyadic	daɪˈæ.dɪk
eros	ˈɛɹoʊs
escrow	ˈɛs.kɹoʊ̯
ethane	ˈɛθeɪn
ewer	ˈju.ɚ
exhume	ɛkˈ.s(j)um
exude	ɪɡˈzud
filet	ˈfɪleɪ
fleer	flɪɹ
furl	fɝl
gala	ˈɡælə
gout	ɡaʊt
haiku	ˈhaɪ.ku
hoagie	ˈhoʊ.ɡi
hock	hɑk
hod	ˈhɑd
hogan	ˈhoʊ.ɡən
holm	hoʊm
hue	hju
hurtle	hɝtl
idyll	ˈaɪdɪl
isomer	ˈaɪ.sə.mɚ
jigger	ˈdʒɪɡɚ
junta	ˈhʊntə
knurl	nɝl
kudzu	ˈkʊd.zuː
kulak	ˈkulæk
lac	lɑk
lar	lɑɹ
levee	ˈlɛvi
ligand	ˈlɪɡənd
loam	loʊm
loess	ˈloʊ.əs
lope	loʊp
lossy	ˈlɔsi
luge	luːʒ
luxe	luks
macho	ˈmɑtʃoʊ
maw	mɔ
merle	mɝl
minter	ˈmɪntɚ
mire	ˈmaɪɚ
mitre	ˈmaɪtəɹ
mottle	ˈmɑt əl
newel	ˈnu.əl
nob	nɑb
oaf	oʊf
oblate	ˈɑbleɪt
oocyte	ˈoʊ.oʊ.saɪt
opal	ˈoʊpəl
orate	ˈɔɹ.eɪt
ossify	ˈɑ.sə.faɪ
oxalic	ɑkˈsælɪk
patina	pəˈtiː.nə
phonon	ˈfoʊ.nɑn
pica	ˈpaɪkə
pilfer	ˈpɪl.fɚ
posy	ˈpoʊzi
purl	pɝl
purvey	pɚˈveɪ
quasar	ˈkweɪ.zɑɹ
quirt	kwɚt
realty	ˈɹil̩ti
rotor	ˈɹoʊ.tɚ
scoter	ˈskoʊ.tɚ
serum	ˈsɪɹəm
sloe	ˈsloʊ
spar	spɑɹ
swag	swæɡ
thrum	θɹʌm
tony	ˈtoʊni
trawl	tɹɔl
tweeze	twiz
vaunt	vɔnt
whet	ˈwɛt
winnow	ˈwɪnoʊ
withe	wɪθ
zaire	zɑːˈɪəɹ
inter	ɪnˈtɝ
inure	ɪˈnjʊɹ
misogynist	mɪˈsɑdʒ.ən.ɪst
temerity	təˈmɛɹəti
provoke	pɹəˈvoʊk
contest	ˈkɑn.tɛst
askance	əˈskæns
dichotomous	daɪˈkɑːt.ə.məs
troop	tɹup
aleatory	ˈæ.lɪ.ə.tɔ.ɹi
antinomian	æntiˈnoʊmi.ən
banker	ˈbæŋkɚ
banner	ˈbænɚ
bauble	ˈbɔbəl
belay	bɪˈleɪ
bream	bɹɪm
calculation	kælkjəˈleɪʃən
calibration	kælɪˈbɹeɪʃən
calibre	ˈkæl.ə.bɚ
cater	ˈkeɪtəɹ
censure	ˈsɛn.ʃɚ
chafe	tʃeɪf
char	tʃɑɹ
char	tʃɑɹ
char	tʃɑɹ
char	tʃɑɹ
churlish	ˈtʃɝːlɪʃ
concentrate	ˈkɑn.sən.tɹeɪt
contradistinction	ˌkɒntɹədɪˈstɪŋkʃn̩
crafty	ˈkɹæfti
crater	ˈkɹeɪ.tɚ
creek	kɹik
debacle	dɪˈbɑ.kəl
dehydration	dihaɪˈdɹeɪʃən
deleterious	ˌdɛləˈtɪɹi.əs
desecration	dɛsɨˈkɹejʃn̩
desultory	ˈdɛs.əlˌtɔɹ.i
deterioration	dɪˌtiː.ɹi.ɔˈɹeɪ.ʃən
deviation	diviˈeɪʃən
dictation	dɪkˈteɪʃən
disburse	dɪsˈbɚs
disgrace	dɪsˈɡɹeɪs
dispute	dɪsˈpjuːt
diverse	dɨ.ˈvɝs
eleemosynary	ˌɛl.ɪˈmɑː.sə.nɛɹ.i
elsewhere	ˈɛlsˌʍɛːɹ
elucidation	ɪˌlu.sɪˈdeɪ.ʃən
enigmatic	ˌɛnɪɡˈmætɪk
enmity	ˈɛn.mɪ.tiː
enthusiastic	ɪnˌθuːziˈæstɪk
equator	ɪˈkweɪ.tɚ
equivocal	ɪˈkwɪvək(ə)l
esplanade	ˈɛspləˌneɪd
extraneous	ɪkˈstɹeɪ.ni.əs
fairly	ˈfɛɹ.li
feminization	ˌfemɪnɪˈzeɪʃən
finally	ˈfaɪ.nl̩.i
flirt	flɝt
foment	foʊˈmɛnt
foray	ˈfɔːɹ.eɪ
forgery	ˈfɔːɹ.dʒəɹ.ɪ
frustration	fɹʌsˈtɹeɪʃən
fuegian	fjuˈidʒi.ən
fulmination	fʌlmɪˈneɪʃən
contumacious	ˌkɑːn.tʊˈmeɪ.ʃəs
cumbersome	ˈkʌmbɚsəm
coronation	ˌkɔɹəˈneɪʃən
corollary	ˈkɔɹəˌlɛɹi
grimace	ˈɡɹɪm.əs
harmonica	ˌhɑɹ.ˈmɑ.nɪ.kə
hearse	hɜɹs
heredity	həˈɹɛɾəɾi
hinder	ˈhɪndɚ
hinder	ˈhaɪn.dɚ
hircine	ˈhɝsaɪn
hircine	ˈhɝsɪn
hopscotch	ˈhɑpˌskɑtʃ
hornbeam	ˈhɔɹnˌbim
hydration	haɪˈdɹeɪʃən
immigration	ˌɪmɪˈɡɹeɪʃən
impart	ɪmˈpɑːɹt
inalienable	ɪˈneɪ.li.ə.nə.bəl
incur	ɪnˈkɝ
infelicitous	ˌɪn.fəˈlɪs.ɪ.təs
innocuous	ɪˈnɑkjuəs
inoculation	ɪˌnɑkjəˈleɪʃən
insulation	ˌɪnsəˈleɪʃən
kinky	ˈkɪŋ.ki
madness	ˈmæd.nəs
insanity	ɪnˈsænɪti
lack	læk
larch	ˈlɑɹtʃ
lawn	lɔn
leisurely	ˈliʒɚli
muster	ˈmʌs.tɚ
nacre	ˈneɪkəɹ
namer	ˈneɪm.ɚ
nonchalance	ˌnɑːnʃəˈlɑːns
obstreperous	əbˈstɹɛpəɹəs
patriotic	ˈpeɪ.t(ʃ)ɹi.ɑ.tɪk
patriotism	ˈpeɪtɹi.əˌtɪzəm
partisan	ˈpɑɹ.ɾɪ.zən
payer	ˈpeɪ.ɚ
pearl	pɝl
pecuniary	pəˈkjuniɛɹi
philander	fɪˈlændəɹ
pipette	paɪˈpɛt
potential	po(ʊ)ˈtɛnʃəl
primacy	ˈpɹaɪ.mə.si
protean	ˈpɹoʊ.tɪ.ən
psalm	sɑm
punk	pəŋk
referee	ˌɹɛfəˈɹiː
retire	ɹiˈtaɪɚ
rocky	[ˈɹʷɒki]
rosette	ɹoʊˈzɛt
sacrosanct	ˈsæk.ɹoʊˌsæŋkt
scoff	skɔːf
server	ˈsɝvɚ
shaker	ˈʃeɪkɚ
sheer	ʃɪɹ
sliver	ˈslɪ.vɚ
so-called	ˈsoʊˌkɔld
sophist	ˈsoʊfɪst
sparkle	ˈspɑɹkəl
stagger	ˈstæɡɚ
startle	ˈstɑɹt(ə)l
subsume	səbˈsuːm
subvert	səbˈvɝt
subvert	ˈsʌbvɝt
swagger	ˈswæɡ.ɚ
stimuli	ˈstɪmjəˌlaɪ
marble	ˈmɑɹbəl
tanner	ˈtænɚ
thirst	θɝst
traitor	ˈtɹeɪtɚ
triumph	ˈtɹaɪ.əmf
troll	tɹoʊl
uncanny	ʌnˈkæni
urgency	ˈɝ.dʒən.si
voluminous	vəˈlu.mə.nəs
wailer	ˈweɪlɚ
entreaty	ɛnˈtɹiːti
valor	ˈvælɚ
taper	ˈteɪpɚ
transplant	tɹænzˈplænt
transplant	ˈtɹænzplænt
launderette	lɔndəˈɹɛt
supercilious	ˌs(j)u.pɚˈsɪ.li.əs
fir	fɝ
trimeter	ˈtɹɪmɪtəɹ
dimeter	ˈdɪmɪtəɹ
poem	ˈpoʊ̯əm
poet	ˈpoʊət
baroque	bəˈɹoʊk
disposition	ˌdɪs.pəˈzɪ.ʃɪn
practitioner	pɹækˈtɪʃənəɹ
partay	ˌpɑɹˈteɪ
corrode	kəˈɹoʊd
bung-hole	ˈbʌŋˌhoʊl
omg	oʊ.ɛm.ˈdʒiː
neolithic	ˌni.oʊˈlɪθ.ɪk
algonquin	ælˈɡɑːŋk(w)ɪn
kerfuffle	kɚˈfʌfəl
gargoyle	ˈɡɑɹ.ɡɔɪl
onomasticon	ˌɑː.noʊˈmæs.tɪkən
boredom	ˈbɔɹ.dəm
glossophilia	ˌɡlɑsəˈfɪli.ə
murray	ˈmɜɹi
star wars	[ˈstɑɹ ˈwɔɹz]
wonderful	ˈwʌn.dɚ.fl̩
caisson	[ˈkeɪsɑn]
bingo	ˈbɪŋ.ɡoʊ
plagioclase	ˈplædʒɪəkleɪz
evidence	[ˈɛvəɾɪns]
alley oop	ˌæliˈup
tarpaulin	ˈtɑːɹpəlɪn
good morning	ˌɡʊd ˈmɔːɹ.nɪŋ
leucite	ˈlusaɪt
hypotenuse	haɪˈpɑt̬ənus
slacker	ˈslækɚ
holocaust	ˈhɑləkɔst
idiosyncrasy	ˌɪdioʊˈsɪŋkɹəsi
snarky	ˈsnɑrki
perigee	ˈpɛɹədʒi
offensive	ˈɔˌfɛnsɪv
piccolo	ˈpɪkoloʊ
kindly	ˈkaɪndli
imperium	ɪmˈpɪɹi.əm
womanizer	ˈwʊmənaɪzəɹ
gorgeous	ˈɡɔɹdʒəs
baal	ˈbeɪəl
additionary	əˈdɪʃənɛɹi
periwinkle	ˈpɛɹiˌwɪŋkəl
odin	oʊdɪn
acanthosis	æˌkænˈθoʊ.sɪs
additory	ˈædɪˌtɔɹi
hierarchical	ˌhaɪˈɹɑːɹkɪkəl
nova	ˈnoʊ.və
scimitar	ˈsɪmɪtɑːɹ
temp	tɛmp
patriarch	ˈpeɪt(ʃ)ɹiɑɹk
national	ˈnæʃən(ə)l
concordance	kənˈkɔɹdəns
renege	ɹɪˈn(e)ɪɡ
hereby	hɪɹˈbaɪ
jove	dʒoʊv
entirety	ɪnˈtaɪ.ə.ɹɪ.ti
whoremonger	ˈhɔɹˌmɑŋ.ɡɚ
judaism	ˈdʒuːdeɪ.ɪzəm
solipsism	ˈsɑlɪpsɪzm
hepatic	həˈpætɪk
pro bono	proʊ ˈboʊnoʊ
karaoke	ˌkæ.ɹiˈoʊ.ki
gospel	ˈɡɑspəl
sectarian	sɛkˈtɛɹi.ən
reservoir	ˈɹɛz.ə(ɹ).vwɑɹ
aqueduct	ˈæk.wəˌdʌkt
bosnia	ˈbɑz.ni.ə
jokes	dʒoʊks
oak tree	ˈoʊk ˌtɹi
lake chargoggagoggmanchauggagoggchaubunagungamaugg	tʃɑɹ.ɡɑɡˌəˌɡɑɡˌmæn.tʃɑˈɡæɡ.ɡɑɡ.tʃɑ.buˌnæ.ɡuŋ.ɡə.mɑɡ
hierarchic	haɪˈɹɑɹ.kɪk
gigabyte	ˈɡɪɡəbaɪt
homogeny	həˈmɑdʒəni
preservation	pɹɛ.zɝˈveɪ.ʃən
shampoo	ʃæmˈpuː
popular	ˈpɑpjələɹ
all of a sudden	ˌɔl əv ə ˈsʌdən
hodgepodge	ˈhɑdʒˌpɑdʒ
omnium-gatherum	ˌɑm.ni.əmˈɡæ.ðɚ.əm
snow white	snoʊ (h)waɪt
humerus	ˈhjuːməɹɪs
item	[ˈaɪ̯ɾəm]
boson	ˈboʊ.zɒn
opaque	oʊˈpeɪk
bespoke	bəˈspoʊk
has-been	ˈhæz.bɪn
equivalent	ɪˈkwɪvələnt
assembly	əˈsɛmb.li
cartography	kɑɹˈtɑɡɹəfi
swamp	swɑmp
diagnose	daɪəɡˈnoʊs
misnomer	mɪsˈnoʊmɚ
de novo	deɪˈnoʊvoʊ
optimistic	ˌɑptɪˈmɪstɪk
synagogue	ˈsɪ.nəˌɡɑɡ
about-face	əˈbaʊtˌfeɪs
stationary	ˈsteɪʃəˌnɛɹi
stationery	ˈsteɪʃənɛɹi
avant-garde	ˌɑˌvɑntˈɡɑɹd
chitterlings	ˈtʃɪ.tɚ.lɪŋz
nostalgia	nɑˈstældʒə
holistic	hoʊˈlɪs.tɪk
marvellous	ˈmɑɹvələs
dildo	[ˈdɪɫdoʊ]
fraud	fɹɔd
grinder	ɡɹaɪndəɹ
y'all's	[jɔlz]
torpedo	ˌtɔɹˈpi.doʊ
tho	ðoʊ
dissect	dɪˈsɛkt
heliocentric	ˌhiːlioʊˈsɛntɹɪk
geocentric	ˌdʒioʊˈsɛntɹɪk
shiitake	ʃɪˈtɑki
dialog	ˈdaɪəlɑɡ
clothesline	ˈkloʊðzlaɪn
debilitate	dəˈbɪləteɪt
irony	ˈaɪ.ɹə.ni
irony	ˈaɪ.ɚ.ni
literally	ˈlɪtəɹəli
schedule	ˈskɛdʒʊl
vitamin	ˈvaɪ.tə.mɪn
blackguard	ˈblæɡɚd
ghastly	ˈɡæs(t).li
fatherly	ˈfɑðɚli
thereto	ˌðɛɚˈtuː
aborning	əˈbɔɹ.nɪŋ
pacify	ˈpæsɪfaɪ
discography	ˌdɪsˈkɑɡɹəfi
latter	ˈlæt̬.əɹ
fatuous	ˈfætʃ.u.əs
demotic	dɪ.mɑ.tɪk
metrology	mɛˈtɹɑ.lə.dʒi
shelter	ˈʃɛltɚ
curmudgeon	kɚˈmʌdʒən
horizontal dancing	ˌhɔː.ɹəˈzɑːn.təl ˈdɑːn.sɪŋ
tyrone	taɪˈɹoʊn
cheerio	ˈtʃɪəɹ.i.oʊ
seraglio	səˈɹæljoʊ
constable	ˈkɑnstəbəl
callow	ˈkæloʊ
hornet	ˈhɔɹ.nɪt
coco	ˈkoʊ.koʊ
winner	ˈwɪnɚ
vice versa	ˈvaɪsi ˈvɝsə
cornhole	ˈkɔɹnˌhoʊl
hornbill	ˈhɔːɹn.bɪl
quetzal	ˈkɛt.səl
harvest	ˈhɑɹ.vəst
penes	ˈpiniz
rabbi	ˈɹæ.baɪ
tranche	tɹæntʃ
paradox	ˈpæɹədɑks
aureole	ˈɔːriːoʊl
bbq	ˈbɑːɹbəkjuː
dynasty	ˈdaɪnəsti
home page	ˈhoʊmpeɪdʒ
impurity	ɪmˈpjɝɪti
algae	ˈæl.dʒi
bulge	bʌldʒ
blaspheme	ˈblæs.fim
sine qua non	ˌsɪni kwɑ ˈnɑn
poultry	ˈpoʊltɹi
alchemists	ˈæl.kə.mɪsts
narcissism	ˈnɑɹsəˌsɪzm
plaster	ˈplæstɚ
meadow	ˈmɛdoʊ
freudian slip	ˌfɹɔɪdi.ən ˈslɪp
mush	mʊʃ
holly	ˈhɑli
amoeba	əˈmiːbə
lingerie	ˌlɑn.(d)ʒəˈɹeɪ
threshold	ˈθɹɛʃ(h)oʊld
social	ˈsoʊ.ʃəl
prescriptivism	pɹəˈskɹɪp.tɪ.vɪzm̩
sideburns	ˈsaɪd.bɚnz
hardly	ˈhɑɹdli
rudder	ˈɹʌdɚ
snapdragon	ˈsnæpdɹæɡən
boll	boʊl
titmouse	ˈtɪtmaʊs
prioritize	pɹaɪˈɔːɹətaɪz
foster	ˈfɔstɚ
snowbird	ˈsnoʊbɝːd
viola	vaɪˈoʊlə
geometry	dʒiˈɑmətɹi
filipino	fɪlɪˈpinoʊ
casket	ˈkæs.kɪt
homograph	ˈhɑːməɡɹæf
poll	poʊl
nitrate	ˈnaɪˌtɹeɪt
aroma	əˈɹoʊmə
organic	ɔɹˈɡænɪk
pesto	ˈpɛstoʊ
coalition	koʊəˈlɪʃən
otherwise	ˈʌð.ɚˌwaɪz
scamper	ˈskæmpɚ
fluoride	ˈflɔɹaɪd
catacomb	ˈkætakoʊm
carbonate	ˈkɑɹbənət
carbonate	ˈkɑɹbəneɪt
ladino	ləˈdinoʊ
specify	ˈspɛs.əˌfaɪ
narwhal	ˈnɑɹʍəl
carton	ˈkɑɹtn̩
malapropism	ˈmæləpɹɑːpɪzəm
dribble	ˈdɹɪ.bɫ̩
moss	mɔs
ebcdic	ˈɛbsəˌdɪk
task	tæsk
sturdy	ˈstɜrdi
laryngeal	ləˈɹɪn.dʒ(i.)əl
balkanization	ˌbɑl.kən.aɪˈzeɪ.ʃən
misanthropic	ˌmɪs.ənˈθɹɑp.ɪk
altruistic	ˌæl.tɹuˈɪs.tɪk
mediocre	ˌmidiˈoʊkəɹ
in memoriam	ɪn məˈmɔɹi.əm
archive	ˈɑɹkaɪv
concerto	kənˈtʃɛɹtoʊ
beamer	ˈbimɚ
albedo	ælˈbi.doʊ
culinary	ˈkʌlɪˌnɛɹi
sundry	ˈsʌn.dɹi
squamous	ˈskweɪ.məs
mythology	mɪˈθɑlədʒi
interface	ˈɪntɚˌfeɪs
scrivener	ˈskɹɪvənəɹ
will o' the wisp	ˌwɪləðəˈwɪsp
kansas	ˈkæn.zəs
golden mean	ˈɡoʊl.dən ˈmiːn
border	ˈbɔɹdɚ
hyper-	ˈhaɪpɚ
purlin	[ˈpɜːɹlɪn]
parallelogram	ˌpæ.ɹə.ˈlɛl.ə.ˌɡɹæm
nebuchadnezzar	ˌnɛbəkədˈnɛzɚ
tango	ˈtæŋɡoʊ
discipline	ˈdɪ.sə.plɪn
audacity	ɔˈdæsɪti
bowler	ˈboʊ.lɚ
pursuit	pɝˈsuːt
bowled	boʊld
clerk	klɝk
deicide	ˈdi.ə.saɪd
hopper	ˈhɑ.pɚ
kalashnikov	kəˈlæʃnəˌkɑf
gunpowder	ˈɡʌnˌpaʊdəɹ
endure	ɪnˈd(j)ʊɹ
sandstone	ˈsændˌstoʊn
metallurgy	ˈmɛtələɹdʒi
il duce	il ˈdutʃeɪ
occur	əˈkɝ
lower	ˈloʊɚ
lower	ˈlaʊɚ
thinker	ˈθɪŋ.kɚ
mediaeval	mɪd.ˈi.vəl
gitmo	ˈɡɪt.moʊ
alabama	ˌæ.lə.ˈbæ.mə
repair	ɹɪˈpɛɚ
poser	ˈpoʊzɚ
exodus	ˈɛksədəs
mold	moʊld
bimbo	ˈbɪmboʊ
ecotourism	ˌɛkoʊˈtʊɹɪzəm
conduct	ˈkɑndʌkt
puerile	ˈpjʊɹɪl
draughts	dɹæfts
elenctic	əˈlɛŋk.tɪk
selene	səˈlini
proposition	ˌpɹɑpəˈzɪʃən
upward	ˈʌpwɜː(ɹ)d
authentic	ɔ.ˈθɛn.tɪk
amenable	əˈmɛn.ə.bəl
funny	ˈfʌni
mister	[ˈmɪstɚ]
circumflex	ˈsɝ.kəmˌflɛks
oval	ˈoʊvəl
crocus	ˈkɹoʊ.kəs
digitalis	dɪdʒɪˈtælɪs
bogeyman	ˈboʊɡimæn
arkansas	ˈɑɹ.kən.sɔ
iowa	ˈaɪəwə
iowa	ˈaɪəweɪ
indiana	ˌɪndiˈænə
saturnalia	ˌsætɚˈneɪli.ə
maryland	ˈmɛəɹɪlənd
alexia	ə.ˈlɛk.si.ə
equitable	ˈɛk.wɪ.tə.bəl
hellebore	ˈhɛlɪbɔːɹ
honeysuckle	ˈhʌniːsʌkəl
clever	ˈklɛvɚ
moronic	mɔːˈɹɑnɪk
uncertainty	ʌnˈsɝtənti
halo	ˈheɪloʊ
tune	t(j)un
tuner	ˈtuː.nɚ
quorum	ˈkwɔːɹ.əm
prayer	pɹɛɚ
prayer	ˈpɹeɪəɹ
abreaction	ˌæb.ɹiˈæk.ʃn̩
abbozzo	ə.ˈbɔt.ˌsoʊ
kashmir	ˈkæʃ.miɹ
northern	ˈnɔɹðɚn
berkshire	bəɹkʃəɹ
gloucestershire	ˈɡlɑstɚʃaɪɹ
worcestershire	ˈwʊs.tɚ.ʃɚ
poinsettia	ˌpɔɪnˈsɛ.ɾ(i)ə
wallflower	ˈwɔl.ˌflɑʊ.ɚ
interesting	ˈɪntəɹəstɪŋ
suppose	səˈpoʊz
suppose	ˈspoʊz
gillian	ˈd͡ʒɪlijən
albion	ˈælbi.ən
tinkle	ˈtɪŋkəl
siren	ˈsaɪɹən
coffin	ˈkɔfɪn
tourist	ˈtʊɹ.ɪst
gaseous	ˈɡæʃəs
aliphatic	ælɪˈfætɪk
shorten	ˈʃɔɹtən
quaternary	ˈkwɑːtɚˌnɛəɹi
indict	ˌɪnˈdaɪt
utter	ˈʌtɚ
household	ˈhaʊshoʊld
versus	ˈvɝsəs
prong	pɹɑŋ
engross	ɪnˈɡɹəʊs
attitude	ˈætɪtud
cosmetic	kɑzˈmɛtɪk
onto	ˈɑn.tu
imperious	ɪmˈpɪɹi.əs
newcomer	ˈn(j)uˌkʌmɚ
borough	ˈbʌɹoʊ
stall	stɔl
soviet	ˈsoʊ.vi.ət
bunker	ˈbʌŋkɚ
filbert	ˈfɪlbɚt
proto-	pɹoʊ.toʊ
algonquian	ælˈɡɑːŋk(w)i.ən
clara	klɛəɹə
uniform	ˈjunəˌfɔɹm
consort	ˈkɑnsɔɹt
consort	kənˈsɔɹt
overdraft	ˈoʊvɚdɹæft
cartridge	ˈkɑɹtɹɪdʒ
patio	ˈpætioʊ
organisation	ˌɔɹɡənɪˈzeɪʃən
deceased	diˈsist
coherent	koʊˈhɛɹənt
golden	ˈɡoʊl.dən
construct	ˈkɑn.stɹʌkt
vital	ˈvaɪt̬əl
paprika	pəˈpɹiːkə
worcestershire sauce	ˈwʊs.tɚ.ʃɚ ˈsɔːs
bearing	ˈbɛɹɪŋ
manchester	ˈmæntʃɛstɚ
dado	ˈdeɪdoʊ
clutter	ˈklʌtɚ
healer	ˈhilɚ
coffle	ˈkɔfl̩
dejection	dəˈdʒɛkʃən
scholar	ˈskɑlɚ
superstition	ˌs(j)u.pɚˈstɪ.ʃən
mutant	ˈmjuʔn̩(t)
valet	ˈvæleɪ
allergy	[ˈæl.ɚ.dʒi]
relationship	ɹɪˈleɪʃənˌʃɪp
somersault	ˈsʌmə(ɹ)ˌsɑlt
retina	ˈɹɛt.ɨ.nə
sergeant	ˈsɑɹ.dʒənt
toyota	tɔɪˈoʊtə
megan	ˈmɛɡən
vault	vɑlt
snicker	ˈsnɪkɚ
necklace	ˈnɛkləs
besides	bəˈsaɪdz
catholic	ˈkæθ(ə)lɪk
catalyst	ˈkæt.ə.lɪst
traunch	tɹɔntʃ
verge	vɝd͡ʒ
widdershins	ˈwɪ.dɚ.ʃɪnz
eulogy	ˈjulədʒi
debunk	dɪˈbʌŋk
vaccine	vækˈsiːn
isotope	ˈaɪ.sə.toʊp
isotope	ˈaɪ.sə.toʊp
radioactive	ˌɹeɪdioʊˈæktɪv
spontaneous	spɑnˈteɪ.ni.əs
half-life	ˈhæfˌlaɪf
exponential	ˌɛk.spoʊ.ˈnɛn.tʃəl
milliard	ˈmɪliɑɹd
meridian	məˈɹɪdiən
veneer	[vɨˈniə̆ɹ]
neophyte	ˈni.əˌfaɪt
know-how	ˈnoʊ.haʊ
glottochronology	
greenwich	ˈɡɹinwɪtʃ
storage	ˈstɔ.ɹɪd͡ʒ
voter	ˈvoʊtɚ
abydocomist	æbɪdəˈkoʊmɪst
acrocephalic	ˌækɹoʊsəˈfælɪk
museum	mjuˈzi.əm
isohyet	ˈaɪ.soʊˌhaɪ.ɪt
alveolar	æl.vi.ˈoʊ.lɚ
metropolitan	mɛtɹɵˈpɑlɨtən
heartbeat	ˈhɑɹtˌbit
armchair	ˈɑɹmtʃɛɚ
butcher	ˈbʊt͡ʃ.ɚ
artillery	ɑɹˈtɪləɹi
aerosol	ˈɛɹəsɔl
oleaginous	ˌoʊ.liˈædʒ.ɪ.nəs
donna	ˈdɑ.nə
roo	ˈɹu
jettison	ˈdʒɛɾɪsn̩
trauma	ˈtɹɔ.mə
taxidermy	ˈtæksɪdɚmi
pahoehoe	pəˈhoʊ.i.hoʊ.i
aether	ˈi.θɚ
aetiology	itiˈɑlədʒi
ambrosia	æmˈbɹoʊʒə
asparagus	əˈspɛɹ.ə.ɡəs
polka	ˈpoʊ(l)kə
isometric	ˌaɪ.soʊˈmɛt.ɹɪk
lethargy	ˈlɛθɚdʒi
logos	ˈloʊɡoʊs
satyr	ˈseɪt.əɹ
stethoscope	ˈstɛθəsˌkoʊp
stoma	ˈstoʊmə
chutzpah	ˈxʊts.pə
chutzpah	ˈhʊts.pə
lox	lɑks
barometer	bəˈɹɑməɾɚ
gnostic	ˈnɑstɪk
diabolical	[ˌdaɪəˈbɑlɪkəɫ]
dogma	ˈdɔɡ.mə
heliotrope	ˈhiːli.əˌtɹoʊp
hyper	ˈhaɪpɚ
hypochondriac	ˌhaɪpoʊˈkɑːndɹiæk
hypocrisy	hɪˈpɑkɹəsi
hysteria	hɨˈstɛɹijə
calypso	kəˈlɪp.soʊ
catharsis	kəˈθɑːɹˌsɪs
chlorophyll	ˈklɔɹ.ə.fɪl
chlamydia	kləˈmɪd.i.ə
cinema	ˈsɪn.ə.mə
cosmos	ˈkɑz.moʊs
cosmos	ˈkɑz.moʊs
cosmos	ˈkɑz.məs
cosmos	ˈkɔz.moʊz
margarita	ˌmɑɹ.ɡəˈɹi.tə
odyssey	ˈɑ.dɨ.si
orthography	ɔɹˈθɑɡ.ɹə.fi
patriot	ˈpeɪ.t(ʃ)ɹi.ət
pediatrician	ˌpidi.əˈtɹɪʃən
pterodactyl	ˌtɛɹəˈdæktl̩
cashmere	kæʒˈmiɹ
karma	[ˈkɑɹ.mə]
yoga	ˈjoʊɡə
durian	ˈdʊə.ɹi.ən
orangutan	əˈɹæŋ.əˌtæn
gutta-percha	ɡʌɾəˈpɹ̩tʃə
roman empire	ˈɹoʊmən ˈɛmpaɪɚ
illegal	ɪˈli.ɡəl
maraca	məˈɹɑ.kə
caldera	kælˈdɛɹ.ə
macaw	məˈkɑː
cubit	ˈkju.bɪt
gaucho	ˈɡaʊtʃoʊ
jerky	ˈdʒɝki
quinoa	ˈkinˌwɑ
moped	moʊpt
moped	ˈmoʊ.pɛd
rosebud	ɹoʊz.bʌd
billow	ˈbɪloʊ
bylaw	ˈbaɪ.lɔ
multiplayer	ˌmʌltiˈpleɪ̯ɚ
trespass	ˈtɹɛspæs
furlough	ˈfɝ.loʊ
roster	ˈɹɑstɚ
stoke	stoʊk
jeopardy	ˈd͡ʒɛpɚdi
you-uns	ˈjuʌnz
you-uns	ˈjʌnz
you-uns	jɪ̈nz
dismantle	[dɪsˈmæ̃nɾɫ̩]
pinochle	ˈpiˌnʌk.l̩
colleen	kə.ˈlin
tintinnabulation	ˌtɪntɪnˌnæbjəˈleʃən
swelter	ˈswɛl.tɚ
catenary	ˈkætəˌnɛɹi
chayote	tʃɑˈjoʊti
chalkboard	t͡ʃɔk.bɔː(ɹ)d
bigger	ˈbɪɡɚ
squeal	skwil
exuviate	ɛkˈsuː.vɪ.eɪt
pone	ˈpoʊni
pone	ˈpoʊni
turned	tɝnd
asceticism	əˈsɛt.əˌsɪz.əm
absurdism	æbˈsɝdˌɪz.m̩
nylon	ˈnaɪlɑn
monomer	ˈmɑnəmɚ
polymer	ˈpɑ.lɪ.mɚ
eisegesis	aɪsɪˈdʒisɪs
oneirocritic	oʊˌnaɪ.ɹəˈkɹɪt.ɪk
wigger	ˈwɪɡɚ
orthoepy	ˈɔɹθoʊˌɛpi
demure	dɪˈmjʊɹ
encompass	ɛnˈkʌm.pəs
sear	siːɹ
transpose	tɹænzˈpəʊz
transpose	ˈtɹænzpəʊz
landlubber	ˈlænd.lʌ.bɚ
lurgy	ˈlɝɡi
homicide	ˈhɑməsaɪd
painter	ˈpeɪntɚ
lactose	ˈlæk.toʊs
divan	dɪˈvæn
osso buco	ˌɑsoʊ ˈbukoʊ
mermaid	ˈmɝ.meɪd
zairean	zɑˈɪɹi.ən
organelle	ˌɔɹ.ɡənˈɛl
podcast	ˈpɔdkæst
cytoplasm	ˈsaɪtoʊˌplæzəm
physiological	ˌfɪzi.əˈlɑdʒɪkəl
ideologue	ˈaɪ.di.ə.lɑɡ
largely	[ˈlɑɹdʒ.li]
forbear	fɔɹˈbɛɚ
forbear	ˈfɔɹ.bɛɚ
sat	ˌɛsˌeɪ̯ˈti
sat	sæt
forcing	ˈfɔɹ.sɪŋ
emergency	ɪˈmɝ.dʒən.si
slough	slaʊ
ulster	ˈʌlstɚ
mature	məˈtʃʊ(ə)ɹ
maturity	məˈtʊəɹəti
carbohydrate	kɑːɹboʊˈhaɪdɹeɪt
amine	əˈ.miːn
merge	mɝdʒ
saccharide	ˈsæk.ə.ɹaɪd
turning	[ˈtɝ.nɪŋ]
holding	[ˈhoʊɫdɪŋ]
sesame	ˈsɛsəmi
trombone	ˌtɹɑmˈboʊn
carousel	ˌkærəˈsɛl
carousel	ˈkæɹəsɛl
carousel	ˌkærəˈzɛl
above-board	əˈbʌvˌbɔɹd
flog	flɑɡ
cloaca	kloʊˈeɪkə
eggnog	ˈɛɡ.nɑɡ
befitting	bɪˈfɪt.ɪŋ
offing	ˈɔfɪŋ
watershed	ˈwɔtɚʃɛd
console	ˈkɑːn.soʊl
console	kənˈsoʊl
solace	ˈsɑː.lɪs
morrow	ˈmɔɹoʊ
interview	ˈɪntɚvjuː
quasi	ˈkwɑ.zi
quasi-	ˈkwɑzi
soften	ˈsɔfən
severe	sɪˈvɪə
severe	sɪˈvɪr
robotic	ɹoʊˈbɑt.ɪk
robotics	ɹoʊˈbɑt.ɪks
supposed	səˈpoʊzd
supposed	səˈpoʊzɪd
presume	pɹiˈz(j)um
liberty	ˈlɪbɚti
geometric	ˌdʒi.oʊˈmɛt.ɹɪk
-ability	əˈbɪl.ə.ti
disrepair	ˌdɪs.ɹɪˈpɛɚ
overwhelm	ˌoʊvɚˈʍɛlm
disrobe	dɪsˈɹoʊb
fecund	ˈfiː.kənd
territory	ˈtɛɹɪˌtɔɹi
gross	ɡɹoʊs
executive	ɪɡˈzɛkjətɪv
paltry	ˈpɔltɹi
furore	ˈfjʊəɹɚ
harridan	ˈhæɹ.ɪ.dən
hinter	ˈhɪntɚ
woulda	ˈwʊdə
meu	ˈmju
prorogue	pɹoʊˈɹoʊɡ
cleave	kliv
clockwork	ˈklɑkwɝk
apple of the eye	ˈæp.əl.əv.ðiˈaɪ
be supposed to	səˈpoʊs ˌtu
be supposed to	səˈpoʊs tə
car park	ˈkɑɹ ˌpɑːɹk
nark	nɑːɹk
gooseberry	ˈɡusˌbɛɹi
narc	nɑːɹk
terminologist	tɛː(ɹ).mɪ.nɑ.lɑ.dʒɪst
terminological	ˌtɜɹmənəlˈɒd͡ʒɪkəl
conversion	kənˈvɝʒən
furry	ˈfɝi
'sup	sʌp
weaken	ˈwikən
heteronym	ˈhɛt.ə.ɹoʊ.nɪm
easter bunny	ˈiːs.tɚ ˈbʌ.ni
paucity	ˈpɑsɪti
fury	ˈfjʊɹi
perplexity	pəɹˈplɛksədi
perplexing	pɚˈplɛksɪŋ
evoke	ɪˈvoʊk
drastic	ˈdɹæs.tɪk
devote	dɪˈvoʊt
regurgitate	ɹɪˈɡɝd͡ʒəˌteɪt
requirement	ɹɪˈkwaɪɹmənt
vantage	ˈvæntɪd͡ʒ
vantage point	ˈvæntɪd͡ʒ ˌpɔɪ̯nt
monger	ˈmʌŋ.ɡəɹ
schmutz	ʃmʌts
scupper	ˈskʌp.ɚ
materiel	mətɪɹiˈɛl
revamp	ɹiˈvæmp
latinize	ˈlæt.ɪn.aɪz
piddle	ˈpɪdəl
non-verbal	[ˌnɑn.ˈvɜ˞.bəɫ]
cartel	kɑɹˈtɛl
wavelength	ˈweɪvˌlɛŋ(k)θ
rapport	ɹæˈpɔɹ
contusion	kənˈtuʒən
sermon	ˈsɝ.mən
reservation	ˌɹɛzɚˈveɪʃən
abiotic	ˌeɪ.baɪˈɑt.ɪk
morganatic	mɔɹɡəˈnætɪk
lasso	ˈlæs.oʊ
cause célèbre	kɔz sɛˈlɛb
odious	ˈoʊ.di.əs
turner	ˈtɜːɹnəɹ
bombastic	bɑmˈbæs.tʰɪk
bogus	ˈboʊ.ɡəs
psephology	sɨ.ˈfɑl.ə.d͡ʒi
oxytocic	ˌɑksiˈtɑsɪk
stolid	ˈstɑːl.ɪd
motionless	ˈmoʊʃənlɛs
homo sapiens	ˌhoʊmoʊ ˈseɪpi.ənz
endear	ɪnˈdɪəɹ
campus	ˈkæmpəs
asthmatic	æzˈmætɪk
respiratory	ˈɹɛspəɹəˌtɔɹi
ludicrous	ˈluː.dɪ.kɹəs
carbonated	ˈkɑɹ.bəˌneɪ.təd
protuberance	pɹoʊˈtuːbəɹəns
pommel	ˈpɑ.məl
dishonest	dɨˈsɑnɪst
orthographic	ˌɔːɹθəˈɡɹæfɪk
honyock	[hɒŋˈjɒk]
gallows	ˈɡæloʊz
defiant	dɪˈfaɪənt
nidorous	ˈnaɪ.də.ɹəs
misogyny	mɪˈsɑdʒ.ɪ.ni
haemoglobin	ˌhimoʊˈɡloʊbɪn
cavity	[ˈkʰævɪɾi]
obelisk	ˈɔbəlɪsk
rutter	ˈɹədəɹ
veracity	vəˈɹæ.sə.ti
erroneous	ɛɹˈoʊ.ni.əs
cybernetic	ˌsaɪbɚˈnɛtɪk
taxon	ˈtæksɑːn
arachnid	əˈɹæknɪd
cockatiel	ˌkɒk.əˈtil
spoiler	ˈspɔɪ.lɚ
plutarch	ˈplu.tɑɹk
nausea	ˈnɔzi.ə
prometheus	pɹoʊˈmiθi.əs
ogle	ˈoʊɡəl
scot-free	ˌskɑtˈfɹi
enclose	ɪnˈkloʊz
trough	tɹɔf
revolver	ɹɪˈvɒl.vɚ
cartoon	kɑɹˈtuːn
jose	hoʊˈzeɪ
qasida	kəˈsidə
hopefully	ˈhoʊpfəli
emaciated	əˈmeɪsieɪtɪd
steerageway	ˈstiɹɪdʒˌweɪ
holystone	ˈhoʊl.i.stoʊn
grin	ɡɹɪn
guilty	ˈɡɪl.ti
epigone	ˈɛpɨɡoʊn
procedure	pɹəˈsidʒɚ
swat	swɑt
oratory	ˈɔ.ɹə.tɔ.ɹi
soviet union	ˈsoʊviət ˈjuːniən
mock-up	ˈmɑk.ʌp
popularity	ˌpɒp.jəˈlæɹ.ɪ.ti
newfangled	ˌnuˈfæŋ.ɡəld
smarmy	ˈsmɑːɹ.mi
orthodoxy	ˈɔːɹθədɑːksi
astonishment	əˈstɑːnɪʃmənt
ostentatious	ˌɒs.tɛnˈteɪ.ʃəs
outlast	ˌaʊtˈlæst
outpost	ˈaʊtˌpoʊst
betroth	bəˈtɹoʊð
homey	ˈhoʊmi
err	ɛɚ
gory	ˈɡɔːɹ.i
carnivorous	kɑɹˈnɪv.əɹ.əs
ovary	ˈoʊvəɹi
owing	ˈoʊ.ɪŋ
prehensile	pɹiˈhɛnsəl
gasp	ɡæsp
sophomoric	sɑf(ə)ˈmɑɹɪk
kill off	kɪl ɔf
kiosk	ˈkiˌɑsk
knickerbockers	ˈnɪkɚbɑkɚz
touché	tuːˈʃeɪ
zoological	zoʊəˈlɑdʒɪkəl
zoological	zuəˈlɑdʒɪkəl
proximity	pɹɑkˈsɪ.mɪ.ti
cask	kæsk
zoophilia	ˈzoʊ.əfiliə
yellow card	ˈjɛl.oʊ ˌkɑɹd
yippie	ˈjɪ.pi
yippie	jɪˈpiː
-ness	nəs
yodel	ˈjoʊ.dəl
yolk	joʊk
youngster	ˈjʌŋstɚ
longing	ˈlɔːŋɪŋ
laud	lɔd
colin	ˈkɑlɪn
waddle	ˈwɑd.əl
etude	ˈeɪˌtud
warden	ˈwɔɹdən
pawnshop	ˈpɔnʃɑp
voyeur	vwɑ.ˈjɜɹ
paper money	ˌpeɪpəɹ ˈmʌni
banter	ˈbæntɚ
tomb	tum
barely	ˈbɛɹ.li
sanguinary	ˈsæŋɡwɪnɛɹi
grr	ɡɝː
warmth	wɔɹmθ
infraction	ɪnˈfɹækʃən
absent-mindedness	ˌæb.sn̩tˈmaɪn.dɪd.nəs
shyster	ˈʃaɪs.tɚ
submerge	sʌbˈmɝdʒ
haywire	ˈheɪ.waɪɚ
agar	ˈɑˌ.ɡɑɹ
watercress	ˈwɔtəɹkɹɛs
gemütlich	ɡəˈmytlɪç
gemütlich	ɡəˈmutlɪk
comprehension	kɑmpɹɪˈhɛnʃn̩
wisenheimer	ˈwaɪz(ə)nˌhaɪməɹ
agog	əˈɡɑɡ
gerrymander	ˈdʒɛɹiˌmændɚ
paroxysm	ˈpæɹ.əkˌsɪz.əm
tache	tæʃ
eraser	ɪˈɹeɪsɚ
bolster	ˈboʊlstɚ
bureaucracy	bjʊˈɹɑːkɹəsi
disinformation	dɪsˌɪnfɚˈmeɪʃən
malodor	ˌmælˈo(ʊ).dəɹ
flippancy	ˈflɪ.pɛn.si
sanctimonious	ˌsæŋk.tɪˈmoʊ.ni.əs
willow	ˈwɪloʊ
intuition	ɪntuwˈɪʃɨn
chthonophagia	ˌθɑn.oʊˈfeɪ.d͡ʒi.ə
contraband	ˈkɑn.tɹəˌbænd
interloper	[ˌɪɾ̃ɚˈloʊ̯pɚ]
carr	kɑɹ
whomever	humˈɛvɚ
chthonian	ˈkθoʊni.ən
chthonian	ˈθʊni.ən
macro	ˈmæk.ɹoʊ
nitwit	ˈnɪtwɪt
sabot	ˈsæboʊ
jurat	ˈdʒʊˌɹæt
urn	ɝn
eating	ˈitɪŋ
verdant	ˈvɝ.dənt
tremor	ˈtɹɛmɚ
entirely	ɪnˈtaɪɹli
wetting	ˈwɛtɪŋ
witty	ˈwɪti
wherewithal	ˈwɛəɹ.wɪ.ðɔl
whirl	wɝl
whirl	ʍɝl
whirr	wɝ
whirr	ʍɝ
albumin	æl.ˈbjuː.mən
neoteny	niˈɑːtəni
debut	deɪˈbjuː
prestigious	pɹɛˈstɪdʒəs
aspiration	ˌæspəˈɹeɪʃən
connote	kəˈnoʊt
astronomical	ˌæstɹəˈnɑːmɪkəl
classify	ˈklæs.əˌfaɪ
whoa	woʊ
wholesome	ˈhoʊlsəm
wholly	ˈhoʊli
whosoever	huːsoʊˈɛvɚ
wickiup	ˈwɪk.i.ʌp
probe	pɹoʊb
erstwhile	ˈɚst.waɪl
widower	ˈwɪdoʊɚ
wilco	ˈwɪl.koʊ
surmount	sɚˈmaʊnt
stew	stu
anemia	əˈnimi.ə
lunette	luːˈnɛt
persuasion	pɚˈsweɪʒən
lure	lʊəɹ
willpower	ˈwɪlˌpaʊɚ
windowpane	ˈwɪndoʊˌpeɪn
windowsill	ˈwɪndoʊˌsɪl
entrench	ɛnˈtɹɛntʃ
somewhat	ˈsʌmwʌt
onomastics	ˌɑː.noʊˈmæs.tɪks
coeval	koʊˈi.vəl
audio	ˈɔ.di.oʊ
conurbation	ˌkɑnɚˈbeɪʃən
notwithstanding	ˌnɑtwɪθˈstændɪŋ
nota bene	ˌnoʊtə ˈbɛneɪ
nota bene	ˌnoʊ.tə ˈbeɪ.ni
contemptuous	kənˈtɛmp.tʃu.əs
burr	bɝ
limbo	ˈlɪmboʊ
bowling	ˈboʊliŋ
intelligible	ɪnˈtɛlədʒəbl̩
phenomena	fɪˈnɑmənə
ruckus	ˈɹʌkəs
dehydrate	diːˈhaɪdɹeɪt
intercept	ɪntɚˈsɛpt
intercept	ˈɪntɚsɛpt
geodesy	dʒiˈɑdəsi
oceanography	ˌoʊʃəˈnɑɡɹəfi
disparate	ˈdɪsp(ə)ɹət
hard-on	ˈhɑɹdɑn
wunderkind	ˈvʊn.dɚ.kɪnt
woebegone	ˈwoʊbɪɡɔn
woebegone	ˈwoʊbɪɡɑn
uxorious	ʌkˈsɔɹ.i.əs
authoritative	əˈθɔɹɪˌteɪtɪv
derailleur	dəˈɹeɪlɚ
chordate	ˈkɔːɹdeɪt
doggy	ˈdɔ.ɡi
squirm	skwɝm
framework	ˈfɹeɪm.wɝk
colonel	ˈkɝnəl
euphonious	juˈfoʊni.əs
arduous	ˈɑːɹd͡ʒuəs
painstaking	ˈpeɪnˌsteɪkɪŋ
libretto	lɪˈbɹɛt.oʊ
resume	ˈɹɛz.ə.meɪ
headquarters	ˈhɛd.ˌkwɔɹ.təz
butler	ˈbʌt.lɚ
wattle	ˈwɒtəl
sinner	ˈsɪnɚ
foliage	ˈfoʊliɪdʒ
largess	lɑɹˈdʒɛs
theorem	ˈθɪəɹ.əm
manifesto	ˌmæn.əˈfɛs.to(ʊ)
scholarship	ˈskɑːləɹʃɪp
vendetta	vɛnˈdɛtə
veteran	[ˈvɛ.t̬ə.ɹən]
fractious	ˈfɹæk.ʃəs
cluster	ˈklʌstɚ
rejoinder	ɹɪd͡ʒˈɔ͡ɪndɚ
speechless	ˈspiːtʃ.lɪs
larvae	ˈlɑɹ.vi
viewpoint	ˈvjuː.pɔɪnt
amour	ɑːˈmʊr
necronomicon	ˌnɛkɹəˈnɑmɪkən
jostle	ˈdʒɑ.səl
fracas	ˈfɹeɪkəs
monty python	ˈmɑnti ˈpaɪθɑn
haggard	ˈhæɡ.ɚd
unacceptable	ˌʌn.æk.ˈsɛp.tə.bl̩
unanimous	juˈnænəməs
autochthonous	ɔˈtɑkθənəs
shemale	ˈʃi.meɪl
unarmed	ˌʌnˈɑɹmd
peccadillo	ˌpɛ.kəˈdɪ.loʊ
homoscedasticity	hoʊmoʊsɪdæsˈtɪsɪti
potentate	ˈpoʊ.tən.teɪt
importune	ɪmpɔɹˈtuːn
matutinal	məˈtʊtənəl
gonorrhea	ˌɡɒn.əˈɹi.ə
salve	sælv
pettifogger	ˈpɛtɪˌfɑːɡɚ
paramour	ˈpæɹəmɔɹ
marquess	ˈmɑɹ.kwɪs
ne'er	ˈnɛʔɚ
there's	ðɛɚz
cuckold	ˈkʌ.koʊld
hypertrophy	haɪˈpɝːtɹəfi
kinder	ˈkaɪndɚ
kinder	ˈkɪndɚ
besmirch	bɪˈsmɝːtʃ
jumper	dʒʌmpɚ
gila monster	ˈhilə ˈmɑnstɚ
lurch	lɝt͡ʃ
fossil	ˈfɑːsəl
diachronic	daɪ.əˈkɹɑnɪk
flabbergasted	ˈflæbɚˌɡæstəd
matchlock	ˈmætʃlɑk
engrossing	ɛnˈɡɹoʊsɪŋ
broccoli	ˈbɹɑ.kə.li
dashboard	ˈdæʃˌboəɹd
stadtholder	ˈstætˌhoʊldɚ
unexpected	ʌnɪkˈspɛktɪd
unclear	ʌnˈklɪɚ
echolalia	ˌɛkoʊˈleɪliə
anvil	ˈæn.vəl
unconditional	ˌʌnkənˈdɪʃənəl
swingometer	swɪŋˈɑmɪtɚ
unfettered	ˈʌnˈfɛtɚd
gloaming	ˈɡloʊ.mɪŋ
smolder	ˈsmoʊldɚ
coastal	ˈkoʊstəl
yo-yo	ˈjoʊ.joʊ
sociopath	ˈsoʊ.si.əˌpæθ
napiform	ˈneɪ.pɪ.fɔɹm
unlearn	ʌnˈlɝn
symposium	sɪm.ˈpoʊ.zi.əm
bryozoan	ˌbɹɑɪəˈzəʊən
italic	ɪˈtælɪk
ambiance	ˈæm.bi.əns
upheaval	ʌpˈhi.vəl
hoary	hɔɹ.i
urartu	ʊˈɹɑɹtu
cleanup	[ˈkliːˌnʌp]
bioinformatics	ˌbaɪoʊˌɪnfɚˈmætɪks
loki	ˈloʊki
petit	ˈpɛdi
slaughter	ˈslɔtɚ
episiotomy	əˌpiːziːˈɒtəmiː
nauseous	ˈnɔːʃəs
maxim	ˈmæk.sɪm
accouterment	əˈku.tɚ.mənt
chatter	ˈtʃætɚ
audacious	ɔˈdeɪʃəs
theater	ˈθi(ə)tɚ
gusto	ˈɡʌstoʊ
mom	mɑm
barrage	bəˈɹɑːʒ
hairshirt	ˈhɛɹʃɝt
frond	fɹɑnd
manor	ˈmænəɹ
underneath	ʌndɚˈniθ
underpin	ˌʌn.dɚˈpɪn
raucous	ˈɹɔkəs
survey	ˈsɝveɪ
survey	sɚˈveɪ
publisher	ˈpʌblɪʃɚ
talkative	ˈtɑːkədɪv
fuscous	ˈfʌskəs
mandatory	ˈmæn.dəˌtɔ.ɹi
sarcastic	sɑɹˈkæstik
curved	kɝːvd
sahara	səˈhɛəɹə
deputy	ˈdɛpjəti
legislative	ˈlɛ.dʒɪˌsleɪ.tɪv
teller	ˈtɛləɹ
superhero	s(j)upə(ɹ)hɪɹoʊ
humorous	ˈhjuːməɹɪs
herbivorous	hɜːɹˈbɪvəɹəs
adulterine	əˈdʌltəɹaɪn
adulterine	əˈdʌltəɹiːn
cursory	ˈkɝː.sə.ɹi
isoprene	ˈaɪsəˌpɹin
fœtor	ˈfiːtɔɹ
pandemonium	ˌpændɪˈmoʊni.əm
slipshod	ˈslɪp.ʃɑd
dolt	doʊlt
lager	ˈlɑːɡɚ
sonorous	ˈsɑːn.ɚ.əs
sporadic	spəˈɹæɾɪk
marshmallow	ˈmɑɹʃˌmɛl.oʊ
routing	ˈɹutɪŋ
hypo	ˈhaɪ.poʊ
popish	ˈpoʊpɪʃ
photographic	ˌfoʊtəˈɡɹæfɪk
photosynthesis	ˌfoʊ.toʊ.ˈsɪn.θə.sɪs
parisian	pəˈɹiʒən
hallucinogenic	həˌlusənəˈdʒenɪk
turret	ˈtɝɹɪt
yesteryear	ˈjɛstərjɪər
supernal	suˈpɝ.nəl
moratorium	ˌmɔ.ɹəˈtɔ.ɹi.əm
bone of contention	ˈboʊn əv kənˈtɛnʃən
cringeworthy	ˈkɹɪndʒˌwɝð.i
blameworthy	ˈbleɪmˌwɚ.ði
noteworthy	ˈnoʊtˌwɝði
praiseworthy	ˈpɹeɪz.wɝ.ði
callipygous	ˌkæl.ɪˈpɪ.dʒəs
hot dog	ˈhɑt.dɔɡ
hot dog	ˌhɑtˈdɔɡ
crayon	ˈkɹeɪ.ɒn
hella	ˈhɛl.ə
laboratory	ˈlæb(ə)ɹəˌtɔɹi
neuro-	ˈn(j)ʊɹoʊ
imprecise	ɪmpɹəˈsaɪs
falling	ˈfɔlɪŋ
lusophone	ˈlusəˌfoʊn
constantly	ˈkɑnstəntli
freely	ˈfɹili
trampoline	ˈtɹæmpəliːn
surpass	sɚˈpæs
jesus jammies	ˈdʒiːzəs ˌdʒæmiːz
patent	ˈpætənt
patent	ˈpeɪtənt
tolerant	ˈtɑːləɹənt
contemporaneously	kənˌtɛmpəˈɹeɪni.əsli
clinometer	klaɪ̯ˈnɑː.mə.t̬ɚ
cloture	ˈkloʊ.tʃɝ
claw	klɔ
well-to-do	ˌwɛltəˈdu
mung	mʌŋ
cedar	ˈsi.dɚ
verboten	ˌfə(ɹ)ˈboʊ.tən
'cause	kʌz
noncommittal	ˌnɑnkəˈmɪtl̩
legislature	ˈlɛdʒɪsˌleɪtʃɚ
biased	ˈbaɪəst
bernard	bəɹˈnɑɹd
abdominally	æbˈdɑm.ɪ.nə.li
above ground	əˈbʌvˌɡɹaʊnd
absorbingly	æbˈsɔɹb.ɪŋ.li
peeler	ˈpiːlɚ
diddly-squat	ˈdɪd(ə)li skwɑt
paraffin	ˈpɛɹ.ə.fɪn
malinger	məˈlɪŋɡɚ
transitory	ˈtɹæn.zɪˌtɔɹ.i
conduit	ˈkɑnd(j)ʊɪt
nosebleed	ˈnoʊzˌblid
piping hot	ˌpaɪpɪŋ ˈhɑːt
voir dire	ˈvɔɹ ˌdaɪɹ
oneiric	oʊ.ˈnaɪ.ɹɪk
ecosystem	ˈikoʊˌsɪstəm
portend	pɔɹˈtɛnd
whomsoever	ˌhumsoʊˈɛvəɹ
nemean lion	ˌnimi.ən ˈlai.ən
soever	soʊˈɛvəɹ
persiflage	ˈpɝː.sɪ.flɑːʒ
pertinacious	pɝtn̩ˈeɪʃəs
compere	ˈkɑːmpeɹ
dauphin	doʊˈfæ̃
notoriety	noʊ.tɚ.aɪ.ə.ti
geologic	ˌdʒi.əˈlɑdʒ.ɪk
cenozoic	ˌkɛnɵˈzoʊɪk
specialty	ˈspɛʃəlti
bloated	ˈbloʊtɪd
notation	noʊˈteɪʃən
cello	ˈtʃɛloʊ
cello	ˈsɛloʊ
swart	swɔɹt
laplace	ləˈplɑs
compulsion	kəmˈpʌl.ʃən
deodorant	diˈoʊdəɹənt
copyvio	ˈkɑpiˌvaɪ.oʊ
authoritarian	əˌθɔrəˈtɛriən
lightweight	ˈlaɪt.weɪt
lightweight	laɪtˈweɪt
plato	ˈpleɪ.toʊ
sizzle	ˈsɪzəl
exposure	ɪkˈspoʊʒɚ
lubrication	lubɹɪˈkeɪʃən
meze	ˈmɛzeɪ
sepulcher	ˈsɛpəɫkɚ
giddy	ɡɪdi
maru	ˈmɑɹu
spearhead	ˈspɪɹ.hɛd
banquette	bæŋˈkɛt
prothesis	ˈpɹɔθəsɪs
polymerize	pəˈlɪ.mə.ɹaɪz
polymerize	ˈpɑləməˌɹaɪz
intel	ˈɪɾ̃.ɛl
fata morgana	ˌfɑtə mɔɹˈɡɑnə
hallucinogen	həˈluː.sɪ.nə.dʒen
japanophilia	dʒəˌpænəˈfɪli.ə
temper	ˈtɛmpɚ
armhole	ˈɑɹmˌhoʊl
diplomatic	ˌdɪpləˈmætɪk
allergic	[ə.ˈlɝ.dʒɪk]
antisocial	ˌæntiˈsoʊʃəl
incredible	ɪŋˈkɹɛdəbəl
tantric	ˈtæntɹɪk
conscientious	ˌkɑnʃiˈɛnʃəs
texture	ˈtɛkstʃə(ɹ)
clitoral	ˈklɪtəɹəl
hecate	ˈhɛkəti
hercules	ˈhɝːkjəliːz
hermes	ˈhɝmiːz
minerva	mɪˈnɝ.və
doohickey	ˈduhɪki
andromeda	ænˈdɹɑmɪdə
deduction	dɪˈdʌkʃən
amate	əˈmɑteɪ
preamble	ˈpɹiˌæmbəl
tinder	ˈtɪndəɹ
downward	ˈdaʊnwɚd
zaftig	ˈzɑftɪɡ
implementation	ˌɪmpləmɛnˈteɪʃən
implementation	ˌɪmpləmənˈteɪʃən
ecumenical	ˌɛk.jʊˈmɛ.nɪ.kəl
lege	ˈlɛdʒ
rebuttal	ɹɪˈbʌt̬ᵊl
cloverleaf	ˈkloʊvɚliːf
precatory	ˈpɹɛ.kəˌtɔ.ɹi
mausoleum	ˌmɔ.səˈli.əm
francophobe	ˈfɹæŋkəfoʊb
guffaw	ɡəˈfɔ
snippet	ˈsnɪpɪt
burgundy	ˈbɝ.ɡən.di
topaz	ˈtoʊpæz
celadon	ˈsɛləˌdɑn
superhet	ˌsupɚˈhɛt
partition	pɑɹˈtɪʃən
haphazard	ˌhæpˈhæz.ɚd
abraham	ˈeɪ.bɹəˌhæm
divert	daɪˈvɝt
stone age	ˈstoʊn ˌeɪdʒ
asthenospermic	ˌæsθənoˈspɝmɪk
asthenospermia	ˌæsθənoˈspɝmi.ə
bases	ˈbeɪsɪz
neutrality	nuˈtɹæləti
encircle	ɪnˈsɜːkəl
encircle	ɛnˈsɜɹkəl
aspire	əˈspaɪɚ
swarthy	ˈswɔɹði
foodstuff	ˈfuːdˌstʌf
hose	hoʊz
vis-à-vis	viz.ɑˈvi
varies	ˈvɛɹiːz
condolence	kənˈdoʊləns
failing	ˈfeɪ.lɪŋ
goldenrod	ˈɡoʊldənˌɹɑd
remonstrate	ˈɹɛ.mən.stɹeɪt
vulnerary	ˈvʌl.nɚ.ɛɹ.i
hired	ˈhaɪɚd
solely	ˈsoʊl.li
toggle	ˈtɑ.ɡəl
haphazardly	hæpˈhæzɚdli
privateer	ˌpɹaɪvəˈtɪəɹ
diffuse	dɪˈfjuz
diffuse	dɪˈfjus
capitulate	kəˈpɪt͡ʃ.jʊ.leɪt
homeopathy	ˌhomiˈɑpəθi
fissure	ˈfɪʃ.ɚ
predilection	ˌpɹɛ.dəˈlɛk.ʃn̩
severity	səˈvɛɹɨti
idyllic	aɪˈdɪlɪk
serbia	ˈsɝ.bi.ə
peanuts	ˈpinəts
matrilocal	ˌmæ.tɹɪˈloʊ.kəl
configure	kənˈfɪɡ(j)ɚ
exorcism	ˈɛk.sɔɹˌsɪ.zəm
exorcise	ˈɛk.sɔɹˌsaɪz
exorcist	ˈɛk.sɔɹˌsɪst
typography	taɪˈpɑːɡɹəfi
chamfer	ˈtʃæm.fɚ
postfix	ˈpoʊstfɪks
ganglion	ˈɡæŋɡli.ən
croat	ˈkɹoʊæt
centered	ˈsɛn.təɹd
graverobber	ˈɡɹeɪvˌɹɑbɚ
montenegro	ˌmɑn.təˈneɪ.ɡɹoʊ
heartfelt	ˈhɑːɹt.fɛlt
pitfall	ˈpɪtfɔl
populous	ˈpɑpjələs
pewter	ˈpjutɚ
grommet	ˈɡɹɑ.mɪt
negatory	ˈnɛɡəˌtɔɹi
jury-rig	ˈdʒʊɹ.i ɹɪɡ
breathtaking	ˈbɹɛθˌteɪ.kɪŋ
referent	ˈɹɛfəɹənt
lacquer	ˈlæk.ɚ
devotion	dɪˈvoʊʃən
rohingya	rəʊˈhɪŋ.jə
soda	ˈsoʊdə
escalade	ˈɛskəˌleɪd
larceny	ˈlɑɹ.sə.ni
stampede	stæmˈpiːd
lozenge	ˈlɑzɪndʒ
armigerous	ɑɹˈmɪ.dʒɚ.əs
gules	ˈɡjulz
antihistamine	ˌæn.tiˈhɪs.tə.miːn
cross-dresser	ˈkɹɑsˌdɹɛ.sɚ
comedian	kəˈmiːdi.ən
polymorphism	pɑliˈmɔɹfɪz(ə)m
serpentine	ˈsɚːpəntaɪn
serpentine	ˈsɝːpəntin
beetroot	ˈbitɹut
tactless	ˈtæktləs
commune	ˈkɑmjuːn
miniver	ˈmɪnɪvɚ
unciform	ˈʌnsɪfɔːɹm
polish	ˈpɑlɪʃ
a	ə
gold	ɡoʊld
ab	ɑb
ab	æb
ab	æb
abigail	ˈæb.ə.ɡeɪl
aboriginal	ˌæb.əˈɹɪd͡ʒ.n̩.l̩
absolute	ˈæb.səˌlut
admiral	ˈæd.mɚl̩
alamo	ˈæləˌmoʊ
alder	[ˈɑl.dɚ]
amati	ɑ.mɑ.ti
amber	ˈæm.bɚ
angelo	ˈæn.dʒə.loʊ
angelo	ˈæn.hə.loʊ
apocalypse	əˈpɑkəlɪps
arcadian	ɑɹˈkeɪ.di.ən
arctic	ˈɑɹ(k)tɪk
aries	ˈɛɹiz
bob	bɑb
burgundy	ˈbɝːɡəndi
burke	bɝk
calypso	kəˈlɪp.soʊ
cancer	ˈkænsɚ
chan	tʃæn
comer	ˈkoʊmɚ
creole	ˈkɹiˌoʊl
dexter	ˈdɛkstɚ
dino	ˈdinoʊ
don	dɑn
donna	ˈdɑnə
dorcas	ˈdɔɹkəs
draco	ˈdɹeɪkoʊ
earl	ɝl
egyptology	ˌidʒɪpˈtɑlədʒi
euripides	jʊˈɹɪp.ɪˌdiz
fern	fɝːn
fletcher	ˈflɛtʃɚ
fourth	fɔɹθ
fowler	ˈfaʊlɚ
frisbee	ˈfɹɪzbi
fuller	ˈfʊlɚ
god	ɡɑd
grad	ˈɡɹɑd
grant	ɡɹænt
gross	ɡɹoʊs
han	hɑn
han	hɑn
holocaust	ˈhɑləkɔst
io	ˈaɪoʊ
joan	dʒoʊn
joanna	ˌdʒoʊˈænə
josh	ˈd͡ʒɑʃ
kaiser	ˈkaɪzɚ
ladino	ləˈdinoʊ
latin	ˈlæt.n̩
latino	ləˈtinoʊ
leo	ˈliːoʊ
lier	lɪɚ
lot	lɑt
majesty	ˈmædʒ.ə.sti
maltese	mɑlˈtiz
marathon	ˈmæɹəˌθɑn
march	mɑɹt͡ʃ
mark	mɑɹk
melissa	məˈlɪsə
mercury	ˈmɝkjəɹi
mobile	moʊˈbiːl
mom	mɑm
morgan	ˈmɔɹɡən
negro	ˈniːɡɹoʊ
nome	noʊm
orange	ˈɔɹ.əndʒ
orthodoxy	ˈɔːɹθədɑːksi
park	pɑɹk
pascal	pæsˈkæl
phosphorus	ˈfɑsfɚəs
pole	poʊl
pop	pɑp
rabat	ɹɑːˈbɑːt
renaissance	ˈɹɛnəˌsɑːns
robin	ˈɹɑbɪn
roe	ɹoʊ
roman	ˈɹoʊmən
sagittarius	sædʒɪˈtɛɹɪəs
scorpius	ˈskɔːɹpɪəs
sol	soʊl
solon	ˈsoʊlən
tanner	ˈtænɚ
toby	ˈtoʊbi
tone	ˈtoʊn
magnum opus	ˌmæɡnəm ˈoʊpəs
tucker	ˈtʌkɚ
turkey	ˈtɝ.ki
volvo	ˈvɔlvoʊ
w	ˈdʌbə(l)ju
warren	ˈwɔɹən
z	zi
machiavellian	ˌmɑk.i.əˈvɛl.i.ən
carpus	ˈkɑɹ.pəs
afar	ʌˈfaɹ
cologne	kəˈloʊn
mo	moʊ
mastermind	ˈmæs.tɚˌmaɪnd
nokia	ˈnɔ.ki.ə
fursuiter	ˈfɝˌsutɚ
incomprehensible	ˌɪnkɑmpɹəˈhɛnsɪbəl
german	ˈd͡ʒɝ.mən
english	ˈɪŋ.ɡlɪʃ
explanatory	ɪkˈsplanətɔːɹi
popsicle	ˈpɑpsɪkl̩
platonic	pləˈtɔnɪk
whippersnapper	ˈʍɪpəɹˌsnæpəɹ
protégé	ˈpɹoʊ.təˌʒeɪ
glaucous	ˈɡlɑ.kəs
divisive	dɪˈvaɪsɪv
cantle	ˈkæntəl
poltroon	pɑlˈtɹun
reaganomics	ˌreɪɡəˈnɑmɪks
wishlist	ˈwɪʃlɪst
genoa	ˈdʒenouə
anthology	ænˈθɑlədʒi
jones	dʒoʊnz
satsuma	sætˈsu.mə
amazon	ˈæ.məˌzɑ.ːn
internet	ˈɪɾ̃ɚˌnɛt
holey	ˈhoʊli
mulching mower	mʌltʃɪŋ moʊəɹ
buckle	ˈbʌk(ə)l
mocha	ˈmoʊkə
displace	dɪsˈpleɪs
divisor	dɨ.ˈvaɪ.zɚ
napoleon	nəˈpoʊli.ən
momentous	moʊˈmɛn.təs
bengal	bɛŋˈɡɑl
unilateral	[ˌjʉː.nəˈɫæɾ.ɚ.ɻɫ̩]
coterminous	kənˈtɝ.mɪ.nəs
gingerly	ˈdʒɪn.dʒəɹ.li
magnolia	ˌmæɡˈnoʊ.li.ə
herrenvolk	ˈhɛɹənfoʊk
joseph	ˈdʒoʊsəf
zootomy	zoʊˈɑdəmi
pentasyllabic	ˌpɛn.tə.sɪˈlæb.ɪk
shish kebab	ˈʃɪʃkəbɑb
tiptoe	ˈtɪpˌtoʊ
clandestinely	klænˈdɛs.tɪn.li
hog	hɑɡ
python	ˈpaɪθɑːn
hungarian notation	hʌŋˈɡɛɹi.ən noʊˈteɪʃən
phantasmagoria	ˌfæntæzməˈɡɔːɹi.ə
perky	ˈpɝki
frumpy	ˈfɹʌm.pi
pituitary	pɪˈtuːɪˌtɛɹi
discomfort	dɪsˈkʌmfɚt
antibiotic	ˌæn.taɪ.baɪˈɑ.tɪk
monetary	ˈmɑnɪteɹi
vitriol	ˈvɪ.tɹi.əl
paleolithic	ˈpæl.ɪi.oʊˌlɪθ.ɪk
consult	ˈkɑnsʌlt
termination	tɚmɪˈneɪʃən
pickaxe	ˈpɪkˌæks
tavern	ˈtævɚn
lychee	ˈlitʃiː
omertà	oʊˈmɛɹtə
tsetse	tsitsi
huguenot	ˈhju.ɡə.nɒt
angler	ˈæŋ.ɡlɚ
jocular	ˈdʒɑkjəlɚ
pulp	pəlp
engrossed	ɛn.ˈɡɹoʊst
armageddon	ˌɑɹ.məˈɡɛ.dn̩
blob	blɑb
mafia	ˈmɑfi.ə
autological	ˌɑːtoʊˈlɑːdʒɪkəl
kicker	ˈkɪkɚ
unfurl	ʌnˈfɝl
armageddon	ˌɑɹ.məˈɡɛ.dn̩
taco	ˈtɑkoʊ
extortion	ɪkˈstɔːɹʃn
halloween	ˌhæ.ləˈwiːn
asperger's syndrome	ˈæspɝɡɚz ˈsɪndɹoʊm
moore	mʊɹ
cat burglar	ˈkæt ˌbɝɡlɚ
côte d'ivoire	ˌkoʊt diˈvwɑɹ
ain't	eɪnt
equality	ɪˈkwɑl.ɪ.ti
tuple	ˈtuːpəl
dactylology	ˌdæktəlˈɑlədʒi
midwifery	ˈmɪdˌwaɪfəɹi
fiqh	fik
shitty	ˈʃɪti
burgeon	ˈbɝː.d͡ʒən
high five	haɪ faɪv
caesura	sɪˈʒʊɹə
deify	ˈdiː.ə.faɪ
bowman	ˈboʊmən
upmost	ˈʌpmoʊst
uppermost	ˈʌpɚˌmoʊst
uproar	ˈʌpɹɔːɹ
symbiotic	ˌsɪm.baɪˈɑt.ɪk
urbanity	ɝˈbæn.ə.ti
remuneration	rɪˌmjuːnəˈreɪʃən
technobabble	ˈtɛknoʊbæbəl
ivory tower	ˈaɪvəɹi ˈtaʊɚ
hostler	ˈ(h)ɑːs.lɚ
ostler	ˈɑːslɚ
ménage à trois	ˌmeɪnɑːʒ ɑː ˈt(ɹ)wɑː
usher	[ˈʌʃ.ɚ]
reproach	ɹɪˈpɹoʊtʃ
allophone	ˈæləˌfoʊn
retroactive	ˌɹɛ.tɹoʊˈæk.tɪv
fictionary	ˈfɪkʃəˌnɛɹi
nsaid	ˈɛnsɛd
irs	ˈaɪ.ɑɹ.ɛs
woe is me	woʊ ɪz mi
becoming	bəˈkʌmɪŋ
absolute humidity	ˈæb.səˌlut hjuˈmɪd.ɪ.ti
kramer	ˈkɹeɪmɚ
serotonin	ˌsɛɹəˈtoʊnɪn
highfalutin	ˌhaɪ.fəˈlu.tɨn
legwork	ˈlɛɡ.wɚk
ouroboric	ɔɹəˈbɔɹɪk
blastoderm	ˈblæstəˌdɚm
discern	dɪˈsɝn
discern	dɪˈzɝn
fifo	ˈfaɪ.foʊ
domino	ˈdɑmɪnoʊ
abiogenetical	ˌeɪ.bai.oʊ.ˈdʒɛn.ət.ə.kəl
abortus	əˈbɔɹ.təs
alliteration	əˌlɪtəˈɹeɪʃən
tonsil	ˈtɑn.səl
dominoes	ˈdɑmɪnoʊz
cytologist	saɪˈtɑːlədʒɪst
soc	soʊʃ
soc	sɑk
choral	ˈkɔɹəl
footnote	ˈfʊtˌnoʊt
getting	[ˈɡɛɾɪŋ]
defcon	ˈdɛfkɑn
quetzalcoatl	ˌkɛtsɑːlkoʊˈɑːtəl
memo	ˈmɛmoʊ̯
mizzenmast	ˈmɪz.ənˌmæst
judder	ˈdʒʌdɚ
simper	ˈsɪmpɚ
cosmopolitan	ˌkɑz.məˈpɑl.ɪ.tən
beaker	ˈbiːkɚ
antechamber	ˈæntiˌt͡ʃeɪmbɚ
farther	ˈfɑɹðɚ
waited	ˈweɪ.tɪd
evolutionary	ˌiːvəˈluːʃəneɹi
theologian	θi.əˈloʊdʒən
cannibalistic	kæn.ə.bəˈlɪs.tɪk
shroff	ʃɹɔf
literacy	ˈlɪt.əɹ.ə.si
litterbug	ˈlɪtɚˌbʌɡ
objectively	əbˈdʒɛktɪvli
skanky	ˈskæŋ.ki
thoroughly	θɜːɹ.ə.lɪ
manners	ˈmæn.ɚz
consequently	ˈkɑːnsɪˌkwɛntli
seriously	ˈsɪɹi.əsli
pall mall	ˌpælˈmæl
elliptical	ɪˈlɪp.tɪ.kəl
clarity	ˈklæɹ.ɪ.ti
deflection	dəˈflɛkʃən
eavesdrop	ˈivzˌdɹɑp
continuity	ˌkɑntɪˈn(j)uːəti
perestroika	pɛɹ.ɪˈstɹɔi.kə
proletariat	ˌpɹoʊlɪˈtɛəɹi.ət
lactation	lækˈteɪʃən
phoenician	fəˈniːʃən
phonology	fəˈnɑlədʒi
necco	ˈnɛkoʊ
incisor	ɪnˈsaɪzəɹ
abyssinia	ˌæb.ɪˈsɪn.i.ə
ascertain	ˌæsɚˈteɪn
dover	ˈdoʊvəɹ
compline	ˈkɑːmplɪn
tardis	ˈtɑɹdɪs
warranty	ˈwɔɹ.ən.ti
heliacal	hɪˈlaɪəˌkəl
app	[ʔæʔp̚]
cadaveric	kəˈdavəɹɪk
bicolano	bɪkəˈlɑnoʊ
equivocate	ɪˈkwɪvəˌkeɪt
bitumen	bɪˈtumən
unvoiced	ˌʌnˈvɔɪst
opossum	əˈpɑsəm
proprioception	ˌpɹoʊ.pɹi.oʊˈsɛp.ʃən
gestalt	ɡəˈʃtɔlt
sensitivity	ˌsɛnsɪˈtɪvɪti
bidet	[bɨˈdeɪ]
buttercup	ˈbʌt.ɚ.kʌp
alimony	ˈæ.lɪ.moʊ.ni
tempting	ˈtɛmp.tɪŋ
granule	ˈɡɹænjul
craftsperson	ˈkɹæftspɝsən
seller	ˈsɛlɚ
potash	ˈpɒt.æʃ
monotheistic	ˌmɑnəθiˈɪstɪk
sphericon	ˈsfɪɹ.ə.kɑn
psychological	ˌsaɪkəˈlɑːdʒɪkl
enabled	[ɛnˈeɪbəɫd]
armlet	ˈɑɹmlət
ruined	ɹuːnd
aspirational	ˌæspəˈɹeɪʃənəl
bote	boʊt
borer	ˈbɔːɹɚ
absolute magnitude	ˈæb.səˌlut
absolute magnitude	ˈmæɡ.nɪ.tjud
cold-blooded	ˈkoʊldˈblʌd.ɪd
oriole	ˈɔːriːoʊl
bing	bɪŋ
dishwasher	ˈdɪʃˌwɑʃɚ
animadversion	ˌænɪmædˈvɝːʒən 
overdue	ˌoʊ.vəɹˈdu
reptilian	ɹɛpˈtɪljən
terpsichorean	ˌtɝp.sɪ.kəˈɹiː.ən
squander	ˈskwɑn.dɚ
homer	ˈhoʊməɹ
futtock	ˈfʌtək
artic	ɑɹtɪk
noggin	ˈnɑɡɨn
burdensome	ˈbɝ.dən.səm
goofball	ˈɡufˌbɔl
pin number	ˈpɪn.nʌm.bɝ
asswipe	ˈæswaɪp
northernmost	ˈnɔɹ.ðɚnˌmoʊst
orzo	ˈɔɹzoʊ
petiole	ˈpɛdiˌoʊl
landlord	ˈlænd.lɔɹd
karst	kɑɹst
grotto	ˈɡɹɑ.toʊ
autonomic	ˌɑː.də.ˈnɑː.mɪk
foon	fun
nickel and dime	ˌnɪkəl ən ˈdaɪm
bilious	ˈbɪl.jəs
devanagari	ˌdeɪvəˈnɑɡəɹi
francais	fɹɑnˈseɪ(s)
petrify	ˈpɛ.tɹəˌfaɪ
shouldn't've	ˈʃʊdəntəv
hegemon	ˈhɛ.dʒɛ.mən
synonymous	sɪˈnɑnɪməs
politesse	pɑləˈtɛs
antonymous	ænˈtɑnɪməs
intervocalic	ˌɪntəɹvoʊˈkælɪk
tuk-tuk	tʊk.tʊk
karen	ˈkæɹən
surcingle	ˈsəɹsɪŋɡɫ̩
untoward	ʌnˈtɔɹd
matriculate	məˈtɹɪkjəˌleɪt
tetromino	tɛˈtɹɑːmɪnoʊ
plutocracy	pluːˈtɑːkɹəsi
thaumaturgy	ˈθɔməˌtɜɹdʒi
invoke	ɪnˈvoʊk
anilingus	ˌeɪnɪˈlɪŋɡəs
zoroastrianism	ˌzoʊɹ.oʊˈæs.tɹi.əˌnɪz.əm
zoroastrian	ˌzoʊɹ.oʊˈæs.tɹi.ən
aberrantly	ˌæbˈɛɹ.n̩t.li
abiogenetically	ˌeɪ.bai.oʊˈdʒɛn.ət.ək.ə.li
ablate	əˈbleɪt
ablatival	ˌæb.ləˈtaɪ.v.l̩
theosophy	[θi.ˈɒs.ə.fi]
theosophic	ˌθi.əˈsɑ.fɪk
aegean sea	əˈdʒi.ən ˈsi
ab initio	ˌæb ɪˈnɪʃ.i.oʊ
incongruous	ɪnˈkɑn.ɡɹu.əs
blender	ˈblɛndɚ
weirdo	ˈwɪəɹdoʊ
invitee	ˌɪnvəˈtiː
corkscrew	ˈkɔɹk.skɹu
talmud	ˈtɑlmʊd
biopharming	baɪoʊfɑː(ɹ)mɪŋ
shallot	ˈʃælət
interrogatory	ˌɪntəˈɹɑɡəˌtɔɹi
bona fide	ˈboʊnə.faɪd
onomastic	ˌɑː.noʊˈmæs.tɪk
scared	skɛəɹd
sprawl	spɹɔl
recreation	ɹɛkɹiˈeɪʃən
recreation	ɹiːkɹiˈeɪʃən
indictment	ɪnˈdaɪt.mənt
astigmatism	əˈstɪɡmətɪzm̩
labrador	ˈlæb.ɹə.dɔɹ
garner	ˈɡɑːɹ.nɚ
swat	swɒt
internecine	ˌɪntɚˈnɛsin
restitution	ˌɹɛstɪˈtuʃən
lobotomy	ləˈbɑː.ɾə.mi
germane	dʒɝˈmeɪn
cold abscess	koʊld ˈæbˌsɛs
oblation	oʊˈbleɪʃən
pterosaur	ˈtɛɹəˌsɔɹ
gaudy	ˈɡɔ.di
gordian knot	ˈɡoʊɹdɪən ˈnɑt
unicef	ˈju.nəˌsɛf
parasitic	pɛɹ.əˈsɪt.ɪk
otherworldly	ˌʌðɚˈwɝld.li
embarrassed	ɪmˈbæɹ.əst
violoncello	ˌvaɪələnˈtʃɛloʊ
sensor	ˈsɛn.sɚ
relay	ˌɹiˈleɪ
trojan	ˈtɹoʊdʒən
smear	smiɚ
smear	smɪɚ
loiter	ˈlɔɪtɚ
happily	ˈhæ.pə.li
mash	mæʃ
trojan	ˈtɹoʊd͡ʒən
plateau	plæˈtoʊ
litterateur	ˌlɪtəɹəˈtʊɚ
cotyledon	ˌkɑtəlˈiːdn̩
trophy	ˈtɹoʊfi
forsworn	fɔɹˈswɔɹn
hegelian	həˈɡeɪli.ən
fires	ˈfaɪ̯ɚz
roses	ɹoʊzɨz̥
edgar	ˈɛdɡɚ
whatsoever	ˌ(h)wʌtsoʊˈɛvɚ
danced	dænst
centromere	ˈsɛntɹəˌmiɚ
kinetochore	kəˈniɾoʊkɔɹ
methionine	mɛˈθaɪəˌniːn
bodyguard	ˈbɑːdiɡɑːɹd
rowan	ˈɹaʊ.ən
senile	ˈsinaɪl
effectually	ɪˈfɛktʃuːəli
unexpectedly	ʌnɪkˈspɛktɪdli
incessantly	ɪnˈsɛs.ənt.li
moonlight	ˈmunˌlaɪt
fluorite	flɔɹait
toque	toʊk
profusely	pɹəˈfjusli
collating	ˈkowlejɾɪŋ
collating	kɑˈleɪtɪŋ
firewall	ˈfaɪ(ə)ɹˌwɔl
displeasure	dɪsˈplɛʒɚ
melodic	[mɨˈlɑɾɪk]
interchange	ɪntɚˈtʃeɪndʒ
interchange	ˈɪntɚtʃeɪndʒ
polar	ˈpoʊ̯lɚ
trebuchet	ˈtɹɛb.juˌʃɛt
gird	ɡɝd
constantine	ˈkɒns.tənˌtiːn
manlike	ˈmænlaɪk
voilà	(v)wɑˈlɑ
absolute value	ˈæb.səˌlut ˈvæl.ju
pika	ˈpaɪkə
rarity	ˈɹɛɹ.ə.ti
bastion	ˈbæsti.ən
homologue	ˈhɑːməlɑːɡ
glagolitic	ˌɡlæɡəˈlɪtɪk
peanut butter	ˈpi.nʌtˌbʌ.tɚ
naughty	ˈnɔti
unearthly	ʌnˈɝθ.li
fraught	fɹɔt
miscellany	ˈmɪ.səˌleɪ.ni
crotchety	ˈkɹɑ.tʃɨ.ti
posthaste	ˌpoʊstˈheɪst
dastardly	ˈdæstɚdli
upload	ˈʌpˌloʊd
upload	ˈʌpˌloʊd
reformation	ˌɹɛfɚˈmeɪʃn̩
creeper	ˈkɹipɚ
gallivant	ˈɡæl.ɪ.vænt
gnosticism	ˈnɑstəsɪzəm
derby	ˈdɝ.bi
parti	pɑɹˈtiː
traced	ˈtɹeɪst
differentiate	ˌdɪ.fəˈɹɛnt.ʃi.eɪt
caterwaul	ˈkæt.ɚ.wɔl
cajole	kəˈdʒoʊl
wonky	ˈwɑŋ.ki
endogenous	ɨnˈdɑdʒənəs
enroll	ɛnˈɹoʊl
emissary	ˈɛmɪˌsɛɹi
chomp	t͡ʃɔmp
organs	ˈɔɹ.ɡənz
allergies	[ˈæl.ɚ.dʒiz]
how're	haʊɚ
inventory	ˈɪn.vənˌtɔ.ɹi
presumptuous	pɹəˈzəmptʃuəs
babysitter	ˈbeɪbiˌsɪtɚ
xerxes	ˈzɝksiːz
pilchard	ˈpɪl.tʃɚd
spots	spɑts
schnapper	ˈʃnæpɚ
sceptre	ˈsɛptɚ
peaked	ˈpi.kɪd
disenchant	ˌdɪsɪnˈtʃænt
recollect	ɹɛkəˈlɛkt
recollect	ɹiːkəˈlɛkt
naysayer	ˈneɪ.ˌseɪ.ɚ
morals	ˈmɔɹəlz
skewer	ˈskjuəɹ
boggle	ˈbɑ.ɡəl
powdered sugar	ˈpaʊ.dɚd ˈʃʊɡ.ɚ
chardonnay	ˌʃɑɹ.dnˈeɪ
demos	ˈdɛmoʊs
formalism	ˈfɔɹml̩ˌɪzm̩
kinesthesia	ˌkɪnɪsˈθiʒə
alfresco	ælˈfɹɛs.koʊ
sheets	ʃits
bullfrog	ˈbʊlfɹɑɡ
jesse	ˈd͡ʒɛ.si
pronate	ˈpɹoʊ.neɪt
alabaster	ˈæl.əˌbæs.tɚ
halo-halo	ˌhɑloʊˈhɑloʊ
himbo	ˈhɪmboʊ
rococo	ɹəˈkəʊkəʊ
coon	kun
mallow	ˈmæloʊ
liverwort	ˈlɪv.ɚ.wɝːt
realpolitik	ɹeɪˈɑlpoʊlɪˌtik
financier	f(a)ɪnænˈsɪəɹ
quantify	ˈkwɑːn.tə.faɪ
scofflaw	ˈskɔfˌlɔ
screech	[skɹitʃ]
halfway	hæfweɪ
theropoda	θiɹ.əˈpɑː.da
saturnalia	ˌsætɚˈneɪli.ə
madden	ˈmædən
showcase	ˈʃoʊˌkeɪs
insurgency	ɪnˈsɝ.dʒən.si
for crying out loud	fɚ ˈkɹaɪ.ɪŋ aʊt ˌlaʊd
epidemiology	ˌɛp.ɪˌdi.miˈɒl.ə.dʒi
metathesis	mə.ˈtæ.θə.sɪs
lobby	lɑbi
bathrobe	ˈbæθ.ɹoʊb
sophomore	ˈsɑfmɔɹ
bittersweet	ˈbɪtɚˌswit
h₂o	ˌeɪtʃtuːˈoʊ
adenosine	əˈdɛnəˌsin
bonfire	ˈbɔn.ˌfaɪ.ɚ
hugo	ˈhjuɡoʊ
bruno	ˈbɹunoʊ
lordship	ˈlɔɹd.ʃɪp
abies	ˈeɪ.biˌiz
francophobia	ˈfɹæŋ.kəˈfoʊ.bi.ə
upper class	ˌʌpɚˈklæs
meritocracy	mɛɹəˈtɑkɹəsi
upper-class	ˈʌpɚˌklæs
pannier	ˈpæn.i.ɚ
mammalian	məˈmeɪl.jən
ogive	ˈoʊɡaɪv
bone-eating snot flower worm	boʊn itɪŋ ˈsnɑt flaʊɚ wɝm
johnny-come-lately	ˌdʒɑːni.kʌmˈleɪtli
hillbilly	ˈhɪlbɪli
throng	θɹɔŋ
crochet	kɹoʊˈʃeɪ
ichor	ˈaɪkɔɹ
absorption band	æbˈsɔɹp.ʃn̩ bænd
maunder	ˈmɔndɚ
dipper	ˈdɪpɚ
plonk	plɑŋk
honshu	ˈhɑnʃu
recoup	ɹɪˈkuːp
rotunda	ɹoʊˈtʌndə
modernize	ˈmɑdɚnaɪz
moggy	ˈmɑɡi
mown	moʊn
dubonnet	ˌdjuːbəˈneɪ
unremitting	ˌʌnɹɪˈmɪɾɪŋ
magnify	ˈmæɡnɪfaɪ
phenomenology	fɪˌnɑməˈnɑləɡi
opalescent	oʊpəlɛsənt
anadromous	əˈnæd.ɹə.məs
have to	ˈhæf.tu
stenographer	stəˈnɑɡɹəfəɹ
pro-	pɹoʊ
vexillology	ˌvɛksəˈlɑːlədʒi
overpower	oʊ.vɚˈpaʊ̯.ɚ
overshadow	ˌoʊ.vɚˈʃæd.oʊ
prance	pɹæn(t)s
oeuvre	ˈəːvɹə
expedite	ˈɛk.spɪˌdaɪt
deformity	dɪˈfɔɹmət̪i
dishonor	dɪsˈɑnəɹ
dishearten	dɪsˈhɑɹ.tən
m'kay	mːˈkeɪ
absence seizure	ˈæb.sn̩s ˈsi.ʒɚ
peppermint	ˈpɛpɚˌmɪnt
spearmint	ˈspɪɹˌmɪnt
endomorph	ˈɛndoʊmɔːɹf
ectomorph	ˈɛktoʊmɔːɹf
irwin	ˈɝwɪn
jeroboam	ˌdʒɛɹəˈboʊəm
lat	lɑt
humanities	hjuˈmæn.ɪ.tiz
goblin	ˈɡɑb.lɪn
corncrake	ˈkɔrnˌkreɪk
absorption coefficient	æbˈsɔɹp.ʃn̩ ˌkoʊ.əˈfɪʃ.n̩t
rowlock	ˈɹɑlək
mirandize	mɪˈɹændaɪz
oxytone	ˈɑksɪˌtoʊn
oxytones	ˈɑksɪˌtoʊnz
pasha	ˈpɑʃə
listening	ˈlɪs.nɪŋ
colliery	ˈkɑl.jɚ.ɪ
zouave	zuˈɑv
fatherhood	ˈfɑ.ðɚˌhʊd
chaise lounge	ˌʃeɪz ˈlaʊndʒ
epicure	ˈɛpɪkjʊɹ
hipster	ˈhɪp.stɚ
exegete	ˈɛksɪdʒit
endoscopy	ɛnˈdɔ.skə.pi
colonoscopy	kɑləˈnɑskəpi
calva	ˈkɑlvə
linoleum	lɪˈnoʊli.əm
koan	ˈkoʊ.ɑn
corrosion	kəˈɹoʊʒən
busto	ˈbʌstoʊ
coffer	ˈkɔfɚ
productivity	ˌpɹoʊdʌkˈtɪvəti
jocund	ˈdʒɑkənd
contranym	ˈkɑn.tɹə.nɪm
corposant	ˈkɔːɹpəˌsænt
seminary	ˈsɛmənɛɹi
ve	vi
dongle	ˈdɑŋɡl̩
pores	pɔɹz
abrazo	əˈbɹɑˌsoʊ
authorize	ˈɔθəɹaɪz
rosé	ɹoʊ̯ˈzeɪ̯
added	[ˈæɾ.əd]
buttocks	ˈbʌtəks
agon	ˈæ.ɡoʊn
señora	seɪˈnjɔːɹə
duh	dʌ
psychosomatic	ˌsaɪkoʊsəˈmædɪk
prod	pɹɑd
cougar	ˈkuɡɚ
bowtie	boʊˈtaɪ
attar	[ˈæt̬.əɹ]
nears	nɪɹz
nares	[ˈneɹiːz]
nares	[ˈnæɹiːz]
coronel	ˈkɔɹ(ə)nəl
gurgitator	ˈɡɝ.dʒə.teɪ.tɚ
histrionics	hɪstɹiˈɑnɪks
birr	bɝ
birr	bɪəɹ
egalitarian	ɪˌɡæl.ɪˈtɛɹ.i.ən
ores	ɔɹz
oars	ɔɹz
inferno	ɪnˈfɝnoʊ
lawman	ˈlɔmæn
ligature	ˈlɪɡətʃɚ
kore	ˈkoɹeɪ
moonraker	ˈmuːn.ɹeɪ.kɚ
lycian	ˈlɪsi.ən
leitmotif	ˈlaɪt.moʊˌtif
leitmotif	ˈleɪt.moʊˌtif
moan	moʊn
politic	ˈpɑlətɪk
mediate	ˈmidieɪt
mediate	ˈmidi.ət
darius	dəˈɹaɪ.əs
piebald	ˈpaɪ.bɔld
nectar	ˈnɛk.təɹ
plotz	ˈplɑts
heartbreak	hɑɹt.bɹeɪk
pwn	pɔn
hummingbird	ˈhʌmɪŋˌbɝd
microscopic	ˌmaɪkɹəˈskɑpɪk
spoilsport	ˈspɔɪl.spɔɹt
short-lived	ʃɔɹtˈlɪvd
resources	ˈɹi.sɔɹsɨz
thorny	ˈθɔɹni
bearded	ˈbɪɹdəd
golden age	ˈɡoʊl.dən eɪd͡ʒ
micrometer	ˈmaɪkɹoʊmiːtɚ
micrometer	maɪˈkɹɑmɪtɚ
jonquil	ˈdʒɑŋkwəl
marinade	ˌmɛɹɪˈneɪd
gyrfalcon	ˈdʒɝˌfælkən
doggy style	ˈdɔ.ɡi staɪl
dumbfound	ˈdʌm.faʊnd
credentialism	kɹəˈdɛn.ʃə.lɪ.zəm
eschaton	ˈɛskəˌtɑn
homer	ˈhoʊməɹ
isomerize	aɪˈsɑməˌɹaɪz
lese majesty	liz ˈmædʒəsti
bavarois	ˌbɑvɚˈwɑ
tudor	ˈtuːdəɹ
archeology	ˌɑɹ.kɪˈɒl.ɘ.dʒɪ
bodybuilding	ˈbɑːdiˌbɪldɪŋ
defined	dɪˈfaɪnd
bodybuilder	ˈbɑː.diˌbɪl.dɚ
mesomorph	ˈmɛzoʊmɔːɹf
macaroon	ˌmæk.əˈɹun
contest shape	ˈkɑːntɛst ˌʃeɪp
nomad	ˈnoʊmæd
abonné	æˈbɔ.ne
isomorphic	ˌaɪ.soʊˈmɔɹ.fɪk
tithing	ˈtaɪðɪŋ
blackthorn	ˈblækˌθɔɹn
flurry	ˈflɝ.ɹi
molly-guard	ˈmɑli ɡɑɹd
disorientation	dɪs.ˌɔ.ɹi.ɪn.ˈtei.ʃn̩
hawthorn	ˈhɔ.θɔɹn
mazel tov	ˈmɑz(ə)lˌtɔf
beta blocker	ˈbeɪ.tə ˈblɔk.ɚ
whitebeam	ˈwaɪtˌbim
peristyle	ˈpɛɹəstaɪl
teratophilia	ˈtɛɹ.ə.tə.fɪl.i.ə
teratophiliac	ˈtɛɹ.ə.təˌfɪl.i.æk
named	ˈneɪmd
accepted	æk.ˈsɛp.tɪd
allomorph	ˈæl.oʊ.mɔɹf
myrtle	ˈmɝtəl
stopped	stɑpt
olivia	oʊˈlɪvi.ə
cassock	ˈkæsək
flowers	ˈflaʊ.ɚz
homogeneity	ˌhoʊ.mə.dʒəˈniː.ə.ti
protozoan	ˌpɹoʊtəˈzoʊən
tyrannical	tɪˈɹæ.nɪ.kəl
otoscope	ˈoʊ̯ɾəskoʊ̯p
saline	ˈseɪliːn
apheresis	əˈfɛɹəsɪs
apheresis	ˌæfəˈɹisɪs
incendiary	ɪnˈsɛn.di.ɛɹ.i
myrrh	[mɝ]
prerogative	pɹəˈɹɑɡ.ə.tɪv
cavort	kəˈvɔɹt
aborigine	ˌæb.əˈɹɪdʒ.ɪ.ni
yarrow	ˈjæɹoʊ
abseil	ˈɑpˌzaɪl
gastric	ˈɡæstɹɪk
chervil	ˈtʃɜː(ɹ)vɪl
flibbertigibbet	ˈflɪbɚtiˌdʒɪbɪt
herbaceous	hɝˈbeɪ.ʃəs
dewberry	ˈduˌbɛɹi
bouncy castle	ˌbaʊnsi ˈkæsəl
undue	ʌnˈduː
stormy	ˈstɔɹmi
sauté	soʊˈteɪ
toxicomania	ˌtɑksɪkoʊˈmeɪniə
otology	oʊˈtɑlədʒi
brazier	ˈbɹeɪ.ʒɚ
fluor	fluɔɹ
pythons	ˈpaɪ.θɑnz
documentary	ˌdɑ.kjəˈmɛn.(tɚ.)ɹi
academese	ə.kæ.dəˈmiz
back road	ˈbæk ˌɹoʊd
suppository	səˈpɑzɪˌtɔɹi
katharevousa	ˌkɑθəˈɹɛvusɑ
livelihood	ˈlaɪvlihʊd
persian gulf	ˌpɝʒən ˈɡʌlf
beech mast	ˈbitʃˌmæst
propitiatory	pɹəˈpɪʃi.əˌtɔɹi
oakley	ˈoʊkli
clemency	ˈklɛ.mən.si
cell wall	sɛl wɔːl
nosy	ˈnoʊzi
eardrum	ˈiɚˌdɹʌm
breviary	ˈbɹɛv.i.ɛɹ.i
collocation	ˌkɔ.lə.ˈkeɪ.ʃən
sumptuary	ˈsʌm(p)tjuˌɛɹi
dogs	dɔɡz
rendezvous	ˈɹɑndəˌvu
popinjay	ˈpɑpənˌdʒeɪ
condescending	ˌkɑndəˈsɛndɪŋ
reduced	ɹɪˈdust
reduced	ɹɪˈdjust
agronomist	əˈɡɹɑːnəmɪst
agronomy	əˈɡɹɑːnəmi
processing	ˈpɹɑsəsɪŋ
pastille	pæsˈtil
craig	kɹɛɡ
torrential	tɔˈɹɛnt.ʃəl
cellar	ˈsɛlɚ
reconnoiter	ˌɹɛkəˈnɔɪtɚ
demanding	dəˈmændɪŋ
deputize	ˈdɛpjutaɪz
scallop	ˈskɒləp
postscript	ˈpoʊst.skɹɪpt
feverish	ˈfi.vɚ.ɪʃ
ovarian	oʊˈvɛɹi.ən
tiramisu	ˌtɪɹəˈmisu
aromanian	æɹoʊˈmeɪniən
furbelow	ˈfɚ.bɪ.loʊ
activism	ˈæk.tɪ.vɪz.m̩
knock on wood	ˌnɑk ɑn ˈwʊd
miskito	ˈmɪs.kɪ.toʊ
nonpareil	nɑnpəˈɹɛl
phosphor	ˈfɑsfɚ
dalliance	ˈdæli.əns
empyreal	ɛmˈpɪɹ.i.əl
hyperbolic	ˌhaɪpɚˈbɑlɪk
chastity	ˈtʃæstɪti
depot	ˈdiːpoʊ
stocks	stɑks
grows	ɡɹoʊz
denied	dɪˈnaɪd
pleroma	pləˈɹoʊmə
songs	sɑŋz
pooh	puː
cordovan	ˈkɔːɹdəvən
córdoba	ˈkɔːɹdəbə
absorbed dose	æbˈsɔɹbd doʊs
pooh	pu
goombah	ˈɡumbɑ
intercalary	ˌɪnt.ɚˈkæl.ɚ.i
seignior	ˈsiːnjɚ
upwards	ˈʌpwɚdz
parasang	ˈpɛɹəsæŋ
reemerge	ɹi.i.ˈmɝdʒ
packing	ˈpækɪŋ
flaneur	flɑˈnʊɚ
fucking a	ˈfʌ.kɪnˌeɪ
zesty	ˈzɛsti
post-	poʊst
soufflé	suːˈfleɪ
finely	ˈfaɪnli
pianoforte	piˈænəfɔɹt
laptop	ˈlæp.tɑp
kosovo	ˈkɔsəˌvoʊ
carpetbagger	ˈkɑɹpɪtˌbæɡɚ
overstep	ˌoʊvɚˈstɛp
macadamia	mækəˈdeɪmi.ə
colander	ˈkɑləndəɹ
madreporite	ˌmædɹəˈpɔɹaɪt
jester	ˈdʒɛs.tɚ
fallout	ˈfɔlˌaʊt
magnification	ˌmæɡnɪfɪˈkeɪʃən
jasmine	ˈdʒæzmɪn
revanchist	ɹəˈvɑn(t)ʃɪst
revanche	ɹəˈvæntʃ
glassy	ɡlæsi
bellows	ˈbɛl.oʊz
nether	nɛð.ɚ
stardust	ˈstɑɹ.dʌst
aboulia	ə.ˈbu.li.ə
cnidarian	nʌɪˈdɛːɹɪən
at all	[æˈɾɔɫ]
crouton	ˈkɹuːtɑːn
catechumen	ˌkæt.əˈkju.mən
hottie	ˈhä.ɾi
flair	flɛɚ̯
amniotic	æmniˈɑːtɪk
extroverted	ˈɛkstɹəˌvəɹtɪd
gloucester	ˈɡlɑstɚ
economical	ˌɛkəˈnɑmɪkəl
informant	ɪnˈfɔɹmənt
jerkin	ˈdʒɜɹ.kɪn
superstitious	ˌs(j)u.pɚˈstɪ.ʃəs
reversion	ɹɨˈvɚʒn̩
reversionary	ɹəˈvɝʒəˌnɛɹi
spontaneously	spɑnˈteɪ.ni.əs.li
swimmer	ˈswɪm.ɚ
dacian	ˈdeɪʃən
dacia	ˈdeɪʃə
margarine	ˈmɑɹ.dʒə.ɹɪn
whatnot	ˈwʌt.nɒt
disembogue	ˌdɪs.ɪmˈboʊɡ
dwimmer	ˈdwɪmɚ
concierge	ˌkɑn.siˈɛɹʒ
robin hood	ˈɹɑbɪn hʊd
serval	ˈsɝvəl
zygodactylous	ˌzeɪɡoʊˈdæktələs
subaltern	sʌbˈɔltərn
subaltern	ˈsʌbəltɚn
coenocyte	ˈsiː.noʊˌseɪt
latex	ˈleɪˌtɛks
poems	ˈpoʊ.əmz
horus	[hɔːɹəs]
falciform	ˈfæl.sɪ.fɔɹm
psittacosis	ˌsitəˈkoʊsɨs
ephraim	ˈifɹi.əm
hypostasis	haɪˈpɑstəsɪs
bonobo	bəˈnoʊ̯ˌboʊ̯
newtonian	n(j)uˈtoʊniən
purported	pəɹˈpɔɹ.tɪd
losel	ˈloʊzəl
manometer	məˈnɑmədəɹ
combine harvester	ˈkɑmˌbaɪn ˈhɑɹvəstəɹ
narcosis	nɑɹˈkoʊ.sɪs
superintendent	ˌsjuːpəɹɪnˈtɛndənt
withal	wɪˈðɑl
mansuetude	mænˈsuət(j)ud
margrave	ˈmɑɹɡɹeɪv
narcissistic	ˌnɑɹ.sɨˈsɪs.tɪk
throw back	θɹoʊ ˈbæk
throwback	ˈθɹoʊ.bæk
moliminous	moʊˈlɪmɪnəs
thunderstruck	ˈθʌn.dɚ.stɹʌk
tiber	ˈtaɪbəɹ
conversationalist	ˌkɑːnvɚˈseɪʃənəlɪst
sleuth	sluːθ
hosiery	ˈhoʊʒəɹi
ovulation	ɑvjəˈleɪʃ(ə)n
tote	toʊt
nefandous	nəˈfændəs
ort	ɔːɹt
barfly	bɑɹflaɪ
snowshoe	ˈsnoʊʃu
cartesian	kɑɹˈti.ʒən
birthplace	ˈbɝθˌpleɪs
abutting	əˈbʌt.ɪŋ
livery	ˈlɪv.ə.ɹi
toffee	ˈtɔfi
celeste	səˈlɛst
prologue	ˈpɹoʊlɔɡ
karmic	ˈkɑɹmɪk
tugboat	ˈtʌɡboʊt
niggard	[ˈnɪɡɚd]
insufferable	ɪnˈsʌfɚəbəl
abstract of title	æbˈstɹækt
abstract of title	ɑv
abstract of title	ˈtaɪ.tl̩
glasshouse	ˈɡlæshaʊs
clavichord	ˈklæv.ɪˌkɔɹd
abduced	æb.ˈdust
abled	ˈeɪ.bl̩d
abreact	ˌæb.ɹiˈækt
absolutise	ˈæb.sə.lu.taɪz
comedienne	kəˌmiːdiˈɛn
poncho	ˈpɑn.tʃoʊ
prosody	ˈpɹɑzədi
lopsided	ˈlɑp.saɪ.dɪd
khoisan	ˈkɔɪˌsɑn
forehand	fɔːɹhænd
consul	ˈkɑn.səl
pot calling the kettle black	ˈpɑt ˈkɔliŋ ðə ˈkɛtl̩ ˈblæk
chowder	ˈtʃaʊdɚ
procedures	pɹəˈsidʒɚs
ancestors	ˈæn.sɛs.tɚz
loading	ˈloʊ.diŋ
high school	ˈhaɪ.skul
panther	ˈpænθɚ
metaphorical	ˌmɛtəˈfɔːɹɪkəl
shinto	ˈʃɪn.toʊ
beaner	ˈbinɚ
glimmer	ˈɡlɪmɚ
flicker	ˈflɪkɚ
forecastle	ˈfoʊkˌsəl
crumble	ˈkɹʌmbəl
biparous	ˈbɪp.ə.ɹəs
honorific	ˌɑːnəˈɹɪfɪk
wrongly	ˈɹɔŋli
spurn	spɚn
anamorphic	ˌænəˈmɔɹfɪk
loneliness	ˈloʊnlinəs
periphrastic	ˌpɛ.ɹəˈfɹæ.stɪk
stockade	ˌstɑˈkeɪd
box office	ˈbɑksˌɑfɪs
consequent	ˈkɑn.sɪ.kwənt
dimorphic	ˌdaɪˈmɔɹfɪk
pyroxene	paɪˈɹɑksin
promenade	pɹɑməˈneɪd
frænulum	ˈfɹiːnjələm
fraenum	ˈfɹiːnəm
frænum	ˈfɹiːnəm
aight	ˈaˌɐɪt
keynote	ˈkiːˌnoʊt
kiloton	ˈkɪləˌtʌn
aberdeen angus	ˌæb.ɚˈdin ˈæŋ.ɡəs
kitty-corner	ˈkɪdiˌkɔɹnəɹ
katydid	ˈkeɪtiˌdɪd
crème de menthe	ˌkɹɛmdəˈmɑnt
ultralight	ˌʌltɹəˈlaɪt
anarchic	ænˈɑɹ.kɪk
watergate	ˈwɑtəɹˌɡeɪt
ufology	ˌjuːˈfɑlədʒi
ufologist	ˌjuːˈfɑlədʒɪst
setswana	sɛtˈswɑnə
tsatske	ˈtsɑtskə
scholastic	skəˈlæstɪk
scholasticism	skəˈlæstɪˌsɪzəm
prep school	ˈpɹɛpˌskuːl
preppy	ˈpɹɛpi
subscriber	səbˈskɹaɪbəɹ
phyllo	ˈfiːloʊ 
unstinting	ʌnˈstɪntɪŋ
doggedly	ˈdɔɡədli
misconception	ˌmɪskənˈsɛp.ʃən
retract	ɹəˈtɹækt
uncleanly	ʌnˈklɛnli
uncleanly	ʌnˈkliːnli
bonspiel	ˈbɑnspiːl
séance	ˈseɪˌɑns
seance	ˈseɪˌɑns
saint bernard	ˈseɪnt bəɹˈnɑɹd
massless	ˈmæsləs
icebreaker	ˈaɪsˌbɹeɪkəɹ
idolater	ˌaɪˈdɑlətəɹ
illustrator	ˈɪləˌstɹeɪtəɹ
immaterial	ˌɪməˈtɪɹi.əl
oligopoly	ɑlɪˈɡɑpəli
miller	ˈmɪlɚ
anderson	ˈæn.dɚ.sən
powell	ˈpaʊ.(w)əl
chapman	ˈtʃæpmən
asphalt	ˈæsfɔlt
quarterstaff	ˈkwɔɹtəɹˌstæf
quoits	kɔɪts
quadrennial	ˌkwɑˈdɹɛni.əl
offertory	ˈɑfəɹˌtɔɹi
offhandedly	ˌɑfˈhændədli
offhandedness	ˌɑfˈhændədnəs
sapsucker	ˈsæpˌsʌkəɹ
offload	ˌɑfˈloʊd
ogress	ˈoʊɡɹɛs
hagiographer	ˌheɪdʒiˈɑɡɹəfəɹ
habiliment	həˈbɪlɪmənt
hairline	ˈhɛɹˌlaɪn
hackles	ˈhækəlz
hallow	ˈhæloʊ
hydrofoil	ˈhaɪ.dɹoʊˌfɔɪl
blasted	ˈblæst.ɪd
stenography	stəˈnɑɡɹəfi
steno	ˈstɛnoʊ
iliad	ˈɪliˌæd
face-off	ˈfeɪsˌɑf
refereed	ˌɹɛfəˈɹiːd
turnstile	ˈtɝnstaɪl
canister	ˈkænɪstɚ
would've	ˈwʊdəv
repartee	ˌɹɛpɑɹˈteɪ
eccentricity	ˌɛk.sɛnˈtɹɪs.ɪ.ti
osiris	oʊˈsaɪɹɪs
caterer	ˈkeɪtəɹəɹ
bygones	ˈbaɪˌɡɑnz
prosecutor	ˈpɹɑsəˌkjuːtəɹ
timberline	ˈtɪmbɚˌlaɪn
tatters	ˈtætɚz
briefcase	ˈbɹiːfˌkeɪs
psychagogic	ˌsaɪ.kəˈɡɑ.dʒɪk
hallowmas	ˈhæloʊməs
pops	pɑps
ponytail	ˈpoʊniˌteɪl
memoirs	ˈmɛmˌwɑɹz
hideaway	ˈhaɪdəˌweɪ
gynecology	ˌɡaɪnəˈkɑlədʒi
roundworm	ˈɹaʊndˌwɝm
marmoset	ˈmɑɹməsət
bananas	bəˈnænəz
birdbrain	ˈbɚd.bɹeɪn
gabfest	ˈɡæbˌfɛst
gadgetry	ˈɡædʒətɹi
ganglia	ˈɡæŋɡli.ə
gangrene	ˈɡæŋˌɡɹin
stomp	stɑmp
gargle	ˈɡɑɹɡəl
gelcap	ˈdʒɛlˌkæp
dimmer	ˈdɪməɹ
dingbat	ˈdɪŋˌbæt
diocesan	daɪˈɑsɪsən
archdiocese	ˌɑɹtʃˈdaɪəsɪs
archdiocesan	ˌɑɹtʃˌdaɪˈɑsɪsən
cakewalk	ˈkeɪk.wɔk
mimosa	mɪˈmoʊ.sə
typecast	ˈtaɪp.kæst
scrawny	ˈskrɔni
episodic	ˌɛpɪˈsɑdɪk
rearward	ˈɹiɹ.wɝ d
formulaic	ˌfɔɹmjəˈleɪ.ɪk
trickery	tɹɪ.kə.ɹi
gertrude	ˈɡɝtɹud
carjack	ˈkɑɹ.dʒæk
rotarian	ɹoʊˈtɛɹ.i.ən
buzzer	ˈbʌzəɹ
regroup	ɹiˈɡɹuːp
midterm	ˈmɪdˌtəɹm
ossetic	ɑːˈsetɪk
ossetian	ɑːˈseti.ən
oceanographer	ˌoʃəˈnɑɡɹəfəɹ
oceanographic	ˌoʃənəˈɡɹæfɪk
opportunistic	ˌɑpəɹˌtuːˈnɪstɪk
orangutang	əˈɹæŋ.uˌtæŋ
overshoe	ˈoʊvəɹˌʃuː
outtake	ˈaʊtˌteɪk
zinfandel	ˈzɪnfn̩dɛl
shamrock	ˈʃæm.ɹɑk
capricorn	ˈkæpɹɪkɔːɹn
soigné	swɑˈnjeɪ
abkhazia	æbˈkeɪ.ʒi.ə
envoy	ˈɛn.vɔɪ
tansy	ˈtæn.zi
tannery	ˈtænəɹi
taproot	ˈtæpˌɹuːt
toasty	ˈtoʊsti
tipi	ˈtiːpi
teepee	ˈtiːpi
teleprompter	ˈtɛləˌpɹɑmptəɹ
teleplay	ˈtɛləˌpleɪ
screenplay	ˈskɹiːnˌpleɪ
oftentimes	ˈɔf.ənˌtaɪmz
bailout	ˈbeɪlˌaʊt
buffyverse	ˈbʌfiˌvɝs
excise	əkˈsaɪz
pleiades	ˈpliːədiːz
flivver	ˈflɪ.vɚ
operationalize	ˌɑpəˈɹeɪʃənəˌlaɪz
lilliputian	ˌlɪlɪˈpjuʃən
geological	ˌdʒi.əˈlɑdʒ.ɪk.əl
hardscrabble	ˈhɑɹdˌskɹæbəl
harlequin	ˈhɑɹlɪkwɪn
harum-scarum	ˌhɛəɹəmˈskɛəɹəm
embezzle	əmˈbɛzəl
embezzler	əmˈbɛzləɹ
empathize	ˈɛmpəˌθaɪz
bombardier	ˌbɑm.bɚˈdɪɚ
endmost	ˈɛndˌmoʊst
earldom	ˈəɹldəm
earthen	ˈəɹθən
dumbledore	ˈdʌm.bəl.dɔːɹ
macaronic	ˌmækəˈɹɑnɪk
persimmon	pəɹˈsɪmən
shutter	ˈʃʌtɚ
organum	ˈɔɹ.ɡə.nəm
prophesy	ˈpɹɑfɪsaɪ
centerfold	ˈsɛntɚfoʊld
could've	ˈkʊdəv
mickey	ˈmɪki
beers	biɹz
zealotry	ˈzɛlətɹi
whatcha	ˈwʌtʃə
yellowy	ˈjɛloʊ.i
yeomanry	ˈjoʊmənɹi
yeshiva	jəˈʃiː.və
yipe	jaɪp
yippee	ˌjɪ.ˈpi
shipment	ˈʃɪpmənt
zooplasty	[ˈzoʊ.ə.ˌplæs.ti]
salish	ˈseɪ.lɪʃ
reschedule	ɹiˈskɛdʒʊl
legit	ləˈdʒɪt
survivor	sɚˈvaɪvɚ
yuan	ˌjuːˈɑn
dower	[ˈdaʊ.ɚ]
jurist	ˈdʒəɹ.ɪst
illogic	ɪˈlɑdʒɪk
indisposition	ɪnˌdɪspəˈzɪʃən
inapposite	ɪnˈæpəzɪt
inelastic	ˌɪnəˈlæstɪk
inherently	ɪnˈhɛɹəntli
importunity	ˌɪmpɔɹˈtuːnɪti
mollycoddle	ˈmɑl.iˌkɑd.əl
incautious	ɪnˈkɑʃəs
inappreciable	ˌɪnəˈpɹiːʃəbəl
jocularity	ˌdʒɑkjəˈlɛɹɪti
laic	ˈleɪ.ɪk
misconceive	ˌmɪskənˈsiːv
monologic	ˌmɑnəˈlɑdʒɪk
ranger	ˈɹeɪndʒɚ
elope	ɨˈloʊp
consulate	ˈkɑnsəlɨt
mafia	ˈmɑfi.ə
boathouse	ˈboʊtˌhaʊs
miscarriage	ˈmɪs.kæɹ.ədʒ
houseboat	ˈhaʊsˌboʊt
drummer	ˈdɹʌmɚ
prof	pɹɑf
subsidy	ˈsʌbsɨdi
insulin	ˈɪnsəlɪn
backless	ˈbækləs
backmost	ˈbækˌmoʊst
xiphoid process	ˈzɪˌfɔɪd ˈpɹɑˌsɛs
damnable	ˈdæmnəbəl
boff	bɒf
briquet	bɹɪˈkɛt
censorial	ˌsɛnˈsɔɹi.əl
concessionary	kənˈsɛʃəˌnɛɹi
concessionaire	kənˌsɛʃəˈnɛɹ
crimination	ˌkɹɪmɪˈneɪʃən
curdle	ˈkɝ.dəl
decrepitude	dɘˈkɹɛpɪˌtuːd
demission	dəˈmɪʃən
demiurgic	ˌdɛmiˈɝ.dʒɪk
derange	diˈɹeɪndʒ
desuetude	dəˈsuːəˌtuːd
diplomatist	dɪˈploʊməˌtɪst
disutility	ˌdɪsjuːˈtɪlɪti
jainism	ˈdʒeɪnɪzm̩
debonair	dɛbəˈnɛɹ
dermatophyte	dɚˈmæt.oʊ.faɪt
xenodochium	ˌzɛn.oʊˈdoʊ.ki.əm
clip-clop	ˈklɪp.klɑːp
entr'acte	ˈɑnˌtɹækt
swath	swɑθ
foreclose	ˌfɔɹˈkloʊz
froward	ˈfɹoʊ.ɚd
abkhaz	ɑbˈkɑz
baryta	bə.ˈɹaɪ.tə
cohesive	koʊˈhiː.sɪv
spectrogram	ˈspɛktɹəˌɡɹæm
spectrograph	ˈspɛktɹəˌɡɹæf
portrayal	ˌpɔɹˈtɹeɪ.əl
profligacy	ˈpɹɑflɪɡəsi
prosthetic	ˌpɹɑsˈθɛtɪk
scandalous	ˈskændələs
preaspiration	ˌpɹiːˌæspəˈɹeɪʃən
copywriter	ˈkɑːpiˌɹaɪɾɚ
mascot	ˈmæsˌkɑːt
loudspeaker	ˈlaʊdspiːkɚ
matting	ˈmætɪŋ
leastways	ˈliːstˌweɪz
orgiastic	ˌɔɹdʒiˈæstɪk
discretionary	dɪsˈkɹɛʃəˌnɛɹi
appointee	əˌpoɪnˈtiː
low-key	ˈloʊki
paramilitary	ˌpɛɹəˈmɪlɪˌtɛɹi
parietal lobe	pəˈɹaɪətəl ˌloʊb
occipital lobe	ˌɑkˈsɪpɪtəl ˌloʊb
caretaker	ˈkɛɹˌteɪ.kɚ
rath	ɹæθ
fustic	ˈfʌstɪk
downwards	ˈdaʊnwɚdz
sabir	sɑˈbiɹ
sabir	sɑˈbiɹ
clerks	klɝks
stencil	ˈstɛnsəl
insensitive	ɪnˈsɛnsɪtɪv
splenetic	spləˈnɛtɪk
vaporous	ˈveɪpəɹəs
versatility	ˌvəɹsəˈtɪlɪti
viability	ˌvaɪəˈbɪlɪti
pretence	ˈpɹiːtɛns
sciamachy	saɪˈæməki
rawhide	ˈɹɔhaɪd
lollipop	lɑ.li.pɑp
braxton	ˈbɹækstən
emboss	ɪmˈbɑs
y'know	jəˈnoʊ
ableism	ˈeɪ.bəl.ɪz.m̩
bountiful	[ˈbaʊ̯n(ɾ)əfəɫ]
supinate	ˈsuː.pəˌneɪt
kumbaya	ˌkum.baɪˈjɑ
epiphenomenon	ˌɛp.ə.fəˈnɒm.əˌnɒn
maxwell	ˈmækswɛl
realtor	ˈɹi(ə)l.təɹ
abolitionary	æb.əˈlɪʃ.əˌnɛɹ.i
herculean	hɜːɹˈkjuːliən
homeostatic	ˌhoʊmioʊˈstætɪk
spandex	ˈspændɛks
hustler	ˈhʌsləɹ
spurge	spɝdʒ
herpes	ˈhɝ.piz
holier	ˈhoʊliɚ
holier	ˈhoʊliɚ
heirloom	ˈɛəɹ.lum
munchkin	ˈmʌntʃkɪn
commandant	ˈkɒməndænt
burdock	ˈbɝːdɑːk
polymorphic	ˌpɑliˈmɔɹfɪk
hotdog	ˈhɑtdɑɡ
sega	ˈseɪ.ɡə
okina	oʊˈkinə
governess	ˈɡʌvɚnəs
sprinkler	ˈspɹiŋklɚ
geophyte	ˈdʒioʊˌfaɪt
punctual	ˈpʌŋktʃuəl
solar system	ˈsoʊ.lɚ ˌsɪs.təm
abuttals	əˈbʌt.l̩z
computers	kəmˈpjutɚs
talmudic	tɑlˈmʊdɪk
fallow	ˈfæloʊ
bacne	ˈbækni
swirl	swɜrl
lasagne	ləˈzɑn.jə
wonderland	ˈwʌndɚˌlænd
cougher	ˈkɔfɚ
bubby	ˈbubi
badder	ˈbædəɹ
contumelious	ˌkɑn.tʊˈmiː.li.əs
ac-	æk
credo	ˈkɹidoʊ
chorister	ˈkɔɹɪstəɹ
olfactory	oʊlˈfæk.təɹ.i
effortlessly	ˈef.ɚt.ləs.li
kirghiz	kɪɹˈɡiːz
athame	ɑˈθɑ.meɪ
-phyte	faɪt
about turn	əˈbaʊt tɚn
sandpaper	ˈsændˌpeɪpɚ
sanatory	ˈsænəˌtɔɹi
lineal	ˈlɪni.əl
470	ˌfɔɹˈsɛvəɾ̃i
lardass	ˈlɑɹd.æs
soft c	sɑːft siː
go the extra mile	ˈɡoʊ ði ˈɛk.stɹə ˈmaɪl
brandon	ˈbɹændən
crematorium	kɹɛməˈtɔːɹɪəm
pointe	pwɑnt
i don't know	[ɑɪ̯ ɾoʊ̯(ʔ)t̚ noʊ̯]
academic freedom	ˌæk.əˈdɛm.ɪk ˈfɹi.dm̩
ensue	ɪnˈsuː
dreamboat	ˈdɹiːmboʊt
bassist	ˈbeɪs.ɪst
anteater	ˈæntˌitɚ
proselyte	ˈpɹɑs.ɪlˌaɪt
band-aid	ˈbændeɪd
conciliatory	kənˈsɪl.i.əˌtɔɹ.i
univocal	juːnɪˈvoʊkəl
chihuahua	tʃɪˈwɑːwɑː
carotid	kəˈɹɒ.tɪd
bewilderment	bɪˈwɪldəɹmənt
grunt work	ɡɹʌ̃nʔwɝk
carry on	ˈkæɹi ˈɑn
fattening	ˈfæt(ə)nɪŋ
benghazi	bɛnˈɡɑ.zi
induced abortion	ɪnˈdust əˈbɔɹ.ʃn̩
poles	poʊlz
depressing	dɪˈpɹɛsɪŋ
enjoyable	ɛnˈdʒɔɪ.jə.bəl
goth	ɡɑθ
goths	ɡɑθs
calender	ˈkæləndɚ
chianti	kiˈɑnti
how old are you	haʊ ˈoʊld ɑɹ ˌju
bloc	blɑk
negligent	ˈnɛɡ.lɪ.dʒənt
matzo	ˈmɑːtsə
chin-up	ˈtʃɪn.ʌp
experiential	ɪkˌspɪɹiˈɛnʃəl
landscaper	ˈlænd.skeip.ɚ
weighted	ˈweɪ.tɪd
prerequisite	pɹiˈɹɛkwəzət
paella	pɑːˈeɪ.(j)ə
mignon	mɪnˈjɑn
laboriously	ləˈbɔɹ.i.əs.li
what'll	ˈ(h)wʌtəl
what'll	ˈ(h)wɒtəl
dirty word	ˈdɚɾijˌwɝd
forwards	ˈfɔɹwɚdz
sulfuric	sʌlˈfjuɹɪk
sulfurous	ˈsʌlfəɹəs
latecomer	ˈleɪtˌkʌm.ɚ
launcher	ˈlɑntʃ.ɚ
lawgiver	ˈlɔˌɡɪv.ɚ
shears	ʃɪɹz
lidar	ˈlaɪdɑɹ
annular	ˈænjəlɚ
commissar	ˈkɑ.məˌsɑr
rodomontade	ˌɹɑ.də.mənˈteɪd
abscissae	æbˈsɪsˌi
noetic	noʊˈɛt.ɪk
smoky	ˈsmoʊki
melamine	ˈmɛl.ə.min
absolute majority	ˈæb.səˌlut məˈd͡ʒɑɹ.ɪ.ti
absolute pitch	ˈæb.səˌlut pɪt͡ʃ
launch pad	ˈlɑntʃ.pæd
gears	ɡɪɚz
beneficiary	ˌbɛn.ɨˈfɪʃ.ɚ.i
realization	ˌɹiəlɪˈzeɪʃən
hourly	ˈaʊ̯ɚli
attune	əˈt(j)un
conveyor	kənˈveɪɚ
shoah	ˈʃoʊ.ə
lysosome	ˈlaɪsəˌsoʊm
no man's land	ˈnoʊˌmænzˌlænd
shofar	ˈʃoʊ̯fɚ
depository	dɪˈpɑzɪtɔɹi
pnictogen	ˈnɪktədʒən
conspirator	kənˈspɪɹətɚ
sutler	ˈsʌtləɹ
quinolone	ˈkwɪnəˌloʊn
nychthemeron	nɪkˈθi.mə.ɹɑn
imprimatur	ˌɪm.pɹɪˈmɑ.tɚ
canoes	kəˈnuːz
astrobleme	ˈæs.tɹoʊ.blim
choline	ˈkoʊliːn
logbook	ˈlɑɡ.bʊk
arsonist	ˈɑɹsənəst
landfall	ˈlænd.fɔl
oo-	oʊ.ə-
san diego	ˌsæn diˈeɪɡoʊ
armada	ɑːɹˈmɑːdə
hurdy-gurdy	ˈhɝː.diˌɡɝː.di
mol	mol
nutritious	nuːˈtɹɪʃəs
lancaster	ˈlæn.kæs.tɚ
tiktaalik	tɪkˈtɑl.ɪk
ukiyo-e	uː.ˈki.oʊ.ˌeɪ
uraeus	juˈɹi.əs
commodious	kəˈmoʊdi.əs
coquetry	ˈkoʊkətɹi
schizo	ˈskɪtsoʊ
minty	ˈmɪnti
demonstrative	dɪˈmɑnstɹətɪv
plumbago	pləmˈbeɪɡoʊ
vertebrae	ˈvɝː.tə.bɹi
mineralogy	ˌmɪnəˈɹɑlədʒi
germen	ˈdʒɝ.mən
reamer	ˈɹi.məɹ
lardy	ˈlɑɹdi
wahine	wɑˈhineɪ
austerely	ɔˈstiəɹli
frustrated	ˈfɹʌs.tɹeɪt.ɪd
salmagundi	ˌsæl.məˈɡʌn.di
lederhosen	ˈleɪdɚˌhoʊzən
mastication	mæstɪˈkeɪʃən
yearningly	ˈjɝnɪŋli
mayoral	meɪˈɔ.ɹəl
bioweapon	ˈbaɪ.oʊˌwɛ.pən
leghorn	ˈlɛɡhɔɹn
tortious	ˈtɔɹʃəs
saurian	ˈsɔɹiən
lovecraft	ˈlʌvkɹæft
xeriscape	ˈzɛ.ɹə.skeɪp
mont blanc	ˌmɑn ˈblɑŋk
crosier	ˈkɹoʊʒɚ
cassidy	ˈkæsɪdi
lats	lɑts
landowner	ˈlændˌoʊ.nɚ
linguistically	lɪŋˈɡwɪstɪk(ə)li
fisher	ˈfɪʃɚ
pyrethrum	paɪˈɹiθɹəm
bisector	ˈbaɪˌsɛktɚ
snickersnee	ˌsnɪk.ɚˈsniː
nootropic	ˌnoʊəˈtɹoʊpɪk
parthian	ˈpɑɹθiən
abiding-place	əˈbaɪ.dɪŋ pleɪs
epiphenomenal	ˌɛpɪfɪˈnɒmɪnəl
erne	ɝːn
romani	ˈɹɑ.mə.ni
prevailing	pɹɪˈveɪ.lɪŋ
promontory	ˈpɹɑməntɔɹi
creosote	ˈkɹiːəˌsoʊt
fatness	ˈfætnəs
admirers	æd.ˈmaɪ.ɚ.ɚz
mackinaw	ˈmækənɔ
yaoi	ˈjɑ.oʊ.i
yaoi	ˈjaʊ.i
bichir	ˈbiːtʃəɹ
zoonosis	zoʊ.ˈɒn.ə.sɪs
whorish	ˈhɔɹɪʃ
toes	toʊz
zenithal	ˈzi.nɪθəl
above-named	əˈbʌvˌneɪmd
baku	bɑːˈkuː
yerevan	ˌjeɹəˈvɑːn
amman	ɑːˈmɑːn
feverishly	ˈfi.vɚ.ɪʃ.li
cap'n	ˈkæpn̩
consolatory	kənˈsoʊl.ə.tɔɹ.i
koch	koʊk
ankylosaurus	ˌæŋkəloʊˈsɔːrəs
hellfire	ˈhɛlˌfaɪəɹ
lookalike	ˈlʊkəlaɪk
hydrogenate	haɪˈdrɑdʒəneɪt
fettered	ˈfɛtɚd
sealer	siːlɚ
hydrogen sulfide	ˈhaɪdɹədʒən ˈsʌlfaɪd
introversion	ɪntɹəˈvəɹʒən
procyon	ˈpɹoʊsiˌɑn
salome	səˈloʊmi
byrlaw	ˈbɝ.lɔ
statutory	ˈstætʃəˌtɔɹi
duteous	ˈdu.ti.əs
logistic	ləˈdʒɪs.tɪk
moroni	məˈɹɑni
moroni	məˈɹoʊnaɪ
astana	æsˈtɑːnə
humdinger	hʌm.ˈdɪŋ.əɹ
holy shit	ˌhoʊli ˈʃɪt
syncline	ˈsɪn.klaɪn
hydroplane	ˈhaɪdɹoʊˌpleɪn
beneficent	bəˈnɛf.ə.sənt
moe	moʊ.eɪ
alarmingly	ə.ˈlɑɹm.ɪŋ.li
horse chestnut	ˌhɔɹs ˈtʃɛsnʌt
onychophagy	oʊ̯.nɪˈkɒf.ə.d͡ʒi
birdy	ˈbɚdi
ur-	ɝ
tires	ˈtaɪ̯ɚz
cutpurse	ˌkʌtˈpɝs
augustan	ɔˈɡʌstən
excommunicate	ˌɛkskəˈmjunəkət
excommunicate	ˌɛkskəˈmjunəkeɪt
coumarin	ˈkuːməɹɪn
alarming	ə.ˈlɑɹm.ɪŋ
rattan	ɹəˈtæn
roti	ˈɹoʊti
offeree	ɑfɚˈɹi
mockery	ˈmɑkəɹi
merriment	ˈmɛɹimɨnt
closure	ˈkloʊ.ʒɝ
pearls	pɝlz
jiggered	ˈdʒɪɡɚd
quirkyalone	ˈkwɝki.əloʊn
overwork	ˌoʊvɚˈwɝk
overwork	ˈoʊvɚˌwɝk
oaths	oʊðz
nostratic	nɑːˈstɹætɪk
blunger	ˈblʌndʒɚ
pepo	ˈpi.poʊ
paparazzo	ˌpɑpəˈɹɑtsoʊ
courtesan	ˈkɔɹtɪzən
brighten	[ˈbɹaɪ̯ʔn̩]
messrs	ˈmɛs.ɚz
flatness	ˈflætnəs
abruzzi	ɑ.ˈbɹut.tsi
tamara	tɑmɑɹə
tamara	təmæɹə
bartholomew	bɑɹˈθɑləmju
bartholomew	bɑɹˈtɑləmi
weakened	ˈwiˌkɛnd
coals	koʊlz
blackness	ˈblæknəs
mottled	ˈmɑt əld
nobly	ˈnoʊbli
models	ˈmɑdl̩s
psychopath	ˈsaɪkoʊˌpæθ
psychopathy	saɪˈkɑpəθi
dogso	ˈdɔɡsoʊ
sapless	ˈsæpləs
newport	ˈnupɔɹt
almah	ˈæl.mə
daub	dɔb
roadside	ˈɹoʊdsaɪd
bandarban	ˈbændɑːɹbæn
wot	wɑt
absorption line	æbˈsɔɹp.ʃn̩ laɪn
stops	stɑps
leicester	ˈlɛstɚ
pomiculture	ˈpoʊməˌkʌlt͡ʃɚ
mortify	ˈmɔɹtɪfaɪ
chitlins	tʃitlɪnz
leghorn	ˈlɛɡhɔɹn
lieder	ˈlidɚ
abatises	ˈæb.ət.ə.səz
automatons	ɔˈtɑ.mə.tənz
snares	sneɚz
termini	ˈtɜɹməˌnaɪ
stratagems	ˈstɹæt.ə.dʒəmz
cognomens	kɒɡˈnoʊ.mənz
psychopaths	ˈsaɪkoʊˌpæθs
psychopathic	ˈsaɪkoʊˌpæθɪk
groaned	ɡɹoʊnd
ingenuous	ɪnˈdʒɛn.ju.əs
irresponsible	ɪrəˈspɑnsɪbəl
stage-coach	ˈsteɪdʒ.koʊtʃ
swaddle	ˈswɔdəl
mountaineer	ˌmaʊn.tɪnˈɪɹ
visualization	ˌvɪʒuələˈzeɪʃən
tyler	ˈtaɪlɚ
starkers	ˈstɑɹkɚz
trillionaire	ˌtɹɪl.jəˈnɛɚ
wherewith	ʍɛɚˈwɪð
wherewith	wɛɚˈwɪð
gruelling	ˈɡɹu.lɪŋ
ministerium	ˌmɪnəˈstɪəriəm
fulgurous	ˈfʊl.ɡɪə.ɹəs
spasmodic	spæzˈmɑ.dɪk
bawdily	ˈbɔːdɪli
tarrier	ˈtæɹiɚ
tarrier	ˈtɑːɹiɚ
personalization	ˌpɝs(ə)nəlaɪˈzeɪʃən
peridotite	pəˈɹɪd.əˌtaɪt
four hundred	ˈfoʊɹ ˈhʌn.dɹəd
soapy	ˈsoʊpi
abcoulomb	ˌæb.kuˈlɑm
brute force	bɹut ˈfɔɹs
prepositions	ˌpɹɛ.poʊ.ˈzɪ.ʃənz
foods	fudz
disillusionment	dɪsɪˈluʒənmənt
lockstitch	ˈlɑkstɪt͡ʃ
charlene	ʃɑɹˈlin
marvelous	ˈmɑɹvələs
recon	ˈɹikɑn
disuse	dɪsˈjus
hoofs	hufs
handlebar	ˈhændəlbɑːɹ
serge	sɝdʒ
dematerialize	ˌdi.məˈtɪɹ.i.ə.laɪz
gridlock	ˈɡɹɪdˌlɑk
repercussion	ˌɹi.pɚˈkʌʃ.ən
infallible	ɪnˈfæ.lə.bəl
midas	ˈmaɪ.dəs
bedwetter	ˈbɛdwɛtɚ
scolding	ˈskoʊldɪŋ
ocher	ˈoʊkɚ
supermajority	ˌs(j)upɜɹməˈd͡ʒɔɹɪti
luther	ˈluθɚ
accommodatingly	ə.ˈkɒm.ə.ˌdeɪt.ɪŋ.li
iatrochemistry	aɪˌæt.ɹoʊˈkɛm.ɪ.stɹi
iatrochemical	aɪˌæt.ɹoʊˈkɛm.ɪ.kəl
an apple a day keeps the doctor away	əˈn‿æ.pəl‿ə ˈdeɪ ˈkips ðə ˈdɑk.tɚ əˈweɪ
scotsman	ˈskɑts.mən
neonate	ˈni.oʊ.neɪt
bullseye	ˈbʊlzaɪ
presbyterian	ˌpɹez.bɪˈtɪɹ.i.ən
accursedness	ə.ˈkɚ.səd.nəs
audiovisual	ˌɔ.di.oʊˈvɪ.ʒu.əl
absolute altimeter	ˈæb.səˌlut
absolute altimeter	ælˈtɪm.ɪ.tɚ
consonantal	[ˈkʰɑn.sə.nən(ɾ).əɫ]
ancien régime	ɑ̃.sjɛ̃ ɹeɪˈʒim
hors d'oeuvre	ɔɹˈdɝv
monomaniac	ˌmɑnoʊˈmeɪnɪæk
waspish	ˈwɑ.spɪʃ
macgyver	məˈɡaɪvɚ
furrier	ˈfɜɹiəɹ
furrier	ˈfɜɹiəɹ
diathetic	ˈdaɪ.ə.θə.tɪk
diathesis	daɪˈæθəsɪs
semite	ˈsɛmaɪt
imponderable	ɪmˈpɑːndəɹəbl
imperialistic	ɪmˌpɪɹi.əˈlɪstɪk
comber	ˈkoʊmɚ
comber	ˈkɑmbɚ
foehn	fɝn
tubes	tuːbz
unified	ˈjuː.nɪ.faɪd
farmland	ˈfɑːɹmlænd
canterbury	ˈkæntəbəɹi
buttress	ˈbʌtɹɪs
forepaw	ˈfɔɹpɔ
decedent	dɪˈsi.dənt
stracciatella	ˌstɹɑtʃi.əˈtɛlə
jäger	ˈjeɪ.ɡɚ
hatless	ˈhætləs
dante	ˈdɑnteɪ
par for the course	ˈpɑɹ fɚ ðə ˈkɔɹs
disclosure	dɪsˈkloʊʒɚ
oscan	ˈɑːskən
keratosis	ˌkɛɹəˈtoʊsɪs
aragon	ˈæɹəɡɑːn
mitred	ˈmaɪ.tɚd
miter	ˈmaɪ.təɹ
thorp	θɔɹp
symbolically	ˌsɪmˈbɑːlɪklɨ
nighthawk	ˈnaɪthɑk
faceplant	ˈfeɪsˌplænt
thatcher	ˈθætʃɚ
jacksonian	dʒækˈsoʊn.i.ən
daguerreotype	dəˈɡɛɹ.oʊ.taɪp
air mass	ɛəɹ mæs
abscopal	æbˈskoʊ.pl̩
red currant	ˈɹɛdˌkɜɹənt
bottler	ˈbɑtəlɚ
dengue fever	ˈdɛŋɡiː ˈfiːvɚ
arthralgia	ɑɹˈθɹæl.dʒi.ə
orlando	ɔɹ.ˈlæn.doʊ
bel paese	ˌbɛl pɑˈeɪzi
autotroph	ˈɔɾəˌtɹoʊf
ricotta	ɹɪˈkɑtə
thenceforth	ˌðɛnsˈfɔːɹθ
cater-corner	ˈkætəˌkɔɹnɚ
kiddie	[ˈkʰɪɾi]
adjure	ædˈdʒʊɹ
afforest	əˈfɔɹɪst
sofa king	ˈsoʊfə ˌkɪŋ
abdominoplasty	æbˈdɑm.ɪ.noʊˌplæs.ti
automate	ˈɔtoʊˌmeɪt
ragù	ɹæˈɡu
vongole	ˈvɑŋɡəleɪ
basalt	bəˈsɑlt
get one's knickers in a twist	ˈɡɛt wʌnz ˈnɪkɚz ɪn ə ˈtwɪst
pep talk	ˈpɛp ˌtɔk
norris	ˈnɔɹɪs
eton	ˈiː.tən
eton	ˈiː.ʔn̩
reassure	ɹiəˈʃʊɹ
sausage party	ˈsɔ.sɪdʒ ˌpɑɹ.ti
rsfsr	ɑɹ.ɛs.ɛf.ɛs.ˈɑɹ
mustached	ˈmʌstæʃt
feathery	ˈfɛ.ðəɹ.i
johnnycake	ˈdʒɑː.niːˌkeɪk
fauteuil	ˈfoʊ.tɪl
leonard	ˈlɛnɚd
románico	ɹoʊˌmɑnɪt͡soʊ
sawhorse	sɔ.hɔɹs
papier-mâché	ˌpeɪpɚ məˈʃeɪ
pastern	ˈpæstəɹn
vance	væns
monterey	ˈmɑnəˌɹeɪ
insofar as	ɪn.soʊˈfɑɹəz
quillaia	kwəˈleɪə
pythagoras	pɪˈθæɡ.əɹ.əs
proteus	ˈpɹoʊti.əs
footballer	ˈfʊtbɔːləɹ
calcify	ˈkælsɪfaɪ
chromatic aberration	kɹoʊˈmæ.tɪk ˌæb.əˈɹeɪ.ʃn̩
molestation	ˌmoʊlɪˈsteɪʃən
macro-	ˈmæk.ɹoʊ
haunch	hɔntʃ
no duh	noʊ ˈdə
marseillaise	mɑːɹseɪˈjɛz
boko	ˈboʊ.koʊ
varsity	ˈvɑɹ.sɪ.ti
sephirah	səˈfiɹə
obliquity	əˈblɪkwɪɾi
sloths	slɑθs
judea	dʒuˈdiːə
internee	ɪntɝˈniː
calipers	ˈkæl.ɨ.pɚz
caliper	ˈkælɪpɚ
demonology	ˌdiːməˈnɑːlədʒi
jimbo	ˈdʒɪmboʊ
ophelia	oʊˈfiljə
pompeii	pɑːmˈpeɪi
mcleod	məˈklaʊd
kiddy	ˈkɪɾi
maugre	ˈmɔ.ɡɚ
oneironaut	oʊˈnaɪɹoʊnɔt
come on	ˈkʌm ˌɔn
pratique	pɹæˈtik
ligatures	ˈlɪɡətʃɚz
siberian	[saɪˈbɪɹiən]
pallette	ˈpælɪt
bedecked	bɪˈdɛkd
powdery	ˈpaʊdəɹi
mome	moʊm
stoically	ˈstoʊ.ɪk.əl.i
worsted	ˈwʊs.tɪd
worsted	ˈwɝ.stɪd
censer	ˈsɛn.sɚ
reputed	ɹɪˈpju.tɪd
oppo	ˈɑ.poʊ
endorphin	ɛnˈdɔ(ɹ)fɪn
paedomorphic	ˌpidəˈmɔɹfɪk
ratty	ˈɹæti
hereford	ˈhɝfɚd
almonds	ˈɑ.məndz
almonds	ˈɑl.məndz
almonds	ˈɑl.mənz
almonds	ˈæ.məndz
watercraft	ˈwɔtɚkɹæft
newark	ˈnuː.əɹk
kayfabe	ˈkeɪˌfeɪb
cephalothorax	ˌsɛfələˈθɔɹæks
doorknob	ˈdɔɹ.nɑb
sneered	snɪɹd
freestone	ˈfɹiːstoʊn
fulguration	ˌfʊl.ɡjəˈɹeɪ.ʃən
tapered	ˈteɪ.pɚd
torrefaction	ˌtɔ.ɹɪ.ˈfæk.ʃən
nacho	ˈnɑt͡ʃoʊ
bashkir	bɑːʃˈkɪəɹ
steamboat	ˈstimˌboʊt
whorled	wɝld
whorled	ʍɝld
wonted	ˈwɔːntɪd
malmö	ˈmɑlmʊ
monstrance	ˈmɑnztɹəns
mortimer	ˈmɔɹtəmɚ
sophy	soʊˈfi
unprincipled	ʌnˈpɹɪnsɪpəld
interject	ɪn.tɚˈdʒɛkt
whirled	wɝld
whirled	ʍɝld
traps	tɹæps
uneducated	ʌnˈɛdʒəkeɪtɪd
diktat	dɪkˈtɑt
steersman	ˈstiɹz.mən
ariadne	ˌæ.ɹiˈæd.ni
elbows	ˈɛl.boʊz
paws	pɔːz
joking	ˈdʒowkɪŋ
chowderhead	ˈtʃaʊdɚhɛd
oviparous	oʊˈvɪpəɹəs
aborad	æˈboɹˌæd
pompadour	ˈpɑːmpədɔːɹ
bradley	ˈbɹædli
gold rush	ˈɡoʊldˌɹʌʃ
meddler	ˈmɛdlɚ
andrews	ˈæn.dɹuz
newman	ˈnumən
favours	ˈfeɪ.vɚz
anole	əˈnoʊ.li
on tenterhooks	ˌɒn ˈtɛn.təɹˌhʊks
cowered	ˈkaʊɚd
aperçu	ˌæ.pɚˈsuː
soho	ˈsɔʊ.hɔʊ
mésalliance	meɪzəˈlaɪəns
linalool	lɪˈnæloʊəl
abram	ˈeɪ.bɹəm
débutant	ˈdɛb.jə.tant
windsor	ˈwɪnzəɹ
arapaho	əˈɹæpəhoʊ
aegean	iˈdʒi.ən
hagar	ˈheɪɡɑːɹ
dénouement	ˌdeɪ.nuˈmɑnt
affordable	əˈfɔɹ.də.bəl
aeronaut	ˈɛɹəˌnɔt
aeronaut	ˈɛɹəˌnɑt
manqué	mɑŋˈkeɪ
entranced	ɛnˈtɹɑːnst
gofer	ˈɡoʊfɚ
daftness	ˈdæftnəs
guyot	ɡiˈjoʊ
ev'ry	ɛvɹi
reconstituting	ɹiˈkɑnstɪˌt(j)utɪŋ
reconstitute	ɹiˈkɑnstɪˌt(j)ut
stratigraphy	stɹəˈtɪɡɹəfi
sloe-eyed	ˈsloʊˌaɪd
epicurus	ˌepɪˈkjʊɹəs
exotropia	ˈɛks.oʊˌtɹoʊpi.ə
macaca	məˈkɑːkə
747	ˌsɛvənfoɹtiˈsɛvən
comforter	ˈkʌmfəɹtəɹ
comforter	ˈkʌmfəɹtəɹ
firn	fɪɹn
bidder	ˈbɪdɚ
fava	ˈfɑː.və
dalai lama	ˈdɑːlaɪ ˈlɑːmə
mainmast	ˈmeɪn.mæst
unadorned	əˌnʌˈdɔːɹnd
adorableness	əˈdɔːɹəbəlnəs
mahjong	mɑˈdʒɔŋ
deportment	dɪˈpɔɹt.mənt
disciplinary	ˈdɪs.ə.pləˌnɛɹi
aflutter	əˈflʌt.ɚ
aftercare	ˈæf.tɚ.kɛɹ
aftereffect	ˈæftəɹ.əˌfɛkt
photometer	fəˈtɑmədəɹ
shemales	ˈʃi.meɪlz
snowclone	ˈsnoʊ.kloʊn
slowest	ˈsloʊɪst
backslider	ˈbækslaɪdəɹ
interviewed	ˈɪn.tɚ.vjuːd
cartwheel	ˈkɑɹtˌwil
offhand	ˌɔfˈhænd
pistachio	pɪsˈtæʃioʊ
antihero	ˈæn.taɪˌhi.ɹoʊ
smattering	ˈsmæɾɹ̩ɪŋ
entourage	ˈɑn.tə.ɹɑʒ
sort of	ˈsɔɹt əv
quinceañera	ˌkɪnseɪ.ənˈjɛɹə
falconer	ˈfælkənɚ
contemptuously	kənˈtɛmp.tʃu.əs.li
bouncy	ˈbaʊnsi
boise	ˈbɔɪsiː
embattled	ɛmˈbæt.əld
courseware	ˈkɔɹswɛɹ
mumchance	ˈmʌm.tʃæns
tailcoat	ˈteɪlkoʊt
doha	ˈdoʊ.hɑː
amorally	eɪˈmɔɹəli
anomalously	əˈnɑmələsli
antisocially	ˌæntaɪˈsoʊʃəli
appallingly	ʌˈpɑlɪŋli
jericho	ˈd͡ʒɛɹɪˌkoʊ
threescore	ˈθɹiskɔɹ
uttermost	ˈʌtəɹmoʊst
alliterate	əˈlɪ.tə.ɹeɪt
ambrosial	æmˈbɹoʊʒəl
aberdevine	ˈæb.ə.dəˌvaɪn
odors	ˈoʊ.dɚz
alicante	ˌɑləˈkɑnteɪ
rale	ɹæl
amortization	ˌæmɚtəˈzeɪʃən
anesthetize	əˈnɛs.θə.taɪz
caterwauling	ˈkætəɹˌwɑlɪŋ
spacefaring	ˈspeɪsfæɹɪŋ
subtly	ˈsʌ.tl̩.li
big mac	bɪɡ mæk
reconnoiters	ˌɹɛkəˈnɔɪtɚs
reconnoitered	ˌɹɛkəˈnɔɪtɚd
pigeons	ˈpɪdʒəns
wilder	ˈwɪldəɹ
slower	ˈsloʊɚ
fantasies	ˈfæntəsiz
kaleidoscopic	kəˌlaɪdəˈskɑːpɪk
kinematic	kɪn.əˈmæt.ɪk
knowable	ˈnoʊəbl̩
reconnoitre	ˌɹɛkəˈnɔɪtɚ
jerkwater	ˈdʒɚk.wɔ.tɚ
jiggly	ˈdʒɪɡ.əˌli
jittery	ˈdʒɪt.ə.ɹi
e-day	ˈiˌdeɪ
urethral	jʊˈɹiːθɹəl
judicatory	dʒuˈdɪkəˌtɔɹi
animes	ˈæ.nəˌmeɪz
beat it	ˈbiˌdɪt
vocalization	voʊk(ə)l(a)ɪˈzeɪʃ(ə)n
popping	ˈpɑpɪŋ
flouted	[ˈflaʊ̯ɾɨd]
nilotic	naɪˈlɑtɪk
asper	ˈæspəɹ
coextensive	ˌkoʊɛkˈstɛnsɪv
homogenize	həˈmɑːdʒənaɪz
austrians	ˈɔːstɹi.əns
napless	ˈnæpləs
calas	kə.ˈlɑː
centres	ˈsɛn.tɚs
littlest	[ˈlɪɾl̩əst̚]
quoit	kɔɪt
growths	ɡɹoʊθs
mares	mɛəɹz
powders	ˈpaʊ.dɚz
booleans	ˈbuli.əns
horrify	ˈhɔɹəfaɪ
marsupials	mɑɹ.ˈsu.pi.əlz
gurus	ˈɡʊ.ɹuz
alums	ˈæ.ləmz
alders	[ˈɔl.dɚz]
coles	koʊlz
dirigibles	ˈdɪɹ.ə.dʒə.bəlz
headmasters	ˈhɛdˌmæstɚz
desktops	[ˈdɛsk.ˌtɑps]
teratophiliacs	ˈtɛɹ.ə.təˌfɪl.i.æks
mossy	ˈmɑːsi
sneers	snɪɹz
barfs	bɑɹfs
knocks	nɑks
pardons	ˈpɑɹ.dn̩z
lulls	[ɫʌɫz]
halts	hɑlts
chomps	t͡ʃɔmps
hallows	ˈhæloʊz
'kay	keɪ
abenaki	ˌæbəˈnæ.ki
roving	ˈɹoʊvɪŋ
hester	ˈhɛstɚ
technologist	tɛkˈnɑləd͡ʒɪst
peri-urban	ˌpɛɹ.ə.ˈɝ.bən
robo-	ˈɹoʊboʊ
campy	ˈkæmpi
tracheophyte	ˈtɹeɪki.əˌfaɪt
flavorless	ˈfleɪvɚləs
messrs.	ˈmɛs.ɚz
party favor	pɑɹɾiːˌfejvɹ̩
lockdown	ˈlɑkˌdaʊn
lambert	ˈlæmbɚt
sino-	ˈsɪnoʊ
absentia epileptica	æbˈsɛn.ʃi.ə ˌɛp.əˈlɛp.tɪ.kə
telomerase	teˈlɑməɹeɪs
segment	ˈsɛɡmɛnt
hilda	ˈhɪldə
alchemistic	ˈæl.kə.mɪ.stək
paradigmatic	ˈpæɹ.ə.dɪɡ.ˈmæ.tɪk
squarely	ˈskwɛɹ.li
squarish	ˈskwɛɹ.ɪʃ
chihuahua	tʃɪˈwɑːwɑː
overstate	ˌoʊ.vɚˈsteɪt
gnawing	ˈnɔɪŋ
abidden	əˈbɪd.n̩
cardecu	ˈkɑɹdɪkju
exclamatory	ɛksˈklæməˌtɔɹi
melena	ˈmɛlɪnə
cinchona	sɪŋˈkoʊnə
cirrhotic	səˈɹɒtɪk
courtly	ˈkɔɹtli
fourscore	ˈfɔɹskɔɹ
praedial	ˈpɹidi.əl
classless	ˈklæsləs
ogonek	ˈoʊɡənɛk
clowder	klaʊ̯dɚ
polycystic	pɑliˈsɪstɪk
pedicab	ˈpɛdiˌkæb
polysemous	ˌpɑːl.iˈsiː.məs
earns	ɝnz
ecchymosis	ˌɛk.ɪˈmoʊ.sɪs
mortified	ˈmɔɹtəˌfaɪd
polka dot	ˈpoʊ.kə ˌdɑt
pomander	ˈpoʊ.mæn.dɚ
pongee	ˈpɑndʒi
apologia	ˌæp.əˈloʊ.dʒi.ə
edentulous	iˈdɛnt.jʊ.ləs
postilion	pəˈstɪljən
moorish	ˈmʊɹ.ɪʃ
overuse	ˌoʊvɚˈjuːz
overuse	ˌoʊvɚˈjuːs
siobhan	ʃəˈvɔːn
gladiolus	ɡlædɪˈoʊləs
opacity	oʊˈpæsɪtiː
interactivity	ɪntəɹækˈtɪvɪti
applique	ˌæ.plɪˈ.keɪ
willowy	ˈwɪloʊi
hammond	ˈhæmənd
trotting	ˈtɹɑtɪŋ
islamofascism	ɪˈslɑ.moʊˌfæʃ.ɪz.əm
slackness	ˈslæknəs
worrywart	ˈwʌɹ.iˌwɔɹt
worrywart	ˈwɝ.iˌwɔɹt
wrap-up	ˈɹæpʌp
shalom aleichem	ˌʃɔləm əˈleɪkəm
crudités	ˈkɹuːdɪteɪz
autosome	ˈɔɾəˌsoʊm
gondolier	ˌɡɑndəˈlɪɹ
biodegradable	baɪoʊdəˈɡɹeɪdəbl̩
biomedical	ˌbaɪoʊˈmedɪkl
blaster	ˈblæs.tɚ
bougainvillea	ˌbu.ɡənˈvɪl.jə
raspy	ˈɹæsp.i
maundering	ˈmɔːndəɹɪŋ
burgh	ˈbɝɡ
runner-up	ˌɹʌn.ɚˈʌp
chanticleer	ˈ(t)ʃæntəˌklɪɹ
choreograph	ˈkɔɹjəɡɹæf
coaxial	koʊ.ˈæk.sɪi.əl
starkish	ˈstɑɹkɪʃ
corncob	[ˈkɔɹnkɑb]
hireling	ˈhaɪɹˌlɪŋ
crossfire	ˈkɹɔːsfaɪɹ
crosswind	ˈkɹɑːs.wɪnd
hecatomb	ˈhɛkətoʊm
peephole	piphoʊl
peephole	pʰiphoʊɫ
baxter	ˈbækstɚ
monroe	mənˈɹoʊ
churchill	ˈtʃɜːɹtʃɪl
antioch	ˈæntiˌɑk
paleography	ˌpeɪliˈɑɡɹəfi
hotelier	oʊ.təl.ˈjeɪ
argyle	ˈɑ˞.ɡaɪl
fettuccini	ˌfɛtəˈt͡ʃini
gainer	ˈɡeɪnɚ
filer	ˈfaɪlɚ
kieran	ˈkɪɹˌɔn
masterfully	ˈmæstɚfʊli
disharmony	dɪsˈhɑrməni
tows	toʊz
apologias	ˌæp.əˈloʊ.dʒi.əz
landform	ˈlænd.fɔɹm
esoterica	ɛ.sɵˈtɛ.ɹɪ.kə
centred	ˈsɛn.təɹd
cremaster	kɹiˈmæstəɹ
moonbeam	ˈmun.bim
perfidious	pɚˈfɪdi.əs
dion	ˈdiːɑn
ptolemy	ˈtɑləmi
ptolemaic	ˌtɑl.əˈmeɪ.ɪk
x-sampa	ˌɛksˈsæmpə
escritoire	ˌɛskɹɪˈtwɑːɹ
bearskin	ˈbɛəɹ.skɪn
sander	ˈsændɚ
cabriole leg	ˈkæb.ɹi.oʊl
hooah	ˈhu.ɑː
hornless	hɔɹn.lɪs
deicer	ˌdiˈaɪsɚ
sotto voce	ˌsɑtoʊ ˈvoʊtʃi
limoncello	ˌlɪmənˈtʃɛloʊ
colton	ˈkoʊltən
patronym	ˈpætɹoʊnɪm
matronym	ˈmætɹoʊnɪm
metronym	ˈmɛtɹoʊnɪm
yolks	joʊks
cardinal numeral	ˈkɑɹdɪnəl ˈnumɜɹəl
polyptoton	ˌpɑ.ləpˈtoʊ.tɑn
oughts	ɑːts
châteaux	ʃæːˈtoʊ(z)
rubai	ɹuˈbaɪ
debride	dɨˈbɹid
discriminatory	dɪsˈkɹɪmɪnəˌtɔɹi
accessibleness	æk.ˈsɛs.ə.bəl.nəs
à gogo	əˈɡoʊ.ɡoʊ
circumlocutionary	ˌsɝːkəmləˈkjuːʃənɛɹi
mafic	ˈmeɪfɪk
schoolmarm	ˈskulˌmɑɹm
inured	ɪˈnjʊɹd
bakerloo	beɪkɚˈlu
augurs	ˈɔ.ɡɚz
spallation	spɔːleɪʃən
planktonic	plæŋkˈtɑnɪk
ablative absolute	ˈæb.lə.tɪv æb.soʊˈlut
surficial	səɹˈfɪʃ(ə)l
brachiopod	ˈbɹækɪəˌpɒd
diaschisis	daɪˈæskəsəs
franglais	ˌfɹɑŋˈɡleɪ
diff eq	dɪ.fiˈkjuː
chunter	ˈtʃʌn.tɚ
carload	ˈkɑɹloʊd
disservice	dɪ(s)ˈsɝvɪs
daleks	ˈdɑːlɛks
sheikdom	ˈʃiːkdəm
shutterbug	ˈʃʌtɚbʌɡ
substantival	ˌsʌbstənˈtaɪvəl
demiurge	ˈdɛmɪˌɝdʒ
wouldn't've	ˈwʊdəntəv
sureness	ˈʃʊɹnəs
xenobiology	ˈziːnoʊbaɪˌɑːlədʒi
meum	ˈmi.əm
window sill	ˈwɪndoʊ ˌsɪl
focuses	ˈfoʊ.kəs.əz
undulipodium	ˌʌn.dʒə.ləˈpoʊ.di.əm
ramsey	ˈɹæmzi
st john's wort	seɪnt d͡ʒɑnz wɚt
negotiable	nɪˈɡoʊʃi.əbəl
olla podrida	ˌɑlə pəˈdɹidə
backwardly	ˈbækwɚdli
folderol	ˈfɔldəɹɔl
abstriction	æbˈstɹɪk.ʃn̩
abstricted	æbˈstɹɪk.təd
wafers	ˈweɪ.fɚz
ernes	ɝːnz
equalize	ˈikwəˌlaɪz
stertorously	ˈstɝ.tɚ.əs.li
penuche	pəˈnuːt͡ʃɪ
skidoo	ˈskiˌdu
herky-jerky	ˈhɚkiˌd͡ʒɚki
cloths	klɔðz
central europe	ˈsɛntɹəl ˈjʊɹəp
sanctimony	ˈsæŋk.tɪˌmoʊ.ni
xenolalia	ˌzinoʊˈleɪliə
sweepstake	ˈswipˌsteɪk
sweepstakes	ˈswipˌsteɪks
peppery	ˈpɛpəɹi
botty	ˈbɒti
gendarmerie	ˈʒɑn.dɑɹ.mə.ɹi
rosie	ˈɹoʊziː
randall	ˈɹændəl
inchworm	ˈɪntʃ.wɝm
simpatico	sɪmˈpæ.tə.koʊ
insole	ˈɪnsoʊl
thirdly	ˈθɚdli
aeolic	iˈɑːlɪk
jack-o'-lantern	ˈdʒæk.oʊˌlæn.tɚn
mangled	ˈmæŋɡəld
motown	ˈmoʊtaʊn
hosta	ˈhoʊ stə
indenture	ɪnˈdɛn.ʃɝ
bromeliad	bɹoʊˈmiːliæd
pimento	pɪˈmɛntoʊ
abietic acid	ˌæb.iˈɛd.ɪk ˈæ.sɪd
erratically	ɪˈɹæt.ɪk.li
seigneur	sɛˈnjɝ
pratt	pɹæt
observational	ˌɑbzɚˈveɪʃənəl
towed	toʊd
ooh la la	u.lɑ.ˈlɑ
potomac	pəˈtoʊmək
reveille	ˈɹɛ.və.li
tin-pot	ˈtɪn.pɑːt
misfire	ˈmɪsˌfaɪɹ
eer	ɛɚ
bas-relief	
megapenny	ˈmɛ.ɡəˌpɛ.ni
abscisic acid	ˌæb.ˈsɪz.ɪk ˈæ.sɪd
perseveration	pɚˌsɛvəˈɹeɪʃən
pretentiously	pɹɪˈtɛnʃəsliː
homogenise	həˈmɑːdʒənaɪz
geiger counter	ˈɡaɪɡɚ ˈkaʊntɚ
firelight	ˈfaɪɚ.laɪt
reduplication	ɹɪ.d(j)u.plɪ.ˈkeɪ.ʃən
preëmptor	pɹiːˈɛmptˌɔɹ
riverbed	ˈɹɪvɚˌbɛd
gender-blind	ˈdʒɛndɚˌblaɪnd
mosey	ˈmoʊ.zi
ostrobogulous	ˌɑː.stɹəˈbɑːɡ.jə.ləs
stiletto	stəˈlɛtoʊ
preëmptioner	pɹiːˈɛmp.ʃənˌəɹ
steaminess	ˈstiminɪs
monophthong	ˈmɑnəfθɔŋ
triphthong	ˈtɹɪfθɔŋ
judeo-	dʒudiːoʊ
overtone	ˈoʊvɚtoʊn
captivating	kæptɪveɪtɪŋ
city hall	ˈsɪti ˌhɔl
homolog	ˈhɑːməlɑːɡ
squireen	skwaɪˈɹiːn
pencil case	ˈpɛnsəl ˌkeɪs
halloa	hɛˈloʊ
proustian	ˈpɹusti.ən
smartphone	ˈsmɑɹtfoʊn
ciara	ˈki(ə)ɹə
toner	ˈtoʊnɚ
onfi	ˈɑn.fi
neotenous	niˈɑːtənəs
cartload	ˈkɑɹt.loʊd
controversies	ˈkɑntɹəˌvɚsiz
emergencies	i.ˈmɚ.dʒən.siz
unites	juːˈnaɪts
cartographic	ˌkɑɹ.təˈɡɹæf.ɪk
stertorous	ˈstɝ.tɚ.əs
scuppernong	ˈskʌ.pəɹˌnɔŋ
whatth	wʌtθ
cat's meow	ˌkætsmiˈaʊ̯
institutional	ˌɪnstɪˈtjuʃənəl
chancellery	ˈtʃænt.slə.ɹi
van gogh	vænˈɡoʊ
alkaloids	ˈæl.kə.lɔɪdz
mad as a hatter	ˌmæd æz ə ˈhætɚ
literatim	ˌlɪ.tɚˈeɪ.tɪm
tute	tut
tute	tut
zoar	ˈzɔʊ.ɑɹ
zoars	ˈzɔʊ.ɑɹz
nosh	nɑʃ
post-haste	ˌpoʊstˈheɪst
perlocution	pɜɹləkjuʃən
stegosaur	ˈsteɡəsɔːɹ
teotwawki	[ti.ɑt.wɑk.i]
lizardman	ˈlɪz.ɚd.mæn
game over	ˌɡeɪm ˈoʊ.vɚ
chested	ˈtʃɛstɪd
the end	ði ɛnd
heliogabalus	ˌhiː.li.əˈɡæb.ə.ləs
heliogabalus	ˌhiː.li.oʊˈɡæb.ə.ləs
chukker	ˈtʃʌ.kɚ
inequity	ɪnˈɛkwɪti
onychophagist	ɑnəˈkɑfədʒɪst
cross-dress	ˈkɹɔsˈdɹɛs
golconda	ɡɑlˈkɑndə
futhark	ˈfuθaɹk
nimbleness	ˈnɪm.bəl.nɪs
spinor	spɪnɔɹ
dota	ˈdoʊt̬ə
in for a penny, in for a pound	ɪn fɔɹ ə ˈpɛ.ni ɪn fɔɹ ə paʊnd
exarch	ˈɛksɑɹk
coptic	ˈkɑptɪk
circassian	səɹˈkæʃən
baseball cap	ˈbeɪs.bɔl ˌkæp
hoss	hɔːs
codomain	ˌkoʊ.doʊˈmeɪn
abstract art	ˈæbˌstɹækt ɑɹt
defcon	ˈdɛfkɑn
paralipomena	ˌpæɹəlɪˈpɒmənə
domiciliary	ˌdoʊmɪˈsɪli.ɛɹi
ot-	oʊt
logarithms	ˈlɑ.ɡə.ɹɪ.ð(ə)mz
debuts	deɪˈbjuːz
cartloads	ˈkɑɹt.loʊdz
doomsayer	ˈdumˌseɪ.ɚ
-meister	ˈmaɪstɚ
bluntness	ˈblʌnt.nəs
donegal	ˈdɑnɪɡɔl
metropole	ˈmɛtɹəpoʊl
tinman	ˈtɪn.mæn
collocate	ˈkɑləkeɪt
collocate	ˈkɑləkət
comparably	kɒmˈpæɹəbl̩i
lisps	lɪsps
overloading	ˈoʊ.vɚloʊ.diŋ
amœba	əˈmiːbə
compartmentalize	kəmˌpɑɹtˈmɛntəlˌaɪz
pursuivant	ˈpɜɹ.sɪ.vənt
overarching	ˌoʊvəɹˈɑɹtʃɪŋ
conservancy	[kənˈsɝvənsɪ]
chrestomathies	ˈkɹɛstoʊmæθiz
lardo	ˈlɑɹ.doʊ
tangential	tænˈdʒɛnt.ʃəl
guiro	ˈɡwɪɹoʊ
cutler	ˈkʌtlɚ
cosign	ˈkoʊ.saɪn
hexapod	ˈhɛk.sə.pɑd
crosscut	ˈkɹɔskʌt
extraneousness	ɪkˈstɹeɪni.əsnəs
hugger-mugger	ˈhʌɡ.ɚˌmʌɡ.ɚ
grabby	ˈɡɹæbi
breathtakingly	ˈbɹɛθˌteɪ.kɪŋ.li
pollinosis	ˌpɑləˈnoʊsɪs
hypotonic	haɪpəˈtɑnɪk
mjollnir	ˈmjɔlnɪr
cliche	kliˈʃeɪ
phonetician	ˌfoʊnəˈtɪʃ(ə)n
hexology	hɛkˈsɑlədʒi
phonologist	fəˈnɑlədʒɪst
pharmacopoeia	ˌfɑɹ.mə.kəˈpi.ə
pertinaciously	ˌpɝːtənˈeɪʃəsli
luan	ˈlu(w)ɑn
beguine	bə.ˈɡiːn
bisection	baɪˈsɛkʃən
jongleur	ˈd͡ʒɑŋ.ɡlɚ
abidingness	əˈbaɪ.dɪŋ.nəs
absorbedness	æbˈsɔɹb.ɪd.nəs
accommodativeness	ə.ˈkɒm.ə.ˌdeɪt.ɪv.nəs
accommodative	ə.ˈkɒm.ə.ˌdeɪt.ɪv
pseudepigrapha	ˌsuː.dəˈpɪ.ɡɹə.fə
boater	ˈboʊ.tɚ
graham	ˈɡɹeɪ.əm
doorframe	ˈdɔɹˌfɹeɪm
boombox	bumˈbɑks
boomboxes	bumˈbɑksɪz
bratty	ˈbɹæti
equitably	ˈɛk.wɪ.tə.bli
exhaustively	ɛɡˈzɑ.stɪv.li
effortlessness	ˈef.ɚt.ləs.nəs
.com	dɑt.kɑm
abecedarium	ˌeɪ.bi.siˈdɛəɹ.i.əm
overcook	oʊ.vɚ.kʊk
cleverer	ˈklɛvɚɚ
patten	ˈpæt(ə)n
margravine	ˈmɑɹɡɹəvin
oxymoronic	ˌɑk.sɪ.məˈɹɑ.nɪk
handler	ˈhæn.dlɚ
teuton	ˈt(j)u.tən
pythagorize	pəˈθæɡ.əˌɹaɪz
hogget	ˈhɑɡət
micropyle	ˈmaɪ.kɹoʊˌpaɪl
pedobaptism	pɛdoʊˈbæptɪzəm
paedobaptism	pɛdoʊˈbæptɪzəm
fucked-up	ˈfʌktˌʌp
neuroepithelium	ˌnɝ.oʊ.ˌɛp.ɪ.ˈθi.li.əm
fuckability	ˌfʌkəˈbɪlɪti
penny for your thoughts	ˈpɛn.i fɔɹ jʊɹ ˈθɑts
adonai	ˌæ.dəˈnaɪ
exhaustiveness	ɛɡˈzɑ.stɪv.nəs
prognoses	pɹɑːɡˈnəʊsiːz
pseudopseudohypoparathyroidism	ˌsuː.doʊˌsuː.doʊˌhaɪ.poʊ.pæɹ.əˈθaɪ.ɹɔɪd.ɪzəm
osaka	oʊˈsɑ.kə
chrysotile	ˈkɹɪs.ə.tɪl
gratuitously	ɡɹəˈtu.ə.təs.li
grudging	ˈɡɹʌ.dʒiŋ
parthenon	ˈpɑːɹθənɑːn
paykan	ˈpeɪkɑːn
funnier	ˈfʌniɚ
disconcertingly	ˌdɪskənˈsɝtɪŋli
tectiform	ˈtɛk.tə.fɔɹm
branson	ˈbɹænsən
hot mess	ˌhɑt ˈmɛs
drawbar	ˈdɹɔ.bɑɹ
absolute alcohol	ˈæb.səˌlut ˈæl.kə.hɑl
carey	ˈkɛəɹi
combinatorial	ˌkɑm.bɪ.nəˈtɔɹ.i.əɫ
stylize	ˈstaɪlaɪz
fatuously	ˈfætʃ.u.əs.li
flawlessly	ˈflɑː.ləs.li
shaddock	ˈʃædək
amplifiers	ˈæm.plə.faɪ.əɹz
monseigneur	mɒnˈsinjəɹ
traceable	ˈtɹeɪsəbəl
fictionalization	ˌfɪk.ʃən.əl.əˈzeɪ.ʃən
belvedere	ˈbɛl.vəˌdɪɹ
flashbulb	ˈflæʃbʌlb
orchis	ˈɔɹ.kɪs
foreknow	ˌfɔɹˈnoʊ
accretionary	ə.ˈkɹi.ʃə.ˌnɛɹ.i
kayla	ˈkeɪ.lə
flyblown	ˈflaɪˌbloʊn
config	ˌkənˈfɪɡ
shiraz	ʃɚˈɑːz
corvee	kɔːɹˈveɪ
ligase	ˈlaɪɡeɪz
stage whisper	ˈsteɪdʒ ˈwɪs.pɚ
coming out	ˈkʌmɪŋˈaʊt
disquietude	dɪˈskwaɪə.tud
osm	ˈɔs.əm
forevermore	fɔːɹˈɛv.ɚ.mɔːɹ
chernobyl	tʃɚˈnoʊbəl
pho	foʊ
copepoda	ˌkoʊpəˈpoʊdə
formalist	ˈfɔɹml̩ˌɪst
sunflowers	ˈsʌn.ˌflaʊ.ɚz
headphone	ˈhedfoʊn
earpiece	ˈɪɹpiːs
pinocchio	pɪˈnoʊki.oʊ
marvellously	ˈmɑɹvələsli
ortolan	ˈɔɹ.tə.læn
otolaryngologist	ˌoʊ.toʊ.lɛɚ.ɪŋˈɡɑ.lə.d͡ʒɪst
romcom	ˈrɑmkɑm
phonogram	ˈfɒnəˌɡɹæm
majordomo	ˌmeɪ.dʒɚˈdoʊ.moʊ
gorged	ɡɔːɹdʒd
oakleaf	ˈoʊkˌlif
fœtors	ˈfiːtɔɹz
grover	ˈɡɹoʊvɚ
brodie	ˈbɹoʊdi
misappropriate	ˌmɪs.əˈpɹoʊ.pɹi.eɪt
heartbreaker	hɑɹt.bɹeɪ.kɚ
enchasten	ɛnˈt͡ʃeɪsən
comitadji	kɑmɪˈtædʒi
presumably	pɹɪˈzuːməbli
freeborn	ˈfɹiˌbɔ(ə)n
decuple	ˈdɛkjʊpɫ
lester	ˈlɛstɚ
harmlessly	ˈhɑɹmləsli
auton	ˈɑ.tɑn
tko	ˈti ˈkeɪ ˈoʊ 
incontrovertibly	ˌɪnˌkɑn.tɹəˈvɝ.tə.bli
sacagawea	ˌsækədʒəˈwi.ə
institutionally	ˌɪnstɪˈtjuʃənəli
bagger	ˈbæɡɚ
corbie step	ˈkɔːɹbi ˌstɛp
sheers	ʃɪɹz
dedicatory	ˈdɛdəkəˌtɔɹi
deflationary	dəˈfleɪʃənəɹi
defog	diːˈfɑɡ
dehydrated	dəhˈaɪdɹeɪtəd
obviousness	ˈɑ(b)viəsnɪs
opportunely	ˌɑ.pɚˈtun.li
overpopulation	ˌoʊvɚˌpɑpjəˈleɪʃ(ə)n
precognitive	pɹiˈkɑɡ.nə.tɪv
picturesquely	ˌpɪkt͡ʃəˈɹɛskli
acai	əˈsaɪ.i
repechage	ˌɹɛp.əˈʃɑʒ
hermione	ˈhɝˈmaɪ.ə.ni
curaçao	ˌkuːɹəˈsaʊ
intercrural	ɪntɚˈkɹuɹəl
retroactively	ˌɹɛtɹoʊˈæktɪvli
unionized	ˈjunjənaɪzd
crêpy	ˈkɹeɪpi
take by storm	ˌteɪk baɪ ˈstɔːɹm
archimedean	ˌɑːɹkɪˈmiːdi.ən
woofs	wʊfs
intermediates	ɪn.tɚˈmi.di.əts
doorframes	ˈdɔɹˌfɹeɪmz
depolymerization	diˌpɑliməɹɪˈzeɪʃən
corgwn	ˈkɔɹɡun
maddison	ˈmædɪsən
firebrand	ˈfaɪɚ.bɹænd
petaflop	ˈpɛtəflɑp
teraflop	ˈtɛɹəflɑp
allopathic	ˌæl.oʊˈpæθ.ɪk
intermeddle	ˌɪntɚˈmɛdəl
aires	eɹz
internet	ˈɪntɚˌnɛt
wikipedia	ˌwɪkiˈpiːdi.ə
nominalize	ˈnɑmənəlaɪz
broch	ˈbɹɑx
landon	ˈlændən
pollard	ˈpɑ.lɚd
homburg	ˈhɑm.bɚɡ
otis	ˈoʊtɪs
tempos	ˈtɛmpoʊz
moloch	ˈmoʊlɑk
legalist	ˈli.ɡəl.ɪst
stylites	ˈstaɪlaɪts
alcazar	ˌælkəˈzɑɹ
malik	məˈlik
abstract expressionism	ˈæbˌstɹækt ɪkˈspɹɜʃ.n̩ˌɪz.m̩
togaed	ˈtoʊɡəd
falchion	ˈfɔltʃən
timelessness	ˈtaɪmləsnəs
heartlessness	ˈhɑɹtləsnəs
tramper	ˈtɹæmpɚ
toed	toʊd
abyssopelagic	əˌbɪs.oʊ.pəˈlæ.d͡ʒɪk
proconsul	pɹoʊˈkɑn.səl
great unwashed	ˌɡɹeɪt ʌnˈwɔːʃt
honeymooner	ˈhʌn.iˌmunɚ
sophont	ˈsoʊfɑnt
leukotriene	ˌlu.koʊˈtɹaɪ.in
hoa	hoʊ
paroxysmal	pæɹ.əkˈsɪz.məl
pillbox	ˈpɪl bɑːks
placidity	pləˈsɪd.ə.ti
dolphinarium	dɑl.fɪˈnɛəɹ.i.əm
sternutatory	stɝːˈnuː.təˌtɔːɹ.i
psephocracy	psiˈfɑkɹəsi
gougers	ˈɡaʊd͡ʒ.ɚz
profuseness	pɹoʊˈfjus.nəs
nostrify	ˈnɑs.tɹə.faɪ
centring	ˈsɛn.(t)ə.ɹɪŋ
cleverest	ˈklɛvɚɪst
monsignor	mɑnˈsiː.njɚ
rager	ˈɹeɪdʒɚ
camorra	kəˈmɔɹə
mayoralty	meɪˈɔ.ɹəl.ti
roan	ɹoʊn
balthazar	ˈbælθəˌzɔɹ
sherpa	ˈʃɝpə
pass muster	ˌpæs ˈmʌs.tɚ
asker	ˈæsk.ɚ
lightfast	ˈlaɪtfæst
humph	hʌmf
antonomasia	ˌæntənəˈmeɪʒə
wherealong	ˌʍɛɹ.əˈlɔŋ
biatch	bi.ˈɑtʃ
creätures	kɹiːˈeɪt͡ʃɚz
detritivorous	ˌdɛtɹəˈtɪvəɹəs
barbaresco	ˌbɑɹbəˈɹɛskoʊ
barolo	bəˈɹoʊloʊ
ingrown	ɪnˈɡɹoʊn
blancmange	bləˈmɑn(d)ʒ
malvasia	ˌmælvəˈsi.ə
pinot	ˈpiːnoʊ
curaçao	ˈk(j)ʊəɹ.əˌsaʊ
deflocculate	dəˈflɑkjuleɪt
discordianism	dɪsˈkɔɹdi.ənɪzəm
baulk	bɔk
coaled	koʊld
africa-eurasia	ˈæf.ɹɪk.ə.jʊɹˈeɪ.ʒə
menstruous	ˈmɛnstɹʊəs
slashing	ˈslæʃɪŋ
psilophyte	ˈsaɪləˌfaɪt
bastian	ˈbæsti.ən
abatjour	ˌɑˌbɑˈʒʊ.ɚ
labefaction	ˌlæb.əˈfæk.ʃən
pitchpole	ˈpɪtʃpoʊl
-log	lɒɡ
busy as a bee	ˈbɪziæzəˈbiː
abelian group	əˈbi.li.ən ɡɹup
geoscientist	ˌdʒioʊˈsaɪəntɪst
arno	ˈɑɹnoʊ
eager beaver	ˌi.ɡɚ ˈbi.vɚ
macroworld	ˈmækɹoʊˌwɝld
flowtop	ˈfloʊtɑp
transendothelial	ˌtɹænzɛndoʊˈθiliəl
theosophical	ˌθi.əˈsɑ.fɪ.kəl
earless	ɪɹləs
earless	ɝlɛs
downloadable	ˌdaʊnˈloʊd.ə.bl̩
bosonic	boʊˈsɑnɪk
fluoroalkyl	flɔɹoʊˈælkɪl
oaxaca	wə.ˈhæ.kə
somite	ˈsoʊmaɪt
markovian	mɑɹˈkoʊvi.ən
detrital	diˈtɹaɪtəl
processivity	pɹɑsɛˈsɪvəti
bouncier	ˈbaʊnsiɚ
cortico-	ˈkɔɹ.tɪ.koʊ
checkbox	ˈtʃɛkbɑks
mundungus	ˌmənˈdəŋɡəs
tokay	toʊˈkeɪ
tokay	toʊˈkeɪ
amberjack	ˈæm.bɚ.dʒæk
quorums	ˈkwɔːɹ.əmz
aeneid	ˈiː.ni.ɪd
abozzo	əˈbɔt.si
abrash	ˈɑ.bɹəʃ
euler	ˈɔɪlɚ
alevin	ˈæl.ə.vən
ideolog	ˈaɪ.di.əl.ɑɡ
luminesce	lumɪˈnɛs
wiktionary:votes/2007-10/lemma entries/words	wɝdz
hobson-jobson	ˌhɑb.sənˈdʒɑb.sən
zaatar	ˈzɑtɑɹ
antinomianism	æntiˈnoʊmi.ənɪzəm
madarotic	ˌmæd.əˈɹɑt.ɪk
japonica	dʒə.ˈpɑn.ɪ.ˌkə
yeller	ˈjɛlɚ
spherule	sfɪɹjuːl
evolutions	ˌɛvəˈluʃənz
captain planet	ˈkæptɪn ˈplænət
abiotically	ˌeɪ.baɪˈɑt.ɪk.li
ablatively	ˌæb.lə.ˈtaɪv.li
abstractable	əbˈstɹækt.ə.bl̩
acceleratingly	æk.ˈsɛl.ə.ˈɹeɪt.ɪŋ.li
accreditable	ə.ˈkɹɛd.ət.ə.bəl
accursedly	ə.ˈkɚ.səd.li
omgwtfbbq	oʊmaɪɡɑːdwətðəfəkbɑːɹbɪkjuː
garuda	ɡəˈɹuːdə
blunderbusses	ˈblʌndəɹbʌsɪz
europanto	jɝ.əˈpɑ.no
acadia	əˈkeɪ.di.ə
gunnel	ˈɡʌnl
comfortless	ˈkʌm.fɚt.ləs
obdormition	ɑb.dɔːɹˈmɪ.ʃən
underlip	ˈʌndɚˌlɪp
parison	ˈpɛɹəsən
niello	niˈɛloʊ
holla	ˈhɑlə
church key	ˈtʃɝtʃ.ki
myrmecophyte	ˈməɹməkoʊˌfaɪt
sociopathy	ˈsoʊ.si.əˌpæθi
abortogenic	əˈbɔɹ.təˌd͡ʒɛ.nɪk
disco ball	ˈdɪskoʊ ˌbɑːl
usar	ˈju.sɑɹ
abstractor	æbˈstɹæk.tɚ
golds	ɡoʊldz
necrophagous	nɛˈkɹɑ.fə.ɡəs
couldn't've	ˈkʊdəntəv
abortee	ə.bɔɹˈti
accruable	ə.ˈkɹu.ə.bəl
accumulable	ə.ˈkjum.jə.lə.bəl
thereatop	ˌðɛəɹəˈtɒp
licker	ˈlɪkɚ
accruement	ə.ˈkɹu.mənt
abrader	əˈbɹeɪ.dɚ
ensmallen	ɪnˈsmɔːlən
ensmallen	ɛnˈsmɔlən
aughts	ɑːts
ishikawa diagram	ˌɪ.ʃiˈkɑ.wɑ ˈdaɪ.ə.ɡɹæm
attache	æ.tæˈʃe
lambchop	ˈlæm.tʃɑp
streisand effect	ˈstɹaɪ.sænd əˌfɛkt
drygulch	ˈdɹaɪ.ɡʌltʃ
beseemeth	bəˈsiː.məθ
wowzers	ˈ waʊ̯.zɚz
amberjacks	ˈæm.bɚ.dʒæks
gideon	ˈɡɪd.i.ən
pontus	ˈpɑːntəs
pansexuality	ˌpænsɛkʃuˈælɪti
aerophyte	ˈɛ.ɹoʊˌ.faɪt
bathwater	ˈbæθwɔtɚ
-'s	ɪz
wormily	ˈwɝ.mə.li
aboil	əˈbɔɪl
lambrusco	[læm.ˈbɹʊs.koʊ]
breathability	ˌbɹiː.ðəˈbɪl.ə.ti
pyrophyte	ˈpaɪɹəˌfaɪt
anthropological	æn.θɹə.pə.ˈlɑdʒikəl
abubble	əˈbʌb.l̩
abstentionism	æbˈstɛn.ʃn̩.ɪz.m̩
abstentionist	æbˈstɛn.ʃn̩.ɪst
normothermic	nɔɹmoʊˈθɝmɪk
dog eat dog	dɔɡ it dɔɡ
rebutter	ɹɪˈbʌtɚ
catawampus	ˌkætəˈwɑmpəs
septagon	ˈsɛptəɡɒn
sloe gin	ˈsloʊ ˌdʒɪn
custardy	ˈkʌstɚdi
leiden	ˈleɪdən
mandarin duck	ˈmændəɹɪn dʌk
arm wrestling	ˈɑɹm ˌɹɛs.lɪŋ
activistic	æk.tɪˈvɪst.ɪk
laths	læθs
northern mariana islands	ˈnɔɹ.ðɚn ˌmɛɹ.iˈæn.ə ˈaɪ.ləndz
whyever	waɪˈɛvɚ
nomas	ˈnoʊ.mæs
norwalk	ˈnɔ(ː)ɹ.wɔːk
throwbacks	ˈθɹoʊ.bæks
acrocyanosis	ˌæ.kɹoʊ.ˌsaɪ.ə.ˈnoʊ.sɪs
flouting	[ˈflaʊ̯ɾɪŋ]
königsberg	ˈkɜnɪɡzˌbɝɡ
brumaire	bɹʊˈmɛəɹ
frimaire	fɹiˈmɛəɹ
nivôse	niˈvoʊz
pluviôse	ˈpluvioʊs
ventôse	vɑnˈtoʊz
germinal	ˈdʒɝmənəl
floréal	ˌflɔɹeɪˈɑl
prairial	pɹɛɹˈjɑl
messidor	ˌmɛsɪˈdɔɹ
thermidor	ˈθɝmədɔɹ
fructidor	ˌfɹʊktəˈdɔɹ
vendémiaire	ˌvɑndəˈmjɛəɹ
mahabharata	mə.hɑˈbɑ.ɹə.tə
guilelessness	ˈɡaɪl.lɪs.nɪs
acacia gum	əˈkeɪ.ʃə ɡʌm
aerophytes	ˈɛ.ɹoʊˌ.faɪts
spherical aberration	ˈsfɪɹ.ɪk.l̩ ˌæb.əˈɹeɪ.ʃn̩
trichotomy	tɹaɪˈkɑt.ə.mi
omphaloskeptic	ˌɑːm.fəl.əˈskɛp.tɪk
captain obvious	ˌkæptən ˈɑbviəs
money talks	ˈmʌn.i tɔks
rapa nui	ˈɹɑpə ˈnui
lolcat	ˈlɑl.kæt
acculturative	ə.ˈkʌl.tʃə.ˌɹeɪt.ɪv
dialer	ˈdaɪ(ə)lɚ
trading card	ˈtɹeɪd.ɪŋ ˌkɑɹd
toco	ˈtoʊ.koʊ
coarticulation	ˌkoʊ.ar.tɪk.ju.ˈleɪ.ʃən
sarcomere	ˈsɑɹ.koʊˌmɪɹ
morning-land	ˈmɔɹ.nɪŋ.lænd
yardbird	ˈjɑɹd.bɝd
becker	ˈbɛkɚ
mona lisa	ˌmoʊnə ˈlisə
tesselate	[ˈtʰɛsɫleɪtʰ]
abacisci	ˌæb.ə.ˈsɪ.ˌsaɪ
rheophyte	ˈɹi.əˌfaɪt
absorptance	æbˈsɔɹp.tn̩s
absorptance	æbˈsɔɹp.tn̩ts
absorption spectrum	æbˈsɔɹp.ʃn̩ ˈspɜk.tɹəm
bigelow	ˈbɪɡəloʊ
purls	pɝlz
mopper	ˈmɒpəɹ
abietate	ˈæb.i.əˌteɪt
dialectician	ˌdaɪəlɛkˈtɪʃn
ace inhibitor	ˈeɪs ɪnˌhɪb.ɪ.tɚ
bromite	ˈbɹoʊmaɪt
mynheer	maɪnˈhɛ(ə)ɹ
abonnement	æˈbɔn.mɑ̃
vive la différence	ˌvivə lɑ ˌdɪfəˈɹɑns
skanks	skæŋks
convo	ˈkɑnvoʊ
come in	kʌm ˈɪn
abris	ɑ.ˈbɹi
mesophyte	ˈmɛzəˌfaɪt
ob-gyn	oʊ.biˈdʒɪn
ob-gyn	oʊ.bi.dʒi.waɪˈɛn
ob-gyn	ɑbˈɡaɪn
cephalic	sɪˈfælɪk
foaled	foʊld
gasless	ˈɡæsləs
king james version	ˌkɪŋ ˈdʒeɪmz ˌvɝː.ʒən
lenape	ləˈnɑːpi
wittier	ˈwɪtiɚ
mikveh	ˈmɪkvə
whitlow	ˈʍɪt.loʊ
moe	moʊ
charpoy	ˈtʃɑɹpɔɪ
tulwar	ˈtʌlwɑɹ
havildar	ˈhævɪldɑɹ
flexuous	ˈflɛkʃ(ə)wəs
anastomose	əˈnæs.təˌmoʊz
anastomosing	əˈnæs.təˌmoʊ.zɪŋ
haxor	ˈhæk.zoʊɹ
ableist	ˈeɪ.bəl.ɪst
absorbancy	æbˈsɔɹ.bn̩.si
gerber	ˈɡɝbɚ
lollygagger	ˈlɑlɪˌɡæɡɚ
microsome	ˈmaɪk.ɹə.soʊm
quartan	ˈkwɔɹtən
selectable	səˈlɛktəbl̩
semasiology	sɪmeɪsiˈɑlədʒi
sciophyte	ˈsaɪəˌfaɪt
rhodophyte	ˈɹoʊdəˌfaɪt
protophyte	ˈpɹoʊdəˌfaɪt
prasinophyte	pɹəˈzɪnəˌfaɪt
phreatophyte	fɹiˈædəˌfaɪt
skiophyte	ˈsaɪəˌfaɪt
osteophyte	ˈɑstioʊˌfaɪt
nanophanerophyte	ˌnænoʊˈfænəɹəˌfaɪt
microphyte	ˈmaɪkɹoʊˌfaɪt
microgametophyte	ˈˌmaɪkɹoʊɡəˈmidəˌfaɪt
metaphyte	ˈmɛdəˌfaɪt
megagametophyte	ˌmɛɡəɡəˈmitəˌfaɪt
cryptophyte	ˈkɹɪptəˌfaɪt
fucktarded	fʌkˈtɑɹd.əd
general knowledge	ˈdʒɛnəɹəl ˈnɑlɪdʒ
backwash	ˈbæk.wɑʃ
traceless	ˈtɹeɪsləs
hyperbolize	haɪˈpɚːbəlaɪz
kiss-ass	ˈkɪsˌæs
stradivarius	ˌstɹædəˈvɛɹi.əs
abiturient	æ.bit.u.ɹiˈɛnt
glucagon	ˈɡlukəˌɡɑn
buffly	ˈbʌf.li
what up	wʌt ˈʌp
date night	ˈdejtˌnɑjt
deregulatory	diːˈɹɛɡjulətɔɹi
gerontic	dʒɛˈɹɑːnt.ɪk
keats	ˈkits
hierocracy	haɪəˈɹɑkɹəsi
plantocracy	plænˈtɑkɹəsi
dogpile	ˈdɔɡ ˌpaɪl
crocodile tears	ˈkɹɑkədaɪl ˌtɪɹz
icann	ˈaɪ.kæn
okie	ˈoʊ.ki
visualise	ˈvɪʒuəlaɪz
dardic	dɑɹdɪk
deflocculation	dəˌflɑkjuˈleɪʃən
nietzschean	ˈni.t͡ʃi.ən
deerstalker hat	diɚstɔkɚ hæt
ily	ˈɪli
abiogenic	ˌeɪ.baɪ.oʊˈd͡ʒɛ.nɪk
aboideau	ɑ.bwɑ.doʊ
desinence	ˈdɛsənəns
haltere	ˈhæltɪɹ
dvořák	dvoʊˈɹæːk
nitchie	ˈnitʃi
da bomb	dəˈbɑːm
baal	ˈbɑːl
tear off	teɪɹ ɑf
hello there	hɛˈloʊ̯ ðɛɚ
leopard seal	ˈlɛpɚd siːl
pocks	pɑks
burgundian	bɜːɹˈɡʌndɪən
scanlon	ˈskænlən
hypermiling	ˈhaɪpə˞maɪlɪŋ
mouton enragé	ˈmu.tɑ̃ ɑ̃.ɹɹɑˈʒeɪ
ablow	əˈbloʊ
macroeconomic	ˌmækɹoʊˌɛkəˈnɑːmɪk
vantage points	ˈvæntɪd͡ʒ ˌpɔɪ̯nts
undergrounder	ˌʌn.dɚˈɡɹaʊn.dɚ
gelateria	dʒəˌlætəˈɹi.ə
knar	nɑɹ
sanitizer	ˈsænɪtaɪzɚ
centesimal	sɛnˈtɛsəməl
chaucerian	tʃɔˈsɪɹi.ən
idioglottic	ˌɪdioʊˈɡlɑtɪk
responseless	ɹɪˈspɑnsləs
polyarch	ˌpɑliˈɑɹk
viscacha	vɪˈskɑtʃə
cumberground	ˈkʌm.bɚ.ɡɹaʊnd
bashkortostan	[bɑʃˈkɔɹtoə̯stɛən]
abakan	ˌɑ.bəˈkɑn
rogation	ɹoʊˈɡeɪ.ʃən
negawatt	ˈnɛɡ.ə.wɑt
belter	ˈbɛltɚ
laccolith	ˈlækəlɪθ
lopolith	lɒpəliθ
intersectional	ˌɪn.təɹˈsɛk.ʃə.nl̩
hematophagy	ˌhi.məˈtɑf.ə.dʒi
befriender	bɪˈfɹɛndɚ
ovoviviparous	ˌoʊvoʊvɪˈvɪpəɹəs
katharometer	kæθəɹɒmitəɹ
spadassinicide	ˌspɑd.əˈsɪ.nɪ.seɪd
birdishly	ˈbɝdɪʃli
tuna	ˈtu.nə
myotomy	maɪˈɑ.tə.mi
anselm	ˈænˌsɛlm
logodaedaly	ˌloʊ.ɡoʊˈdi.də.li
preconfigure	pɹekənˈfɪɡ(j)ɚ
abscisic	æbˈsɪ.sɪk
specifier	ˈspɛsəˌfaɪɚ
aandblom	ˈɑnt.blɑm
farro	ˈfæɹoʊ
malvoisie	ˌmɑlˌvwɑˈzi
malmsey	ˈmɑ(l)mzi
barlow	bɑɹloʊ
kwassa kwassa	ˈkwɑs.ə ˈkwɑs.ə
peepy	ˈpi.pi
abseiler	ˈɑpˌzaɪ.lɚ
constitutionalism	ˌkɑnstɪˈtuʃənəˌlɪzəm
camo	ˈkæ.moʊ
assessee	əsɛsˈi
oaky	ˈoʊki
breasticle	ˈbɹɛstɪkl
hypotrochoid	ˌhaɪ.poʊˈtɹoʊ.kɔɪd
interoceanic	ˌɪntəɹˌoʊʃiˈænɪk
torrefy	ˈtɔ.ɹɪ.faɪ
yech	[jɛx]
weretiger	ˈwɛɹtaɪɡɚ
wererat	ˈwɛɹæt
logological	ˌlɑɡ.oʊˈlɑdʒ.ɨ.kəl
cruces	ˈkɹu.siz
svarabhakti	ˌsvɑɹəˈbɑkti
proditorious	pɹɑd.ɪ.ˈtɔ.ɹi.əs
ye olde	ðiː əʊld
ye olde	ði oʊld
ye olde	jiː əʊld(i)
ye olde	ji oʊld
rhyparography	ɹɪ.pəˈɹɑ.ɡɹə.fi
palettise	ˈpælɪtaɪz
y'see	jəˈsi
wroclaw	ˈvɹɔts.wɑf
otherworld	ˈʌðɚˌwɝld
epicness	ˈɛ.pɪk.nəs
oligomenorrhoea	ɑləɡoʊmɛnəˈɹi.ə
mister	[ˈmɪstɚ]
doodly-squat	ˈdu.dəli skwɑt
hey rube	heɪ ɹub
moral high ground	ˌmɔɹəl ˈhaɪ ɡɹaʊnd
markhor	ˈmɑɹkɔɹ
replate	ɹiˈpleɪt
do do	ˈdu du
olecranon	oʊˈlɛkɹəˌnɑn
quarryman	ˈkwɔɹ.i.mən
jimmer	ˈdʒɪməɹ
ecmascript	i.si.ɛmˈeɪ skɹɪpt
xoanon	ˈzoʊ.ə.nɑn
guillain-barré syndrome	ɡiːˈæn bəˈɹeɪ ˈsɪndɹoʊm
asturias	æsˈtʊɹ.i.əs
warta	ˈvɑɹtə
archimedes	ˌɑːɹkɪˈmiːdiːz
palettize	ˈpælɪtaɪz
monomachy	məˈnɑməki
butterfish	ˈbʌtəɹfɪʃ
moqui	ˈməʊ.ki
metanalysis	mɛtəˈnæləsəs
panipuri	ˌpɑniˈpʊɹi
fatless	ˈfætləs
carders	ˈkɑɹ.dɚz
fruitions	fɹu.ˈɪʃ.əns
whitlows	ˈwɪt.loʊz
happy birthday	ˈhæpi ˈbɝθ.deɪ
tarter	[ˈtɑɹ.ɾɚ]
epitomic	[ˌɛ.pɪ.ˈtɑm.ɪk]
abonnements	æˈbɔn.mɑ̃
abiosis	eɪ.biˈoʊ.sɪs
unselectable	ˈʌnˌsəˈlɛktəbl̩
no'm	ˈnoʊəm
objurgatory	ɒbˈd͡ʒʌɹ.ɡə.tɒ.ɹi
squirrelled	ˈskwɝld
gameboard	ˈɡeɪm.bɔɹd
ender	ˈɛndə(ɹ)
ender	ˈɛndɚ
teosinte	tiːoʊˈsɪnteɪ
kirby	ˈkɝbi
absquatulation	æbˈzkwɑt͡ʃ.ʊ.leɪ.ʃn̩
illinoisan	ˌɪləˈnɔɪən
paparazza	ˌpɑpəˈɹɑtsə
sideboob	ˈsaɪdbub
unergative	ʌnˈɝɡətɪv
macdonald	məkˈdɑnəld
oogone	ˈoʊoʊˌɡoʊn
aboutness	əˈbaʊt.nəs
oviform	ˈoʊ.vɚfɔɹm
oviform	ˈoʊ.viːfɔɹm
scrunt	skɹʌnt
misfeature	ˌmɪsˈfiː.t͡ʃɚ
monothetic	mɑnəˈθɛdɪk
horizontal mambo	ˌhɔː.ɹəˈzɑːn.təl ˈmɑm.boʊ
depositary	dɪˈpɑzɪtɛɹi
shakespeareana	ʃeɪkˌspɪɹiˈænə
noctule	ˈnɑktʃul
malbec	mælˈbɛk
dialogical	ˌdaɪ.əˈlɑ.d͡ʒɪ.kəɫ
teotihuacan	ˈteɪ.oʊˌti.wɑˈkɑn
absorptiometer	æbˌsɔɹp.ʃiˈɑm.ə.dɚ
absorptiometer	æbˌsɔɹp.tiˈɑm.ə.dɚ
segmenting	ˈsɛɡ.mɛn.tɪŋ
primmer	ˈpɹɪm.ɚ
thelytoky	θəˈlɪt.ə.ki
babbies	ˈbæ.biz
epiphenomena	ˌɛp.ə.fəˈnɒm.əˌnə
maskless	ˈmæskləs
flirty	ˈflɜɹti
clams up	ˈklæmˈzʌp
bordelaise	ˌbɔɹdəˈleɪz
baclofen	bæˈkloʊ.fɪn
abundancy	əˈbʌn.dn̩.si
acanthocyte	əˈkæn.θoʊˌsaɪt
hygrothermal	haɪ.ɡɹoʊ.θɝm.əl
hell hath no fury like a woman scorned	hɛl hæθ noʊ ˈfjʊɹi laɪk ə ˈwʊmən skɔɹnd
badelynge	ˈbæd.lɪŋ
melodeon	məˈloʊdi.ən
maccabee	ˈmæk.kəˌbi
tom jones	ˌtɑm ˈdʒoʊnz
zzzs	ziz
appellee	ˈæpəli
paralinguistic	ˌpæɹəlɪŋˈɡwɪstɪk
magdeburgian	ˌmæɡdəˈbɝɡi.ən
heigh-ho	ˈhaɪˈhoʊ
acanthoses	æˌkænˈθoʊ.sis
ablastin	əˈblæs.tən
interregna	ˌɪntəɹˈɹɛɡnə
interregnums	ˌɪntəɹˈɹɛɡnəmz
baster	ˈbeɪstɚ
trannies	ˈtɹæ.niz
cross-dressers	ˈkɹɔsˌdɹɛ.sɚz
crewmember	kɹuːˈmɛmbɚ
cardio	ˈkɑɹ.di.oʊ
renin	ˈɹi.nɪn
aberrative	ˈæb.əˌɹeɪd.ɪv
revanchism	ɹəˈvɑn(t)ʃɪz(ə)m
gapless	ˈɡæpləs
filenames	faɪlneɪms
storages	ˈstɔɹəd͡ʒəz
acanthamoeba	əˌkæn.θəˈmi.bə
pergamentaceous	ˌpɚɡəmənˈteɪʃəs
micrite	ˈmɪkɹaɪt
affrication	æfɹɪˈkeɪʃən
seljuk	sɛlˈdʒuːk
bizarreness	bɪ.ˈzɑɹ.nəs
rivalrous	ˈɹaɪvəlɹəs
editress	ˈɛdɪtɹəs
scannable	ˈskænəbəl
outwardness	ˈaʊtwɚdnɪs
dewar	ˈduː.əɹ
abnormalness	æbˈnɔɹ.ml̩.nəs
bonheur du jour	bəˌnɝ d(j)u ˈʒʊɹ
contentful	ˈkɑn.tɛnt.fəɫ
minorly	maɪ.nɚ.li
hoverboard	ˈhʌvɚbɔɹd
phrenitis	fɹəˈnaɪdəs
makiwara	ˌmɑ.kiˈwɑ.ɹə
chytrid	ˈkɪtɹɪd
absentee ownership	ˌæb.sn̩ˈti ˈoʊ.nɚˌʃɪp
squonk	skwɑŋk
allomother	ˈæləˌmʌðɚ
baroque	bəˈɹoʊk
plasmodiocarp	plæzˈmoʊdioʊˌkɑɹp
werebear	ˈwɛɹbɛɹ
hirquine	ˈhɝkwaɪn
goober	ˈɡubəɹ
ern	ɝn
viraginous	vɨˈɹæ.dʒɪn.əs
coachability	koʊtʃəˈbɪlɪti
sofa-bed	ˈsoʊfəbɛd
kilopond	ˈkɪləˌpɑnd
worthful	ˈwɚθ.fɫ̩
stylesheet	staɪlʃit
trackable	ˈtɹækəbəl
aborally	æbˈɔɹ.ə.li
brattily	ˈbɹætɪli
palletise	ˈpælɪtaɪz
palletize	ˈpælɪtaɪz
goji	ˈɡoʊ.dʒi
saltwort	ˈsɑlt.wɔɹt
nerdcore	ˈnɝdˌkɔɹ
nonogram	ˈnɑːnəɡɹæm
towable	ˈtoʊ.ʌ.blə
manslot	ˈmænzlɑt
converb	ˈkɑn.vɝb
capless	ˈkæpləs
injera	ɪnˈdʒɛɹə
forthy	fɚˈðaɪ
luger	ˈluɡɚ
ablepharia	æb.l̩ˈfeɪ.ɹi.ə
polymeric	ˌpɑliˈmɛɹɪk
mylar	ˈmaɪlɑɹ
combinatorially	kɑm.bɪ.nəˈtɔɹ.i.ə.li
marchland	ˈmɑɹt͡ʃ.lænd
ablepharon	æˈblɛf.ə.ɹɑn
ablepharous	æˈblɜf.ə.ɹʌs
portuguese water dog	ˌpɔɹtʃəɡiːz ˈwɔtɚ dɔɡ
celebutard	səˈlɛbjutɑɹd
spanish water dog	ˌspænɪʃ ˈwɔtɚ dɔɡ
mariengroschen	məˈɹi.ənˌɡɹoʊʃən
boykin	ˈbɔɪkən
contentless	ˈkɑn.tɛnt.lɪs
whichsoe'er	ˌwɪtʃsoʊˈɛɹ
epergne	iˈpɝn
hardy har har	ˈhɑɹɾiˈhɑɹˈhɑɹ
glassless	ˈɡlæsləs
aboideaux	ɑ.bwɑ.doʊ
catless	ˈkætləs
eiffel	ˈaɪfl̩
overprotection	ˌoʊvɚpɹəˈtɛkʃən
parleyvoo	ˌpɑɹ.liˈvu
still and all	ˈstɪləˌnɔl
nuer	ˈnuɚ
mastless	ˈmæstləs
ingrowth	ˈɪnˌɡroʊθ
flagless	ˈflæɡləs
iatrogenesis	aɪˌætɹoʊˈdʒɛnɪsɪs
ensiform	ˈɛnsəˌfɔɹm
werehyena	ˈwɛɹhaɪˌiːnə
rösti	ˈɹɔsti
acquisitory	əˈkwɪzɪˌtɔɹi
palilalia	ˌpælɪˈleɪliə
philerast	ˈfɪləˌɹæst
costello	kɑˈstɛloʊ
mayblossom	ˈmeɪˌblɑsəm
counterplot	ˈkaʊn.tɚ.plɑt
abducens nerve	æbˈduˌsɛnz nɚv
alkalied	ˈæl.kə.laɪd
hoatzin	ˈwɑːtsɪn
adless	ˈædləs
baudelairean	ˌboʊdəˈlɛɹi.ən
oh my goodness	oʊ maɪ ˈɡʊdnəs
abortorium	æ.bɔɹˈtɔ.ɹi.əm
volumize	ˈvɑl.ju.maɪz
casteless	ˈkæstləs
dialetheism	ˌdaɪ.əˈlɛθ.i.ɪz.əm
necessitous	nəˈsɛ.sə.təs
noemata	noʊˈimətə
ashkenazim	ˌɑːʃkɪˈnɑːzɪm
pædomorphic	ˌpiːdəˈmɔɹfɪk
stache	stæʃ
fliver	ˈflɪvɚ
universalism	ˌjuːnəˈvɝsəlˌɪzəm
pars distalis	ˌpɑɹz dɪsˈtælis
première danseuse	pʁəmjɛʁ dɑ̃søz
hellespont	ˈhɛl.ɪs.pɑnt
saturniid	səˈtɚ.ni.ɪd
abrin	ˈeɪ.bɹən
toke tube	təʊk tuːb
stendhalian	stɛ̃ˈdɑli.ən
catloaf	kæt.loʊf
bicrural	ˌbaɪˈkɹʊɹ.əl
larper	ˈlɑɹ.pɚ
expectedly	ɪkˈspɛktɪdli
digitonin	dɪdʒɪˈtoʊnɪn
mapless	ˈmæpləs
austenesque	ˌɔstəˈnɛsk
alexandrite	ˌæl.ɪɡ.ˈzæn.dɹaɪt
whom're	ˈʍuːməɹ
wut	wʌt
-ency	-ɪnsɪ
combinational	kambɨˈnejʃɨnəl
cum dumpster	kʌm dʌmpstɚ
latitudinarian	lædɪtuːdəˈnɛɹi.ən
prosiopeses	ˌpɹɑsioʊˈpisiz
panthea	ˈpænθiˌa
abat-voix	ɑ.ˌbɑv.ˈwɑ
abat-voix	ɑ.ˌbɑv.ˈwɑz
eleazar	ˈɛləˌzɔɹ
calydon	ˈkælɪˌdɒn
mtso	mɛtsoʊ
grith	ɡɹɪθ
milford	mɪlfəɹd
rendevous	ˈɹɑndəˌvu
jabberwocky	ˈdʒæbɚˌwɔki
whetter	ˈwɛtɚ
friend zone	ˈfɹɛnd zoʊn
simonides	saɪˈmɑːnɪdiːz
pindar	ˈpɪndɚ
perseverative	pɚˈsɛvɚˌɹeɪtɪv
opah	ˈoʊpə
kozachok	kəˌzɑˈtʃɔk
bouncing castle	ˌbaʊnsɪŋ ˈkæsəl
-xeny	-ksəni
iridocyclitis	ˈiɹɨdoʊsɨˌklaɪtəs
synechia	sɪˈnɛk.i.ə
feet-first	fiːt.fɝst
cryptolect	ˈkɹɪptəˌlɛkt
gawd	[ɡɔːd]
hashtag	ˈhæʃˌtæɡ
cornify	ˈkɔɹ.nɪ.faɪ
tolyatti	tɔlˈjɑti
hokkaidō	hɑ.ˈkaɪ.doʊ
bolo	ˈboʊ.loʊ
bagless	ˈbæɡləs
premier danseur	pʁəmje dɑ̃sœʁ
parthen-	ˌpɑɹθən
acantholysis	æˌkænˈθɑ.lə.sɪs
low-down	ˈloʊ.daʊn
tatsoi	tɑtˈsɔɪ
cryptolalia	ˌkɹɪptəˈleɪliə
witcher	ˈwɪtʃɚ
neanderthal	niːˈæn.dɚˌθɑːl
neanderthal	niːˈæn.dɚˌtɑːl
neanderthal	niˈændəɹθəl
methionyl	məˈθaɪəˌnɪl
badassery	bædˈæsəɹi
supercommentary	supɚˈkɑmənˌtɛɹi
deucedly	ˈdusɨdli
heterographic	ˌhɛt.ə.ɹoʊˈɡɹæf.ik
onomatope	ˈɑnəmətoʊp
how do you pronounce this word	ˈhaʊ duː ˈjuː pɹəˈnaʊns ðɪs ˈwɝd
tchaikovsky	tʃaɪˈkɑfski
castless	ˈkæstləs
lab coat	ˈlæb ˌkoʊt
magic word	ˈmædʒɪkˌwɝd
land of nod	ˈlænd əv ˈnɑd
pauciloquy	pɔˈsɪləkwi
fauxtography	[foːˈtɑɡɹəfi]
nehru jacket	ˈneɪ.ɹu ˈdʒæk.ɪt
breadmaker	ˈbɹɛdˌmeɪkɚ
europeanism	ˌjʊɹəˈpi.ənɪzəm
poikilocytosis	ˌpɔɪ.kə.loʊˌsaɪˈtoʊ.sɪs
monophthongal	ˌmɑ.nəfˈθɑŋ.əl
enchorial	ɛnˈkɔɹ.i.əl
bʼakʼtun	ˈbɑkˌtun
abortus fever	əˈbɔɹ.təs ˈfiv.ɚ
keatsian	ˈkitsi.ən
precisive	pɹiˈsaɪ.sɪv
bradylalia	ˌbɹeɪdəˈleɪliə
terebic	təˈɹɛbɪk
electronic cigarette	ɪˌlɛkˈtʃɹɑːnɪk ˈsɪɡɚˌɛt
lacrimogenous	læk.ɹɪˈmɑdʒənəs
oro-	ˈɔɹoʊ
z-fighting	ˈziːfʌɪtɪŋ
psychopathies	saɪˈkɑpəθiz
osakan	oʊˈsɑkən
sparql	ˈspɑɹkəl
xoloitzcuintli	ˌʃoʊ.loʊ.ɪtsˈkwɪn.tli
agnathic	æɡˈnæθɪk
persepolis	pɚˈsɛpəlɪs
smuthound	ˈsmʌthaʊnd
aboiteaux	ɑ.bwɑ.toʊ
triskele	ˈtɹaɪ.skil
diplotene	ˈdɪpləˌtin
gillyflower	ˈdʒɪl.iˌflaʊɚ
isogenous	aɪˈsɑdʒənəs
bone-chilling	ˈboʊnˌtʃɪl.ɪŋ
peanutbutter	ˈpi.nʌtˌbʌ.tɚ
anacrogynous	ˌæn.əˈkɹɑ.dʒɨn.əs
acrogynous	əˈkɹɑ.dʒɨn.əs
questionary	ˈkwɛstʃənɛɹi
kerberos	ˈkɜɹbəɹəs
idiotype	ˈɪ.diː.oʊ.taɪp
melkite	ˈmɛlkaɪt
bamf	bæmf
staffless	ˈstæfləs
offlet	ˈɔflɛt
tardis	ˈtɑɹdɪs
homography	hoʊˈmɒɡɹəfi
abitur	ˌæbiˈtʊɹ
segways	ˈsɛɡwejz
borrel	ˈbɔɹəl
rendezvouses	ˈɹɑndeɪˌvuz
beauceron	ˈboʊsəˌɹɑn
weever	ˈwi.vɚ
isoleucyl	ˌaɪ.sə.ˈlu.sɪl
gower	ˈɡaʊɚ
paleo-eskimo	ˌpeɪlioʊˈɛskɪmoʊ
nominalizer	ˈnɑm.ə.nəl.aɪz.ɚ
laughless	ˈlæfləs
arteri-	ɑɹˈtɪɹi
ailuro-	aɪˈlʊɹə-
owndom	ˈoʊn.dəm
unuttered	ˌʌnˈʌtɚd
finitary	ˈfɪnɪtɛɹi
scramble competition	skɹæmbəl kɒmpətɪʃən
pseph-	psif
ab origine	æb əˈɹɪd͡ʒ.ɪ.ni
hypernatremic	ˌhaɪ.pɚ.nəˈtɹi.mɪk
thebacon	ˈθiːbəkɒn
unarm	ʌˈnɑɹm
abjoint	ˈæbˌd͡ʒɔɪnt
acaudal	eɪ.ˈkɔd.l
casanova	ˌkæsəˈnoʊvə
splash page	splæʃ peɪdʒ
abscisin	ˈæb.sə.sən
bursiform	ˈbɝsɪfɔɹm
home sweet home	hoʊm swiːt hoʊm
circumgyrate	ˌsɝ.kəmˈdʒaɪ.ɹeɪt
exteriorly	ɪkˈstɪɹiɚli
absolute time	ˈæb.səˌlut taɪm
rowan	ɹoʊən
shit stain	ˈʃɪt steɪn
schrödinger	ˈʃɹoʊdɪŋɚ
aboulic	əˈbu.lɪk
beethovenian	ˌbeɪtoʊˈvini.ən
fricandeau	ˈfɹɪkənˌdoʊ
paschal lamb	ˈpæs.kəl ˈlæm
octaval	ɑkˈteɪvəl
overshorten	ˌoʊ.vɚˈʃɔɹ.tən
variadic	vɛɹiˈædɪk
absolute space	ˈæb.səˌlut speɪs
zumba	ˈzum.bə
snackless	ˈsnækləs
sassanid	ˈsæsənɪd
na-na na-na boo-boo	ˈnæːnəˌnæːnə ˈbuːˌbuː
spontaneous abortion	spɑnˈteɪ.ni.əs əˈbɔɹ.ʃn̩
veggie burger	ˈvɛdʒijˈbɹ̩ɡɹ̩
mebos	ˈmibɔs
abnormalize	æbˈnɔɹ.məl.aɪz
tricast	tɹaɪkæst
merkel	ˈmeɹkəl
couple-close	ˈkʌp.əlˌkloʊs
iotation	aɪoʊˈteɪʃən
ipsedixitism	ˌɪpsiˈdɪksɪtɪzəm
absolutization	ˌæb.səˌlut.əˈzeɪ.ʃn̩
absolutisation	ˌæb.səˌlut.əˈzeɪ.ʃn̩
virgula	ˈvəɹɡjʊlə
buchanan	bjuˈkænən
briggs	bɹɪɡz
iatromathematical	aɪˌæt.ɹoʊ.mæ.θəˈmæ.tɪ.kəl
buller	ˈbʊləɹ
antiochene	ˌænti.əˈkiːn
zwj	ˌziˌdʌbl̩juˈdʒeɪ
antiochian	ˌæntiˈoʊkiən
antiochian	ˌæntiˈɑkiən
daegu	dæˈɡu
kardashian	[kʰɑɹˈdæʃi.ən]
affectability	əfɛktəˈbɪlɪti
ruritanian	ˌɹʊɹ.ɪˈteɪ.ni.ən
dirty words	ˈdɚɾijˌwɝdz
medievaldom	mɪdˈi.vəl.dəm
can i come in	kən ˌaɪ kʌm ˈɪn
lock on	ˌlɑk ˈɑn
chopstix	ˈtʃɑpstɪks
threonyl	ˈθɹi.ə.nɪl
nooser	ˈnusɚ
blackwell	ˈblækwɛl
quot homines tot sententiæ	ˌkwɑt ˈhɑmɪneɪz ˌtɑt sɛnˈtɛntiˌaɪ
pornograph	ˈpɔɹnəˌɡɹæf
abdominocentesis	æbˌdɑm.ɪ.noʊ.sɜnˈti.səs
abfarad	æbˈfæɹˌæd
abnormalcy	æbˈnɔɹ.ml̩.si
abohm	æbˈoʊm
abvolt	æbˈvoʊlt
abwatt	æb.wɑt
abrachia	əˈbɹeɪ.ki.ə
brachyuran	ˌbɹæk.iˈju.ɹən
i have a cold	aɪ hæv ə koʊld
quickener	ˈkwɪkənɚ
rijeka	ɹɪˈjɛkə
sacless	ˈsækləs
wontedly	ˈwɔːntɪdli
tuareg	ˈtwɑɹ.ɛɡ
crustose	ˈkɹʊs.toʊs
s-mobile	ɛsˈmoʊbɨli
abdominocystic	æbˌdɑm.ɪ.noʊˌsɪs.tɪk
abdominogenital	æbˈdɑm.ɪ.noʊˈd͡ʒɛn.ɪ.tl̩
abdominohysterotomy	æbˈdɑm.ɪ.noʊ.hɪs.tɚˈɹɑt.ə.mi
hollow leg	ˌhɑ.loʊ ˈlɛɡ
acanthion	əˈkæn.θi.n̩
ridibund	ˈɹɪdəˌbənd
abdominoscrotal	æbˌdɑm.ɪ.noʊ.skɹoʊ.tl̩
acanthoma	ə.kænˈθoʊ.mə
voegelinian	ˌvoʊɡəˈlɪniən
sarcee	ˈsɑɹ.si
abulic	ˌeɪˈbju.lɪk
still's murmur	ˈstɪlzˌmɹ̩mɹ̩
limitary	ˈlɪmɪˌtɛɹi
membraneous	mɛmˈbɹeɪ.ni.əs
melaleuca	ˌmɛləˈluːkə
noice	nɔɪs
hash brownie	ˌhæʃ ˈbɹaʊni
dumble-dor	ˈdʌm.bəl.dɔːɹ
dumbledor	ˈdʌm.bəl.dɔːɹ
negroni	nəˈɡɹoʊni
tyrannic	tɪˈɹæ.nɪk
epitheliod	ˌɛpəˈθili.əd
abnormalism	æbˈnɔɹ.ml̩.ɪz.m̩
zygon	ˈzaɪ.ɡɑn
litterateuse	ˌlɪtəɹəˈtuːz
polymorphy	ˈpɑliˌmɔɹfi
odic	ˈoʊdɪk
odic	ˈɑdɪk
pareidolic	pɛɹ.aɪˈdoʊ.lɪk
ocularly	ˈɑ.kjə.lɚ.li
buster	ˈbʌstɚ
anthypophora	ænθəpəfɔɹə
microdose	ˈmaɪkɹoʊˌdoʊs
circumpose	ˈsɝːkəmˌpoʊz
overnumerousness	ˌoʊvɚˈnuməɹəsnəs
abembryonic	ˈæbˌɛm.bɹiˌɑn.ɪk
nine-tenths	ˌnaɪnˈtɛnθs
conterminal	kənˈtɝ.mɪ.nəl
tenebrosity	ˈtɛnɪbɹɑsədi
dissipable	ˈdɪsɪˌpɪbl̩
abarognosis	ˌæb.əɹ.əɡˈnoʊ.sɪs
abdominocardiac	æbˌdɑm.ɪ.noʊˌkɑɹdi.æk
aqabamycin	ˌɑkəbəˈmaɪsɪn
exteriorization	ɪkˌstɪɹiɚɪˈzeɪʃən
abutilon	əˈbjutˌl̩ɑn
busticate	ˈbʌstɪˌkeɪt
tapless	ˈtæpləs
cardialgy	ˈkɑːɹ.diˌæl.dʒi
ommatophore	əˈmæ.tə.fɔɹ
mcdonald	məkˈdɑnəld
swather	swɑθəɹ
croze	kɹoʊz
carnegie	ˈkɑɹnəɡi
unclomb	ʌŋˈkloʊmb
outsiderness	ˌaʊtˈsaɪdɚnəs
abustle	əˈbʌs.l̩
immitigable	ɪˈmɪtɪɡəbəl
orthoepic	ˌɔrθoʊˈɛpɪk
horizontal jogging	ˌhɔː.ɹəˈzɑːn.təl ˈdʒɑ.ɡɪŋ
semanticity	ˌsɪmænˈtɪsɪti
prosauropod	pɹoʊˈsɔɹɵpɑd
exteriorizing	ɪkˈstɪɹi.əˌɹaɪzɪŋ
exteriorized	ɪkˈstɪɹi.əˌɹaɪzd
pathing	ˈpæðɪŋ
elecampane	ˌɛləkæmˈpeɪn
morgellons	mɔɹˈdʒɛlənz
lebesgue integral	ləˈbɛːɡ ˈɪntəɡɹəl
padless	ˈpædləs
hogg	hɑɡ
homebred	ˈhoʊmˌbɹɛd
troak	tɹoʊk
theocratical	ˌθi.ə.ˈkɹæ.tɪ.kəl
disharmonize	dɪs.ˈhɑɹ.mən.ˌaɪz
unsequestered	ʌnsəˈkwɛstɚd
paraenetical	pæɹəˈnɛdɪk(ə)l
sephira	səˈfiɹə
ain'tcha	ˈeɪn.tʃə
gironde	dʒɪˈɹɑnd
lebesgue measure	ləˈbɛːɡ ˈmɛ.ʒɚ
appendix:list of protologisms/long words/titin	mə.ˌθaɪ.ə.nɪl.ˌθri.ə.nɪl.ˌθri.ə.nɪl.ɡlu.ˌtæm.ə.nɪl.ˌæl.ə.(ˌ)nɪl.ˌproʊ.lɪl.ˌθri.ə.nɪl.ˌfɛ.n(ə)l...ˌlu.s(ə)l.ɡlu.ˌtæm.ə.nɪl.ˌsɛ.r(ə)l.ˌvæ.lɪl.ˌvæ.lɪl.ˌvæ.lɪl.ˌlu.s(ə)l.ɡlu.ˌtæ.mɪl.ˌɡlaɪ.s(ə)l...ˌhɪs.tə.(ˌ)dɪl.(ˌ)aɪ.sə.ˌlu.sɪl...ˌtɹɪpt.ə.(ˌ)fɪl.ˌfɛ.n(ə)l.ˌæl.ə.(ˌ)nɪl.ˌɑɹ.dʒə.(ˌ)nɪl.ə.ˌspɑɹt.(ə)l...ˌlaɪ.s(ə)l...(ˌ)æs.pə.ˌɹæ.dʒɪ.n(ə)l...ˌtaɪ.ɹə.(ˌ)sɪl...ˌsɪs.ti.i.nɪl...ˌsɛ.r(ə)l.ˌaɪ.sə.ˈlu.(ˌ)siːn
borachio	bɔˈɹɑt͡ʃoʊ
starbucks	ˈstɑːɹˌbʌks
2.0	tu pɔɪnt oʊ
cheshire cat	ˌtʃɛʃɚ ˈkæt
totear	təˈtɛɚ
cablegate	ˈkeɪbəlˌɡeɪt
gianduja	dʒɑn.ˈdu.jə
pima	ˈpimə
intervallic	ˌɪntɚˈvælɪk
daniels	ˈdænjəlz
build into	bɪldˈɪn.tu
shaobing	ˌʃaʊˈbɪŋ
he who laughs last laughs best	ˈhi hu ˈlæfs ˈlæst ˈlæfs ˈbɛst
aerian	ˌeɪˈɪɹi.ən
ingrow	ɪnˈɡɹoʊ
tamagotchi	ˌtɑməˈɡoʊtʃi
opsonic	ɑpˈsɑnɪk
local supercluster	ˌloʊkl̩ ˈsupɚˌklʌstɚ
virgo supercluster	ˈvɚɡoʊ ˈsu.pɚˈklʌstɚ
aphroditus	æfɹəˈdaɪtəs
tsundere	ˈtsun.dəɹ.eɪ
beheadal	bəˈhɛdəl
academy award	əˈkæd.ə.mi əˈwɔɹd
rototill	ˈɹoʊ.toʊ.ˌtɪl
receivability	ɹə.ˌsi.vɑ.ˈbɪl.ɪ.ti
manurial	mə.ˈnʌɹ.i.əl
cakeshop	ˈkeɪk.ʃɑp
fomite	ˈfoʊmaɪt
mainer	ˈmeɪnɚ
-merous	-məɹəs
tagless	ˈtæɡləs
chumpier	ˈtʃʌmpiɚ
dearheart	ˈdiɹˌhɑɹt
coup d'états	ˌkuːdeɪˈtɑːz
if you know what i mean	ɪf ju ˌnoʊ wʌt aɪ ˈmin
head-first	hɛd.fɝst
head first	hɛd.fɝst
panegyrically	pænəˈdʒɪɹək(ə)li
mercator	mɜɹ.ˈkeɪ.tɜɹ
de morgan's law	dɨˈmɔɹɡɪnzˌlɔ
actially	ˈæk.ʃə.li
supervacaneous	ˌsuːpəɹvəˈkeɪnɪəs
santorum	sænˈtɔɹəm
marching orders	ˈmɑɹtʃɪŋˌɔɹɾɹ̩z
cataphor	ˈkætəfɚ
murenger	ˈmjʊɹəndʒəɹ
yippee ki-yay	jɪˈpiːkaɪeɪ
mald	mɑld
in sha allah	ˌɪnʃˈɑ.lə
prickly heat	ˈpɹɪk li ˈhit
fairy chess	ˈfɛriˌtʃɛs
massachusettsian	mæsəˈtʃusɛtsi.ən
abuilding	əˈbɪl.dɪŋ
rapey	ˈɹeɪpi
404 page	ˌfɔɹ.oʊ.ˈfɔɹ.peɪdʒ
citations:ncmo	nɪkmoʊ
dweomercraft	dwiːməɹːkɹæft
batless	ˈbætləs
abristle	əˈbɹɪ.sl̩
broccolini	bɹɑ.kəˈliːni
father-bother merger	ˌfɑðɚ ˈbɑðɚ ˈmɝdʒɚ
mottramite	ˈmɑ tɹə maɪtˌ
gow	ɡaʊ
twenny	[ˈtwɛni]
gnoll	noʊl
barside	ˈbɑɹ.saɪd
machoness	ˈmɑ.tʃoˌnəs
pokémon	ˈpoʊkeɪˌmɑn
bashir	bəˈʃiɹ
basheer	bəˈʃi˞
thirdy	ˈθɝɾi
fordy	[ˈfɔɚ̯ɾi]
sevendy	[ˈsɛv.n̩.i]
saltbush	ˈsɔːltˌbʊʃ
-odontia	əˈdɑnʃə
castro	ˈkæstɹoʊ
manson	ˈmænsən
ohko	ˈoʊkoʊ
prereq	ˈpɹi.ɹɛk
omnisciency	ɑmˈnɪʃənsi
melodramata	ˈmɛləˌdɹɑmətə
iatromathematician	aɪˌæt.ɹoʊˌmæθ.ə.məˈtɪʃ.ən
iatromathematics	aɪˌæt.ɹoʊ.mæθ.əˈmæt.ɪks
dunn	dʌn
quinnat	ˈkwɪnət
questuary	ˈkwɛstjʊˌɛɹi
smail	ˈɛs.meɪl
wartwort	ˈwɔɹt.ˌwɝt
septimation	ˈsɛptəmeɪʃən
outshow	aʊtˈʃoʊ
wereleopard	ˈwɛɹlɛpɚd
copperfield	ˈkɑ.pɚ.ˌfiːld
tivoli	ˈtɪvəli
pinole	pi.ˈnoʊleɪ
riming	ˈɹaɪmɪŋ
mosquitoey	[məˈskiɾoʊi]
johannine	dʒoʊˈhæˌnaɪn
chalcedon	ˈkælsɪdɑːn
werecat	ˈwɛɹkæt
werelion	ˈwɛɹlaɪən
bragfest	ˈbɹæɡfɛst
are you ok	ɑɹ juː oʊˈkeɪ
ljbf	ˈlɪd͡ʒ.bɪf
niobe	ˈnaɪ.oʊ.bi
nowruz	noʊ̯ˈɹuz
academic year	ˌæk.əˈdɛm.ɪk jɪɹ
orvieto	ɔɹˈvjeɪtoʊ
orl	ɔɹl
rhebok	ˈɹiː.bɑk
giuseppettite	dʒuˈsɛpətaɪt
takedaite	təˈkeɪdə.aɪt
darlin'	ˈdɑɹlɪn
la rochelle	ˌlɑ ɹoʊˈʃɛl
paralinguistics	ˌpæɹəlɪŋˈɡwɪstɪks
esotropia	ˈɛs.oʊˌtɹoʊpi.ə
sapote	səˈpoʊti
plusquam-	ˈpləsˌkwæm
dard	dɑɹd
qalandar	ˈkæləndɚ
palatize	ˈpælɪtaɪz
abdominal ring	æbˈdɑm.ə.nl̩ ɹɪŋ
timur	tɪˈmʊəɹ
arginyl	ˈɑɹ.dʒə.ˌnɪl
glutaminyl	ɡlu.ˈtæm.ə.nɪl
cornhusking	ˈkɔɹnˌhʌskɪŋ
balmily	ˈbɔ(l)məli
overstudious	ˌoʊ.vɚˈstuː.di.əs
monoxylous	məˈnɑk.sɪ.ləs
rory	ˈɹɔɹ.i
dispensatory	dɪsˈpɛnsəˌtɔɹi
zakynthos	ˈzɑkɪnθɔs
centaury	ˈsɛntɔɹi
saint louis	seɪntˈluːɪs
taegu	tæˈɡu
gettable	ˈɡɛdəbəl
vexillary	ˈvɛksəˌlɛɹi
obsecratory	ɑbˈsɛkɹəˌtɔɚɹi
o'neill	oʊˈnil
wroken	ˈɹəʊkən
vietcong	ˌvi.ɛt.ˈkɑŋ
hydropsy	ˈhaɪdɹɑpsi
whallah	wɑˈlɑ
meleagrine	ˌmɛl.iˈeɪ.ɡɹaɪn
oostegite	oʊˈ(w)ɑstɪˌdʒaɪt
whirry	ˈwɝ.ɹi
reverberative	ɹəˈvɝbəˌɹəɪtɪv
gurt	ˈɡɜːɹt
halfness	ˈhæfnəs
colson	ˈkoʊlsən
agnew	ˈæɡ.nu
abductively	æbˈdʌk.tɪv.li
onirocritic	oʊˌnɪ.ɹəˈkɹɪt.ɪk
sortilegious	sɔɹt.ɪˈliːdʒəs
chukar	ˈtʃʌk.ɚ
lucubratory	ləˈkjubɹətɔɹi
torpitude	ˈtɔɹpɪtud
carbonarism	ˌkɑɹbəˈnɑɹɪzəm
abscissæ	æb.ˈsɪs.ˌi
retrochoir	ˈɹɛ.tɹəˌkwaɪɚ
clancy	ˈklænsi
minutary	ˈmɪnəˌtɛɹi
donnean	ˈdʌni.ən
batrachophagous	ˌbætɹəˈkɒfəɡəs
pesher	ˈpɛʃ.ɚ
hanson	ˈhænsən
englishry	ˈɪŋ(ɡ)lɪʃɹi
abkari	ɑb.ˈkɑɹ.i
appellatory	əˈpɛləˌtɔɹi
coath	koʊθ
abdominohysterectomy	æbˈdɑm.ɪ.noʊ.hɪs.tɚˈɹɛk.tə.mi
abdominovaginal	æbˌdɑm.ɪ.noʊˈvæ.d͡ʒɪ.nl̩
abenteric	æb.ɛnˈtɛɹ.ɪk
abrachiocephalia	əˈbɹeɪ.ki.oʊ.sɛˌfeɪ.li.ə
absinthol	ˈæb.sənˌθɔl
acampsia	əˈkæmp.si.ə
acanthamoebiasis	əˌkæn.θə.miˈbaɪ.ə.sɪs
acanthella	æ.kænˈθɜ.lə
acanthocephaliasis	æˌkæn.θoʊ.sɜf.əˈlaɪ.ə.sɪs
acanthocytosis	əˌkæn.θoʊ.saɪˈtoʊ.sɪs
acanthoid	əˈkænˌθɔɪd
acanthor	əˈkæn.θɔɹ
acanthotic	æˌkænˈθɑ.tɪk
acapnial	əˈkæp.ni.l̩
tabless	ˈtæbləs
strad	stɹæd
defiatory	dəˈfaɪətɔɹi
spurrier	ˈspɝɹiɚ
etnean	ɛtˈni.ən
adorkable	ʌˈdɔɹkəbl̩
reorientate	ɹiˈɔɹiɛnteɪt
architranseme	ˌɑːɹkɪˈtɹænziːm
surgeoncy	ˈsɝ.dʒən.si
morphosis	mɔɹfoʊsɪs
ohim	ˈoʊhɪm
exteriority	ɪkˌstɪɹiˈɔɹɪti
moo-cow	ˈmuːkaʊ
iatrophysicist	aɪˌæt.ɹoʊˈfɪz.ə.sɪst
mollie	ˈmɑli
your guys's	ˈjɹ̩ ɡaɪzəz
schopenhauerian	ˌʃoʊpənhaʊˈɪɹi.ən
italish	ɪˈtælɪʃ
metagnathous	mɪˈtæɡnəθəs
pomey	ˈpɑ.mi
postulatory	ˌpɑstjʊˈleɪtəɹi
passless	ˈpæsləs
surfeiter	ˈsɝː.fɪ.tɚ
chartres	ˈʃɑɹtɹə
lutrine	ˈluːtɹaɪ̯n
slowth	slɔθ
negarchy	ˈnɛɡˌɑɹki
tumultuary	təˈmʌltʃuˌɛɹi
iztaccíhuatl	ˌistɑkˈsiwɑtl̩
oblectation	ɑ.blɛkˈteɪ.ʃən
sine quibus non	ˌsɪni ˌkwɪbʊs ˈnɑn
sycee	ˈsaɪsiː
cital	ˈsaɪdəl
chaplin	ˈtʃæplɪn
mustee	məˈsti
gagless	ˈɡæɡləs
proditory	ˈpɹɑdɪtɔɹi
rosepetal	ɹoʊz pɛt(ə)l
rose petal	ɹoʊz pɛt(ə)l
preambulatory	pɹiˈæmbjʊləˌtɔɹi
assythment	əˈsaɪðmənt
theosoph	ˈθiː.oʊ.sɒf
yolo	ˈjoʊ.loʊ
leesy	ˈliː.zi
wenzhou	wʌnˈdʒoʊ
meadery	ˈmidəɹi
prodition	pɹoʊˈdɪʃən
discoverture	dɪsˈkʌvɚˌtʃʊɚ
pommé	ˈpɑ.meɪ
bowmanship	ˈboʊmənʃɪp
overslaugh	ˈəʊ.vəɹˌslɔː
croquembouche	ˌkɹɑkəmˈbuʃ
milkaholic	mɪlkəˈhɑlɪk
kwaj	ˈkwɑːdʒ
presidentialness	ˌpɹɛzɪˈdɛn(t)ʃəlnɪs
coagulatory	koʊˈæɡjələˌtɔɹi
epode	ˈɛpoʊd
mouvementé	ˌmuv(ə)ˌmɑnˈteɪ
wunderkammer	ˈvʊndɚˌkɑmɚ
dodger	ˈdɑdʒə(ɹ)
snipper-snapper	ˈsnɪpəɹˌsnæpəɹ
aetites	iˈtaɪdiz
epicurean	ˌɛpɪkjʊˈɹiːən
abducent nerve	æbˈdus.ənt nɚv
abiologically	ˌeɪ.baɪ.əˈlɑdʒ.ɪ.kə.li
absentee voter	ˌæb.sn̩ˈti voʊ.tɚ
absolute ceiling	ˈæb.səˌlut ˈsi.lɪŋ
absolute music	ˈæb.səˌlut ˈmju.sɪk
absolute scale	ˈæb.səˌlut skeɪl
dedupe	diːˈduːp
abuna	ɑˈbu.nɑ
abuna	əˈbu.nə
academy	əˈkæd.ə.mi
acanth-	əˈkænθ
acantho-	əˈkæn.θoʊ
acanthocephalan	əˌkæn.θəˈsɛf.ə.lən
acanthocephalid	əˌkæn.θəˈsɛf.ə.lɪd
a capriccio	ɑ kɑˈpɹit.tʃoʊ
thermidorian	ˌθɝməˈdɔɹi.ən
oneironautics	oʊˈnaɪ.ɹoʊ.nɔ.tɪks
poochie-fication	[ˌput͡ʃifɪˈkeɪʃən]
calfless	ˈkæfləs
overwait	ˌoʊvɚˈweɪt
overwait	ˈoʊvɚweɪt
-verse	vɚs
murr	[mɝ]
romney	ˈɹɑːmni
niggered	[ˈnɪɡɚd]
mulcher	ˈmʌltʃɚ
cake shop	ˈkeɪk ʃɑp
aasvoel	ˈɑs.ˌfoʊ.əl
ababdeh	ə.ˈbæb.dɛ
ab absurdo	ˌæbəbˈsɝˌdoʊ
abbasi	əˈbɑ.si
abatsons	ˌɑˌbɑˈsɔ̃
abatsons	ˌɑˌbɑˈsɔ̃z
abbot nullius	ˈæ.bət.nʊˈli.əs
abderhalden reaction	ˈɑp.dəˌhɑl.dən ɹiˈæk.ʃən
abdominal fin	æbˈdɑm.ə.nl̩ fɪn
abdominal pore	æbˈdɑm.ə.nl̩ pɔɹ
abdominal pouch	æbˈdɑm.ə.nl̩ paʊt͡ʃ
abdominal region	æbˈdɑm.ə.nl̩ ˈɹi.d͡ʒən
abdominal respiration	æbˈdɑm.ə.nl̩ ˌɹɛs.pəˈɹeɪ.ʃən
abderian	æbˈdɪɹ.i.ən
abdominal rib	æbˈdɑm.ə.nl̩ ɹɪb
abecedarian	ˌeɪ.biˌsiˈdæɹ.i.ən
abelite	ˈeɪ.bəˌlaɪt
abelmusk	ˈeɪbəlməsk
abeltree	ˈeɪ.bəlˌtɹi
abendmusik	ˈɑ.bəntˌmuˌzik
a bene placito	ɑ ˈbɛ.ni ˈplɑ.t͡ʃəˌtoʊ
abenlen	əˈbɛn.lɛn
aberdavine	ˈæb.ə.dəˌvaɪn
aberduvine	ˈæb.ə.dəˌvaɪn
abernethy biscuit	ˈæb.ɚˌni.θi
abert's towhee	ˈeɪ.bɚts ˈtoʊ.hi
aww yeah	ɔ˥˩ jɛ˥ə˩
abgesang	ˈɑp.ɡəˌzɑŋ
abranchious	ˈeɪˌbɹæŋ.ki.əs
abipón	ˈæ.bəˌpɑn
abipones	ˌæ.bəˈpoʊn.iz
abjective	ˈæbˌd͡ʒɛ.tɪv
abkar	ˈɑb.kɑɹ
abkhas	æbˈkɑs
ablare	əˈblɛɹ
ablastous	eɪˈblæs.təs
ableeze	əˈbliz
abmigration	ˌæbˌmaɪˈɡɹeɪ.ʃən
abney level	ˈæb.ni ˈlɜv.l̩
abolitiondom	æb.əˈlɪʃ.n̩.dəm
abongo	əˈbɑŋˌɡoʊ
aboospore	æ.boʊ.əˌspɔɹ
abor	ˈɑˌbɔɹ
abor-miri	ˌɑˌbɔɹˈmɪ.ɹi
à bouche	ɑˈbuʃ
about ship	əˌbaʊt ˈʃɪp
above proof	əˈbʌv pɹʊf
above-water	əˈbʌv ˈwɑ.tɚ
abrahamman	ˈeɪ.bɹə.ˌhæm.ˌmæn
abramman	ˈeɪ.bɹəm.ˌmæn
abranchialism	ˌeɪˈbɹæŋ.ki.l̩.ɪz.m̩
abrasin oil	ˈæ.bɹə.zən
abrasiometer	ə.ˌbɹeɪ.zi.ˈɑm.ə.tɚ
abreactive	ˌæb.ɹiˈæk.tɪv
abri audit	ə.ˈbɹi
abri audit	oʊ.ˈdi
abrocome	ˈæb.ɹəˌkoʊm
abrotanum	əˈbɹɑt.n̩.əm
abrotine	ˈæ.bɹəˌtin
abruptio placentae	əˈbɹʌp.ʃiˌoʊ pləˈsɛnˌti
abruptio placentarum	ə.ˈbɹʌp.ʃi.ˌoʊ.ˌplæs.n̩.ˈtæ.ɹəm
abruptiones placentarum	ə.bɹʌp.ʃi.ˈoʊ.niz.ˌplæs.n̩.ˈtæ.ɹəm
abruzzi ware	ɑˈbɹut.si
absaroka	æbˈsɑ.ɹə.kə
absaroke	æbˈsɑ.ɹə.ki
absarokee	æbˈsɑ.ɹə.ki
abscess root	ˈæb.sɛs ɹut
abscissio infiniti	æbˈsɪ.siˌoʊ ɪn.fəˈni.ti
abscissiones infiniti	æbˌsɪ.siˈoʊˌniz ˌɪn.fəˈni.ti
abscission zone	æbˈsɪ.ʃn̩ ˈzoʊn
absente reo	æbˈsɛn.ti ˈɹi.oʊ
absinthe green	ˈæb.sɪnθ ɡɹin
absinthe oil	ˈæb.sɪnθ ɔɪl
absinthine	ˈæbˌsɪn.θən
absit omen	ˈæb.sɪt ˈoʊ.mn̩
absolute of enfleurage	ˈæb.səˌlut əv ɑn.fluˈɹɑʒ
absolute altitude	ˈæb.səˌlut
absolute altitude	ˈæl.tɪˌtud
absolute blocking	ˈæb.səˌlut ˈblɑk.ɪŋ
absolute constant	ˈæb.səˌlut ˈkɑn.stn̩t
absolute ego	ˈæb.səˌlut ˈi.ɡoʊ
absolute endorsement	ˈæb.səˌlut ɜnˈdɔɹs.mn̩t
absolute fee simple	ˈæb.səˌlut fi ˈsɪm.pl̩
absolute form	ˈæb.səˌlut fɔɹm
absolute impediment	ˈæb.səˌlut ɪmˈpɜd.ə.mn̩t
absolutely convergent	ˌæb.səˈlut.li kənˈvɚ.d͡ʒn̩t
absolute personal equation	ˈæb.səˌlut pɚˈsə.nl̩ iˈkweɪ.ʒn̩
absolute pressure	ˈæb.səˌlut ˈpɹɜ.ʃɚ
absolute privilege	ˈæb.səˌlut ˈpɹɪv.l̩.ɪd͡ʒ
absolute reality	ˈæb.səˌlut ɹiˈæl.ə.ti
absolute right	ˈæb.səˌlut ɹaɪt
absolute state	ˈæb.səˌlut steɪt
absolute system	ˈæb.səˌlut ˈsɪs.tm̩
absolute term	ˈæb.səˌlut tɚm
absolute threshold	ˈæb.səˌlut
absolute threshold	ˈθɹɜʃ.hoʊld
absolute weight	ˈæb.səˌlut weɪt
absolutistically	ˈæb.səˌluˌtɪs.tɪk.l̩i
absolvitory	æbˈzɑl.vəˌtɔɹ.i
absorbent cotton	æbˈsɔɹ.bn̩t ˈkɑ.tn̩
absorbent paper	æbˈsɔɹ.bn̩t ˈpei.pɚ
absorberman	æbˈsɔɹ.bɚ.mæn
absorptiometric	æbˌsɔɹp.ʃi.oʊˈmɛ.tɹɪk
absorptiometric	æbˌzɔɹp.ʃi.oʊˈmɛ.tɹɪk
absorption cell	æbˈsɔɹp.ʃn̩ sɜl
absorption dynamometer	æbˈsɔɹp.ʃn̩ ˌdaɪ.nəˈmɑm.ɪ.tɚ
absorption edge	æbˈsɔɹp.ʃn̩ ɜd͡ʒ
absorption factor	æbˈsɔɹp.ʃn̩ ˈfæk.tɚ
absorption hygrometer	æbˈsɔɹp.ʃn̩ haɪˈɡɹɑm.ɪ.tɚ
absorption pipette	æbˈsɔɹp.ʃn̩
absorption pipette	paɪˈpɜt
absorption system	æbˈsɔɹp.ʃn̩ ˈsɪs.tm̩
absque impetitione vasti	ˈæbs.kwi ˌɪm.pəˌtɪ.ʃiˈoʊ.ni ˈvæsˌti
abstinence syndrome	ˈæb.stə.nn̩s ˈsɪn.dɹoʊm
abstinence theory	ˈæb.stə.nn̩s
abstinence theory	ˈθi.ə.ɹi
abstract music	æbˈstɹækt ˈmju.zɪk
abstract universal	æbˈstɹækt ˌju.nəˈvɝ.sl̩
bariatrician	bɛɹi.əˈtɹɪʃən
yarl	jɑɹl
mox nix	ˈmɑks ˌnɪks
moth-er	ˈmɔðɚ
binner	ˈbɪnɚ
not've	ˈnɑtəv
unproduceable	ʌn.pɹəˈdu.sɪ.bəl
beaujolais	ˌboʊ.ʒəˈleɪ
wafered	ˈweɪ.fɚd
moqui marble	ˈməʊ.ki ˈmɑɹbəl
spankingly	ˈspæŋkɪŋli
jager	ˈjeɪ.ɡɚ
dog	dɔɡ
hermitian matrix	hɝ.ˈmɪ.ʃən ˈmeɪ.tɹɪks
mysia	ˈmɪʒə
door frame	ˈdɔɹ ˌfɹeɪm
door frames	ˈdɔɹ ˌfɹeɪmz
vacationship	vəˈkeɪʃ(ə)n.ʃɪp
rally cap	ˈɹæl.i ˌkæp
batcrap	ˈbætkɹæp
absatively	æbsəˈtɪvli
tertullian	təɹˈtʌli.ən
naches	ˈnɑx.əs
olykoek	ˈɑ.ləˌkʊk
croggy	ˈkɹɑɡi
burocrat	ˈbjʊɹəkɹæt
burocracy	bjʊˈɹɑːkɹəsi
sohcahtoa	ˌsoʊ.kɑˈtoʊ.ʌ
bayesian network	ˈbeɪ.zjən ˈnɛt.wɝk
abasia atactica	ə.ˈbeɪ.ʒə ˈeɪ.tæk.tɪk.ə
masterman	ˈmæs.tɚˌmən
gold ochre	ɡoʊld ˈoʊkɚ
boat-shaped abdomen	boʊt ʃeɪpt ˈæb.də.mən
carinate abdomen	ˈkæ.ɹɪ.neɪt ˈæb.də.mən
abdominal decompression	æbˈdɑm.ə.nəl di.kəmˈpɹɛʃ.ən
abdominal gestation	æbˈdɑm.ə.nl̩ d͡ʒɛˈsteɪ.ʃn̩
abdominal inguinal ring	æbˈdɑm.ə.nl̩ ˈɪŋ.ɡwɪn.l̩ ɹɪŋ
abdominal muscle	æbˈdɑm.ə.nl̩ ˈmʌs.l̩
abdominal quadrant	æbˈdɑm.ə.nl̩ ˈkwɑd.ɹn̩t
abdominal reflex	æbˈdɑm.ə.nl̩ ˈɹi.flɜks
abdominal section	æbˈdɑm.ə.nl̩ ˈsɜk.ʃn̩
abdominocardiac reflex	æbˌdɑm.ɪ.noʊˈkɑɹ.di.æk ˈɹi.flɛks
abdominodiaphragmatic breathing	æbˌdɑm.ɪ.noʊ.di.ə.fɹæɡˈmæt.ɪk
kohls	koʊlz
abdominoscrotal muscle	æbˌdɑm.ɪ.noʊ.skɹoʊ.tl̩ ˈmʌs.l̩
abdominothoracic arch	æbˌdɑm.ɪ.noʊ.θɔɹ.æs.ɪk ɑɹt͡ʃ
abdominouterotomy	æbˌdɑm.ɪ.noʊ.ju.tɚˈɑ.tə.mi
abducens muscle	æb.ˈdu.ˌsɛnz ˈmʌs.l̩
a-be	əˈbi
aberdeenshire	ˌæb.ɚˈdinˌʃaɪ.ɚ
abeokuta	ˈɑ.beɪˌoʊ.ku.tə
aberrant conduction	əbˈɛɹ.n̩t kənˈdʌk.sn̩
aberratio lactis	æb.ɜˈɹeɪ.ʃi.oʊ ˈlæk.tɪs
aberratio testis	æb.ɜˈɹeɪ.ʃi.oʊ ˈtɜs.tɪs
lateral aberration	ˈlæt.ɚ.l̩ ˌæb.əˈɹeɪ.ʃn̩
longitudinal aberration	ˌlɑn.d͡ʒəˈtjud.n̩.l̩ ˌæb.əˈɹeɪ.ʃn̩
mental aberration	ˈmɜn.tl̩ ˌæb.əˈɹeɪ.ʃn̩
abettance	əˈbɛt.n̩ts
no-scope	ˈnoʊskoʊp
abingdon	ˈæb.ɪŋ.dn̩
abiogenically	ˌeɪ.baɪ.oʊˈd͡ʒɛ.nɪk.li
live oak	laɪv oʊk
cordovan	ˈkɔːɹdəvən
noetherian domain	nə.ˈtɛ.ɹi.ən doʊ̯.ˈmeɪ̯n
3d printer	ˈθɹi ˈdi ˈpɹɪntɚ
ablatio placentae	æbˈleɪ.ʃi.oʊ pləˈsɛnˌti
ablatio retinae	æbˈleɪ.ʃi.oʊ ˈɹɜt.n̩.i
ablephary	æˈblɛf.əˌɹi
abmho	ˈæb.moʊ
abob	əˈbɑb
abocclusion	ˈæb.oʊˌklu.ʒn̩
caturday	ˈkætɚdeɪ
caturday	ˈkætɚdi
accidental abortion	ˌæk.sɪ.ˈdɛn.tl̩ əˈbɔɹ.ʃn̩
ampullar abortion	æmˈpʊ.lɑɹ əˈbɔɹ.ʃn̩
artificial abortion	ˌɑɹ.təˈfɪʃ.l̩ əˈbɔɹ.ʃn̩
complete abortion	kəmˈplit əˈbɔɹ.ʃn̩
habitual abortion	həˈbɪt͡ʃ.u.l̩ əˈbɔɹ.ʃn̩
imminent abortion	ˈɪm.ɪn.ənt əˈbɔɹ.ʃn̩
incomplete abortion	ɪn.kəmˈplit əˈbɔɹ.ʃn̩
inevitable abortion	ɪnˈɛv.ɪt.ə.bl̩ əˈbɔɹ.ʃn̩
infected abortion	ɪnˈfɛkt.əd əˈbɔɹ.ʃn̩
missed abortion	mɪst əˈbɔɹ.ʃn̩
nontherapeutic abortion	nɔnˌθɛɹ.əˈpju.tɪk əˈbɔɹ.ʃn̩
septic abortion	ˈsɛp.tɪk əˈbɔɹ.ʃn̩
therapeutic abortion	θɛɹ.əˈpju.tɪk əˈbɔɹ.ʃn̩
threatened abortion	ˈθɹɛt.n̩d əˈbɔɹ.ʃn̩
tubal abortion	ˈtu.bl̩ əˈbɔɹ.ʃn̩
abounder	əˈbaʊn.dɚ
above-quoted	əˈbʌvˌkwoʊt.əd
above-said	əˈbʌvˌsɜd
above-written	əˈbʌvˌɹɪt.n̩
abraham's barm	ˈeɪ.bɹəˌhæms bɑɹm
sham abraham	ʃæm ˈeɪ.bɹəˌhæm
sound law	ˈsaʊnd lɔ
abrasional	əˈbɹeɪ.ʒn̩.l̩
abronia	əˈbɹoʊ.ni.ə
álava	ˈɑləvə
mifflin	ˈmɪflɪn
halpert	ˈhælpəɹtʰ
halpern	ˈhælpəɹn
schrute	ʃɹuːt
bartholin abscess	ˈbɑɹ.toʊ.lɪnz ˈæbˌsɛs
beesly	ˈbizli
blind abscess	blaɪnd ˈæbˌsɛs
moo shu	ˈmu.ʃu
collar-button abscess	ˈkɑ.lɚ ˈbʌ.tn̩ ˈæbˌsɛs
deep abscess	dip ˈæbˌsɛs
dry abscess	dɹaɪ ˈæbˌsɛs
ebert	ˈiːbəɹt
milk abscess	mɪlk ˈæbˌsɛs
mother abscess	ˈmʌ.ðɚ ˈæbˌsɛs
orwell	ˈɔːɹwel
pastless	ˈpæstləs
doma	ˈdoʊmə
animous	ænɪməs
gangnam	ˈɡɑŋ.nɑm
dog bone wrench	[dɔɡ boʊn ɹɛnt͡ʃ̩̩]
rusto	ˈɹʌstoʊ
tin anniversary	ˈtɪn ænɪˌvɜɹsəɹi
these're	ˈðizɚ
those're	ˈðoʊzɚ
that're	ðətɚ
which've	ˈwɪtʃəv
that've	ðətəv
these've	ˈðizəv
those've	ˈðoʊzəv
thomasine	ˈtɑm.əs.in
hefemale	ˈhi.fimeɪl
hefemales	ˈhi.fimeɪlz
burns	bɝnz
lowe	loʊ
rowe	ɹoʊ
kerr	kɛɹ
olson	ˈoʊlsən
salazar	ˈsæləzɑɹ
sloan	sloʊn
gore	ɡɔːɹ
barrow	ˈbæɹoʊ
beeson	ˈbisən
belcher	ˈbɛltʃɚ
booker	ˈbʊkɚ
buckner	ˈbʌknɚ
burr	bɝ
callaway	ˈkæləweɪ
cranston	ˈkɹænstən
foley	ˈfoʊli
folger	ˈfoʊld͡ʒɚ
holder	ˈhoʊldɚ
hurley	ˈhɝli
gomez	ˈɡoʊmɛz
golden	ˈɡoʊldən
irvin	ˈɝvɪn
chadwick	ˈtʃædwɪk
right to work	ɹaɪt tə wɝk
haboku	hɑˈboʊ.ku
polyaxial	ˌpɑ.lɪˈæk.si.əl
idioglossic	ˌɪdioʊˈɡlɑsɪk
nutting truck	nʌtɪŋ tɹʌk
tachylalia	ˌtækɪˈleɪliə
absciss layer	ˈæb.sɪs 
absciss layer	ˈleɪ.ɚ
absenteeship	ˌæb.sn̩ˈti.ʃɪp
absentee vote	ˌæb.sn̩ˈti voʊt
absinthiin	æbˈsɪn.θi.ən
absinthismic	ˌæb.sənˈθɪz.mək
absolute idea	ˈæb.səˌlut aɪˈdɪ.ə
maddox	ˈmædəks
massey	ˈmæsi
malone	məˈloʊn
artina	ɑɹˈtinə
khazar	kəˈzɑːɹ
orr	ɔɹ
oates	oʊts
bragg	bɹæɡ
winters	ˈwɪntɚz
absolute unit	ˈæb.səˌlut ˈju.nɪt
flatt	flæt
mosley	ˈmoʊzli
absorption costing	æbˈsɔɹp.ʃn̩ ˈkɑs.tɪŋ
elazar	ˈɛl.əˌzɑ(ɹ)
abstinence of war	ˈæbstɪnɪns əv ˈwɔɹ
abstinent	ˈæb.stɪ.nn̩t
abstinent	ˈæb.stə.nn̩t
abstract expressionist	ˈæbˌstɹækt ɪkˈspɹɜʃ.n̩ˌɪst
sofky	səfki
abstrusive	æbˈstɹu.sɪv
abt system	ɑpt ˈsɪs.tm̩
abukir	ˌɑ.buˈkɪɹ
abukumalite	ˌæ.bəˈku.məˌlaɪt
aboulomania	ˌeɪˌbju.ləˈmeɪ.ni.ə
declared abundance	dɪˈklɛ(ə)ɹd
declared abundance	əˈbʌn.dn̩s
royal abundance	ˈɹɔɪ.l̩
royal abundance	əˈbʌn.dn̩s
abundant year	əˈbʌn.dn̩t jɪɹ
aburachan seed	ˌɑ.bə.ɹəˈt͡ʃɑn sid
aburagiri	ˌɑ.bə.ɹəˈɡɪ.ɹi
aburton	əˈbɝ.tn̩
a-burton	əˈbɝ.tn̩
merlot	mɝˈloʊ
abusua	ˌæ.bəˈsu.ə
abutt	əˈbʌt
ab utili	æb ˈju.tl̩.i
abwab	əbˈwɑb
abydos	əˈbaɪ.dɑs
abyssalbenthic	əˌbɪs.l̩ˈbɜn.θɪk
abyssobenthic	əˌbɪs.oʊˈbɜn.θɪk
abyssalpelagic	əˌbɪs.l̩.pəˈlæ.d͡ʒɪk
abyssal rock	əˈbɪs.l̩ ɹɑk
abyssal zone	əˈbɪs.l̩ zoʊn
abyssian	əˈbɪs.i.ən
abyssolith	əˈbɪs.ə.lɪθ
abyssolithic	əˌbɪs.əˈlɪθ.ɪk
goathair	ˈɡoʊtˌhɛɹ
kipchak	kɪpˈtʃæk
moesia	miːʃi.ə
goatse	ˈɡoʊt.si
commagene	kɑːməˈdʒiːni
esthonia	ɛsˈtoʊ.ni.ə
how do	ˌhæwˈduw
flaccider	ˈflæsɪdɚ
comfortabler	ˈkʌm.fɚ.tə.blɚ
davos	ˈdɑːvoʊs
acacatechin	ˌæ.kəˈkæt.ə.t͡ʃɪn
acacetin	əˈkæs.ə.tn̩
acacian	əˈkeɪ.ʃn̩
acacia veld	əˈkeɪ.ʃə vɜld
acaciin	əˈkeɪ.si.ɪn
academic costume	ˌæk.əˈdɛm.ɪk ˈkɑs.tjum
academicism	ˌæk.əˈdɛm.əˌsɪz.m̩
academy blue	əˈkæd.ə.mi blu
academy board	əˈkæd.ə.mi boɹd
acadialite	əˈkeɪ.di.əˌlaɪt
acadian french	əˈkeɪ.di.n̩ fɹɜnt͡ʃ
acadian chickadee	əˈkeɪ.di.n̩ ˈt͡ʃɪk.əˌdi
acadian flycatcher	əˈkeɪ.di.n̩ ˈflaɪ.kæt͡ʃ.ɚ
acadian owl	əˈkeɪ.di.n̩ aʊl
-acal	ək.l̩
kheer	kɪə(ɹ)
acalepha	ˌæk.əˈlif.ə
acalyptrate	ˌeɪ.kəˈlɪp.tɹeɪt
acana	ˈɑ.kə.nə
acanthad	əˈkæn.θəd
acantharian	ˌæˌkænˈθæ.ɹi.n̩
acanthellae	æ.kænˈθɜ.li
acanthial	əˈkæn.θi.əl
proteoform	ˈpɹoʊtiːoʊˌfɔɹm
plummer	ˈplʌmɚ
acanthamoebiases	əˌkæn.θə.miˈbaɪ.ə.sis
acanthamebiasis	əˌkæn.θə.miˈbaɪ.ə.sɪs
acanthamebiases	əˌkæn.θə.miˈbaɪ.ə.sis
acanthology	(ˌ)æˌkænˈθɑlədʒi
acanthocephaliases	æˌkæn.θoʊ.sɜf.əˈlaɪ.ə.sis
acanthocytoses	əˌkæn.θoʊ.saɪˈtoʊ.sis
acanthokeratodermia	əˌkæn.θoʊˌkɜɹ.ə.toʊˈdɝ.mi.ə
acanthopelvis	əˌkæn.θoʊˈpɜl.vɪs
acanthpelyx	əˌkæn.θoʊˈpɜ.lɪks
acanthopod	əˈkæn.θəˌpɑd
acanthopodous	æˌkænˈθɑ.pə.dəs
acanthopore	əˈkæn.θəˌpɔɹ
acanthopt	ˈæ.kən.θɑpt
acanthopteran	æˌkænˈθɑp.tə.ɹən
acanthosis nigricans	æˌkænˈθoʊ.sɪs
acanthosis nigricans	ˈnɪɡ.ɹɪˌkænz
acanthosoma	əˌkæn.θəˈsoʊ.mə
acanthosomata	əˌkæn.θəˈsoʊ.mə.tə
acanthostyle	əˈkæn.θəˌstaɪl
acanthous	əˈkæn.θəs
petrarchan	pɛˈtɹɑɹkən
auxlanger	ˈɔksˌlæŋɚ
draper	ˈdɹeɪpɚ
aelita	aɪ̯ˈlitə
longyi	ˈlɑndʒi
gorsoon	ɡɔːˈsuːn
moral low ground	ˌmɔɹəl ˈloʊ ɡɹaʊnd
sosh	soʊʃ
moguled	ˈmoʊ.ɡəld
punctiliar	ˌpəŋkˈtɪliɚ
frayne	ˈfɹeɪn
frain	ˈfɹeɪn
burnham	ˈbɝnəm
danson	ˈdænsən
driver	ˈdɹaɪvɚ
goldbloom	ˈɡoʊldblum
hadley	ˈhædli
hatfield	ˈhætfild
hershey	ˈhɝʃi
mercer	ˈmɝsɚ
spooner	ˈspunɚ
creaker	kɹikɚ
holden	ˈhoʊldən
chauceresque	ˌtʃɔsəˈɹɛsk
orson	ˈɔɹsən
overton	ˈoʊvɚtən
o'shea	oʊˈʃeɪ
damascene	ˌdæməˈsiːn
arpanet	ˈɑɹ.pəˌnɛt
symblepharon	sɪmˈblɛf.ə.ɹɑn
mama-san	ˈmɑməˌsɑn
nerdspeak	nɝːd.spiːk
barbituate	ˌbɑɹˈbɪtʃu.ɪt
metagnomy	məˈtæɡ.nə.mi
leipsic	ˈlɪpsɪk
caravaggesque	ˌkæɹəvɑˈdʒɛsk
xenophyophore	ˌzinoʊˈfaɪoʊˌfɔɹ
wuxia	ˌwuˈʃɑ
phocaea	foʊˈsiːə
moralphobia	mɔːɹəl ˈfəʊbi.ə
alder.	[ˈɔl.dɚ]
shott	ʃɑt
canadia	kəˈneɪ.di.ə
big woop	bɪɡ wʊp
globaloney	ˈˌɡloʊbəˈloʊni
carbonari	ˌkɑɹbəˈnɑɹi
dunwoody	ˈdʌnwʊdi
livermore	ˈlɪvɚmɔɹ
burkean	ˈbɝki.ən
varronian	væˈɹoʊ.ni.ən
nietzscheanism	ˈni.t͡ʃi.ənɪzəm
o'malley	oʊˈmæli
dingwad	ˈdɪŋˌwɑd
east turkestan	isːt ˌtɜɹkɪˈstæn
vernacularize	vəˈnækjʊləˌɹaɪz
hnn	hn̩
teamster	ˈtim.stɚ
tacey	ˈteɪ.si
them's	ðɛms
escher	ˈɛʃɚ
oniric	oʊ.ˈnɪ.ɹɪk
yeasayer	ˈjeɪ.ˌseɪ.ɚ
voorhees	ˈvɔɹhiz
hon hon hon	[ˈhɑ̃ˈhɑ̃ˈhɑ̃]
boxered	ˈbɑksəɹd
allocher	ˈæləˌkɛəɹ
broha	ˈbɹoʊˈhɑ
yeppity	[ˈjɛpɨɾi]
toldja	ˈtoʊldʒə
ruh-roh	ˈɹʌʔˌɹoʊ
dockize	ˈdɒk.ɑɪz
herculaneum	ˌhɜɹkjəˈleɪni.əm
braggadocious	ˌbɹæ.ɡəˈdəʊ.ʃəs
anisomorphic	ænˌaɪ.soʊˈmɔːɹ.fɪk
turlet	ˈtɝːlɪt
comfortative	ˈkʌmfɚˌteɪtɪv
arbela	ɑːɹˈbiːlə
dogberry	ˈdɔɡˌbɛɹi
marmara	ˈmɑːɹməɹə
cheops	ˈkiɑːps
wax poetic	ˈwæks.poˈwɛɾɪk
auto show	ˈɔɾowˈʃow
tijuanan	tiˈhwɑnən
nam pla	ˌnɑm ˈplɑ
pog	pɑɡ
kinara	kɪˈnɑ.ɹə
hohenzollern	ˈhoʊənˌzɑləɹn
mueller	ˈmʌlɚ
greater caucasus	[ˈɡɹ̠ʷeɪ̯ɾɚ ˈkʰɔkəsəs]
gaddafi	ɡəˈdɑfi
paradoxography	ˌpɛ.ɹəˌdɑkˈsɑ.ɡɹə.fi
amarone	ˌɑməˈɹoʊneɪ
fallon	ˈfælən
kunstkammer	ˈkʊnstkɑmɚ
petrarch	ˈpɛtɹɑɹk
sunporch	ˈsʌnˌpɔɹt͡ʃ
cybele	ˈsɪbɨliː
neopatriarchy	ˌnioʊˈpeɪtɹiˌɑɹki
guirl	ˈɡɝl
-stat	stæt
incel	ˈɪnsɛl
onsweep	ˈɑn.swip
desdemona	ˌdɛzdəˈmoʊnə
cane corso	ˌkɑneɪ ˈkɔɹsoʊ
fascistize	ˈfæʃəsˌtaɪz
horizontal refreshments	ˌhɔː.ɹəˈzɑːn.təl ɹɪˈfɹeʃ.mənts
mocudrama	ˈmɑ.kju.ˌdɹɑ.mə
lovelify	ˈlʌvləˌfaɪ
smof	smɔf
smof	smɔf
doujin	ˈdoʊ.dʒɪn
paedopsychology	ˌpidoʊsaɪˈkɑləd͡ʒi
terf	tɝf
hema	hi mə
overman	ˈoʊvɚmən
kapoor	kʌˈpuːɹ
cosa nostra	ˈkoʊzəˈnoʊstɹə
ptochocracy	toʊˈkɑkɹəsi
palmyrene	ˌpælməˈɹiːn
lizardfolk	ˈlɪz.ɚd.foʊk
caplan	ˈkæplən
originariness	əɹɪd͡ʒ.ˈn̩ɛɹinəs
embolalia	ˌɛmbəˈleɪliə
aabomycin	ˌæb.oʊˈmaɪ.sɪn
prenunciative	pɹiˈnʌnsiˌeɪɾɪv
radicative	ɹæˈdɪkəˌtɪv
matterative	məˈtɜɹəɾɪv
shortfetched	ˈʃɔɹtfɛtʃt
short fetched	ˈʃɔɹtfɛtʃt
short-fetched	ˈʃɔɹtfɛtʃt
marlock	ˈmɑɹ.lək
world egg	wɜːld ˌɛɡ
rubaiyat	ˈɹubiˌ(j)ɑt
ruba'i	ɹuˈbaɪ
ruba'iyat	ˈɹubiˌ(j)ɑt
petrarchanism	pɛˈtɹɑɹkənɪzəm
queerdar	ˈkwiɹdɑɹ
rhinolalia	ˌɹaɪnoʊˈleɪliə
oligolalia	ˌɑlɪɡoʊˈleɪliə
agitolalia	ˌæd͡ʒɪtoʊˈleɪliə
agitophasia	ˌæd͡ʒɪtoʊˈfeɪʒə
furcal	[ˈfɝ.kəɫ]
circumpolloid	ˌsɝ.kəmˈpoʊ.lɔɪd
smithers	ˈsmɪðɚz
'ho	hoʊ
multicursal	ˌməltiˈkɝsəl
gork	ɡɔːɹk
heat rash	ˈhit ˌɹæʃ
batverse	ˈbætˌvɝs
trophoplast	ˈtɹɑfoʊplæst
pig pile	ˈpɪɡˌpaɪl
astrophile	ˈæs tɹoʊˌfaɪl
arrhizal	əˈɹaɪzəl
micropaedic	ˌmaɪkɹəˈpidik
crudeform	ˈkɹuːdˌfɔɹm
crude form	ˈkɹuːd ˌfɔɹm
y.o.l.o.	ˈjoʊ.loʊ
ethelborn	ˈɛθ(ə)lˌbɔɹn
aloe vera	ˈæ.loʊ ˈvɛ.ɹə
prochlorophyte	pɹoʊˈklɔɹəˌfaɪt
misogynoir	mɪˈsɑdʒ.ɪˌnwɑɹ
carrillo	kəˈɹɪloʊ
dunlap	ˈdʌnlæp
fernandez	fɚˈnændɛz
hogan	ˈhoʊɡən
hooper	ˈhupɚ
knowles	noʊlz
madden	ˈmædən
petty	ˈpɛti
russo	ˈɹusoʊ
snider	ˈsnaɪdɚ
romanesco	ɹoʊ.maˈnɛs.koʊ
cadel	[ˈkʰei.dl̩]
kimonoed	kəˈmoʊnoʊd
crowder	ˈkɹaʊdɚ
mímir	ˈmimɪɹ
chronolatry	ˌkɻəˈnɑlətɻi
file handle	ˈfaɪl hæn.dl
stylites	staɪˈlaɪtiz
file names	faɪl neɪms
oxyrhynchus	ˌɑksiˈɹɪŋkəs
anataxis	ˌænəˈtæksəs
lear	lɪəɹ
romajikai	ˌɹoʊmədʒiˈkaɪ
idiolalia	ˌɪdioʊˈleɪliə
guardiancy	ˈɡɑɹdi.ənsi
zante	ˈzænti
fiercen	ˈfɪəɹsən
aganactesis	ˌæɡənækˈtisɪs
spermatozoic	spɜɹˌmætəˈzoʊɪk
bledsoe	ˈblɛdsoʊ
plaqueless	ˈplækləs
memester	mimstɚ
austenian	ɔsˈtini.ən
vaporwave	ˈveɪpɚweɪv
idiotropic	ˌɪdioʊˈtɹɒpɪk
sogs	sɔɡz
gods	gɔdz
pasta fazool	ˌpɑstə fəˈzul
monthiversary	ˌmʌnθɪˈvɝs(ə)ɹi
genderblind	ˈdʒɛndɚˌblaɪnd
aracari	ɑːɹəˈsɑːɹi
matless	ˈmætləs
sefira	səˈfiɹə
mene mene tekel upharsin	ˈmɛni ˈmɛni ˈtɛkəl juˈfɑɹsɪn
clinamen	klaɪˈneɪmən
quelea	ˈkwiliə
snapless	ˈsnæpləs
foresyllable	ˈfoɹsɪləbɫ
acronical	əˈkɹɑnɪkəl
multifurcate	.mʌltiˈfɜ˞kət
multifurcate	.mʌltiˈfɜ˞keɪt
gridlocks	ˈɡɹɪdˌlɒks
mosby	ˈmoʊzbi
ethnonymy	ɛθˈnɒnɪmi
roubaisian	ɹoʊˈbeɪʒən
fragrant meat	ˈfɹeɪɡɹənt ˈmiːt
aznavour	ˌɑːznəˈvʊəɹ
whittier	ˈwɪtiɚ
plautus	ˈplɔtəs
canto	ˈkæn.toʊ
pluranimous	plʊˈɹæ.nɪ.məs
bronde	bɹɑnd
fortune stick	ˌfɔɹtʃən ˈstɪk
slagless	ˈslæɡləs
whuddup	[wʌˈɾʌp]
wuddup	[wʌˈɾʌp]
riverbend	ˈɹɪvɚˌbɛnd
wash-ball	ˈwɔʃˌbɔl
massacree	ˈmæs.ə.kɹi
quickscope	ˈkwɪkˌskoʊp
khomeini	koʊˈmeɪni
underkill	ˈʌndɚˌkɪl
underkill	ˌʌndɚˈkɪl
auding	ˈɑ.dɪŋ
maril	mɛˈɹɪl
flaubertian	floʊˈbɝti.ən
ambeer	ˈæmbɪɹ
braeburn	ˈbɹeɪbɝn
pidgin english	ˈpɪ.dʒən ˌɪŋ.ɡlɪʃ
reird	ɹiɚd
hyperdorism	ˈhaɪpɚˌdɔɹɪzm̩
hyperaeolism	ˈhaɪpɚˌaɪoʊlɪzm̩
hyperatticism	ˈhaɪpɚˌætɪsɪzm̩
hyperionism	ˈhaɪpɚˌaɪɑnɪzm̩
vox nihili	ˈvɒks ˈnaɪ hɪˌlaɪ
allolalia	ˌæləˈleɪliə
trisector	ˈtɹaɪˌsɛktɚ
together with	tʊˈɡɛðɚ wɪθ
prickly saltworts	pɹɪk.li sɑlt.wɚts
dole	[doʊ̯ɫ]
petrarchism	pɛˈtɹɑɹkɪzəm
taskless	ˈtæskləs
subfeu	ˈsəbˌfju
subfeu	ˌsʌbˈfjuː
umich	juˈmɪʃ
tamerlane	ˈtæməɹleɪn
shoemaker-levy	ˈʃu.meɪˌkɝ ˈlɛ.vi
nonschizophrenia	ˈnɒn.skɪt.səˌfɹi.ni.ə
nagless	ˈnæɡləs
albizzia	ælˈbɪzi.ə
albizzia	ælˈbɪtsi.ə
philostorgy	ˈfɪ.ləˌstɔɹ.dʒi
star wars day	[ˈstɑɹ ˈwɔɹz deɪ]
fighty	ˈfaɪti
voom	vum
emesene	ˌɛməˈsiːn
prevenge	pɹɪˈvɛndʒ
nabby	ˈnæ.bi
subumber	sʌbˈum.bɚ
parking coupon	ˈpɑɹkɪŋ ˈkjuˌpɑn
bto flat	 biː tiː əʊ flæt
reproachment	ɹɪˈpɹəʊtʃ.mənt
rebukement	ɹiˈbjuːk.mənt
salicide	ˈsælɪˌsaɪd
sachertorte	ˈsɑkɚˌtɔɹt
efren	ˈɛf ɹɛn
virtue signalling	ˈvɜɹtʃu sɪɡnəlɪŋ
rhyparographer	ɹɪ.pəˈɹɑ.ɡɹə.fɚ
rhyparograph	ɹɪˈpæ.ɹə.ɡɹæf
murgeon	ˈmɝ.dʒən
periergia	ˌpɛ.ɹiˈɝ.dʒi.ə
benedicite	ˌbɛnəˈdɪsɪti
rown	ɹoʊn
tonkotsu	tɑŋˈkɑtsu
dumpster fire	ˈdʌmpstɚˈfaɪəɹ
hypolemma	ˌhaɪpoʊˈlɛmə
arizonite	ˌæɹəˈzoʊnˌaɪt
blammo	ˈblæmoʊ
horizontal tango	ˌhɔː.ɹəˈzɑːn.təl ˈtæŋ.ɡoʊ
crime doesn't pay	kɹaɪm ˈdʌzˌənt peɪ
quartary	ˈkwɔɹ.tə.ɹi
pismirism	ˈpɪs.maɪ(ə)ˌɹɪ.zəm
homo superior	ˌhoʊmoʊ suːˈpɪɹiɚ
knee-breeches	ˌniˈbɹɪtʃəz
rigmarolish	ɹɪɡməɹoʊlɪʃ
gasahol	ˈɡæsəˌhɑl
heartly	ˈhɑɹtli
currente calamo	kəˈɹɛnteɪ ˈkaləmoʊ
active shooter	ˌæk.tɪv ˈʃuːtɚ
duergar	ˈdwɛɹ.ɡɑɹ
gove	ɡoʊv
arm span	ˈɑɹm.spæn
alytarch	ˈæ.lə.tɑɹk
febuary	ˈfɛb.juˌɛ(ə)ɹi
tiwed	ˈtaɪud
bouleutic	boʊˈl(j)uɾɪk
kash	kæʃ
chabadnik	χəˈbɑdnɪk
beveller	ˈbɛvəlɚ
anisopoikilocytosis	əˌnaɪ.soʊˌpɔɪ.kə.loʊ.saɪˈtoʊ.sɪs
la trobian	lə ˈtɹoʊbɪən
virtue signaller	ˈvɜɹtʃu sɪɡnələɹ
zero derivation	ˌziɹəʊ ˈdɛɹɪˌveɪʃən
any%	ˈɛni pɜɹ.sɛnt
la trobe	lə ˈtɹoʊb
clown-car primary	ˈklaʊn kɑɹ ˌpɹaɪməɹi
berengar	ˈbɛɹɪŋɡəɹ
smollett	ˈsmɑːlət
camorrista	ˌkɑməˈɹistə
nanoshuttle	nɑnoʊ ˈ ʃʌtəl
navaratna	nɑvɑɹɑtnɑ
kelleher	ˈkɛləhɚ
duckburg	ˈdʌkbɝɡ
barksian	ˈbɑɹksi.ən
rottol	ˈɹɑdɑl
arte povera	ˌɑɹteɪ ˈpoʊvəɹə
decrime	diˈkɹaɪm
volcel	ˈvɑlsɛl
leominster	ˈlɛmənstəɹ
scioto	saɪˈoʊtə
hypercalculia	ˌhaɪpɚ.kælˈkjuː.li.ə
bodyjack	ˈbɑ.di.dʒæk
holofernes	hɑːləˈfɝːniːz
beltrami	bɛlˈtɹæmiː
labeouf	ləˈbʌf
waldeyer's ring	ˈvældaɪeɹz ˌɹɪŋ
escrowee	ˌɛskɹoʊ̯ˈi
meehan	[ˈmiːhæ̝ːn]
knackless	ˈnækləs
suh	sʌ
seo	sʌ
schenck	ʃæŋk
new bern	ˈnuːbəɹn
alcazar	ˌælkəˈzɑɹ
littell	ˈlɪt.l̩
dolce vita	ˌdoʊltʃeɪ ˈvitə
satterly	ˈsætɚliː
iatmul	ˈjɑtmʊl
wilkes-barre	ˈwɪlks.bɛ.ɹi
birr	bɝ
pogge	pɑɡ
greenskin	ˈɡɹinskɪn
kennewick	ˈkɛnəˌwɪk
el clásico	ˌɛl ˈklæsɪkoʊ
corte	ˌkɔɹteɪ
lackless	ˈlækləs
monstress	ˈmɑnstɚɛs
windster	ˈwaɪnd.stɚ
dwimmery	ˈdwɪ.mɚ.ɹi
berniecrat	ˈbɝnikɹæt
sirtaki	sɚˈtɑki
ice bear	aɪsˌbɛəɹ
montferrat	ˌmɑntfəˈɹɑt
birch tree	ˈbɝtʃ ˌtɹi
viscachera	ˌvɪskɑˈtʃɛɹə
pineapple tart	ˈpaɪnˌæp.əl tɑːɹt
kuih tart	ˈkweɪ tɑːɹt
bell curve god	ˈbel kɜːɹv ɡɑːd
internet brigade	ˈɪn(t)əɹˌnɛt bɹɪˈɡeɪd
i need to vomit	aɪ nid tu ˈvɑmit
dota	ˈdoʊt̬ə
famagusta	ˌfɑːməˈɡuːstə
apush	ˈeɪ.pʊʃ
antishinto	ˌæntiˈʃɪn.toʊ
dectuple	ˈdɛktʊpɫ
decarceration	diːˌkɑɹ.səˈɹeɪʃən
decarcerate	diːˈkɑɹ.səˌɹeɪt
unakas	juˈneɪkəs
hypercathexis	ˌhaɪ.pɚ.kəˈθɛk.sɪs
bde maka ska	bəˈdeɪ məˈkɑ skɑ
stochastic terrorism	stəˈkæstɪk ˈtɛɹəɹɪzəm
doujin event	ˈdoʊ.dʒɪn ɪˈvɛnt
doujin music	ˈdoʊ.dʒɪn ˈmjuzɪk
doujin game	ˈdoʊ.dʒɪn ɡeɪm
vin santo	ˌvɪn ˈsɑntoʊ
port said	pɔɹt sɑˈiːd
molochize	ˈmoʊlɑkaɪz
eunatremia	ˌjuː.nəˈtɹiː.mi.ə
eunatremic	ˌjuː.nəˈtɹiː.mɪk
sig. fig.	sɪɡ ˈfɪɡ
multiworld	ˈmʌltaɪˌwɜːɹld
bradyphasia	ˌbɹeɪdəˈfeɪʒə
bisweptual	baɪˈswɛp.t͡ʃu.əl
weigh enough	weɪ əˈnʌf
chotki	ˈt͡ʃoʊtki
evilworker	ˈiːvɪlwɝ.kɚ
miliary abscess	ˈmɪ.liˌɛɹ.i ˈæbˌsɛs
nebbiolo	ˌnɛbiˈoʊloʊ
alliyah	ɑˈlijə
charlyne	tʃɑɹˈlin
engelene	ˈɛndʒɛˌlin
zelina	ˈzɛlinə
alanic	əˈleɪnɪk
transmisogynoir	ˌtɹænz.mɪˈsɑdʒ.ɪˌnwɑɹ
pannierwise	ˈpæn.i.ɚ.ˌwaɪz
conculture	ˈkɑn.ˈkʌl.t͡ʃə
davao	dɑ.ˈvaʊ
morphologization	mɔɹˌfɑlədʒˈaɪzeɪʃən
finsta	fɪnstə
bethsaida	ˌbɛθ.ˈseɪ.ɪ.ɾə
efflagitations	əˌflæd͡ʒ.ɪ.ˈteɪʃəns
beechmast	ˈbitʃˌmæst
'mater	ˈmeɪtɚ
oversuit	ˈoʊ.vɚ s(j)ut
-poo	pu
reptilious	ɹɛpˈtɪljəs
reptitious	ɹɛpˈtɪʃəs
repertible	ɹɪˈpɝtəbəl
slish	slɪʃ
futureness	ˈfjuːt͡ʃɚnəs
gunate	ɡuneɪt
horseshoe curve	ˈhɔːɹs.ʃuː kɝv
hashflag	ˈhæʃˌflæɡ
attap	ˈaˌtap
croppie	ˈkɹɑpi
chu nom	t͡ʃuː ˈnoʊm
boutta	baʊɾə
shivvy	ˈʃɪvi
metzian	ˈmɛtsi.ən
lieberal	ˈlaɪbəɹəl
proust	pɹust
contentlessness	ˈkɑn.tɛnt.lɪs.nɪs
zucc	zʌk
netherdutch	ˈnɛðɚdʌt͡ʃ
dual earner	ˈd(j)uː.əl ɝnɚ
archaeographist	ɑːkiːˈɒɡɹəfɪst
jagirdar	ˈdʒæ.ɡɝˌdɑɹ
obummer	oʊˈbʌ.mɚ
asceticist	əˈsɛt.əˌsɪst
abligation	ɑb.ləˈɡeɪ.ʃən
tickler file	tɪkəlɚ faɪl
riley	ˈɹaɪli
ordinal numeral	ˈɔːɹd.nəl ˈnumɜɹəl
floridean	ˌflɔɹɪˈdiən
illinoian	ˌɪləˈnɔɪən
gaycist	ˈɡeɪ.sɪst
lenten fare	ˈlɛntən ˈfɛɚ
kellion	kɛˈliːɑn
kellia	kɛˈliːə
overvalued idea	ˌoʊ.vɚˈvæljud aɪˈdi.ə
girldick	ˈɡɝlˌdɪk
douzeper	ˈduzpɪɹ
churchish	ˈtʃɚtʃɪʃ
buffont	ˈbʌf.ənt
neo-thrash	ˈni.oʊˌθɹæʃ
realschule	reɪˈɑlˌʃulə
real school	ˈril ˌskul
orientee	ˈɔriəntiː
workamping	wɝkˈkæmpɪŋ
karlene	kɑɹˈlin
esav	ˈeɪ.sav
yaakov	ˈjaː.koʊv
purse	pɝs
zawra'	zaw.raːʔ
muzawwara	muˈzaʊəɹə
flimmer	ˈflɪmɚ
elagabalus	ˌɛləˈɡæbələs
glutose	ˈɡlutoʊs
complisult	ˈkɑmplə.sʌlt
apples of the eye	ˈæp.əlz.əv.ðiˈaɪ
asherah	əˈʃiɹə
chaffle	ˈt͡ʃɑ.fl
climate strike	ˈklaɪmət straik
fall into a trap	fɑːl ɪntə ə træp
illyromania	ɪˌlɪɹoʊˈmeɪniə
el capitan	ɛl kæpəˈtæn
holler copper	ˌhɑ.lɚ ˈkɑ.pɚ
parley-vous	ˌpɑɹ.liˈvu
saint martin	ˌseɪnt ˈmɑɹ.tɪn
ka-bar	ˈkeɪ bɑɹ
ka-bar	ˈkeɪ bɑː
los altos	ləʊs ˈæltoʊs
ione	aɪˈoʊn
debt obligation	dɛt ɑb.ləˈɡeɪ.ʃən
pactless	ˈpæktləs
covid	koʊvɪd
zoar	ˈzɔʊ.ɑɹ
caulini	kɔlˈiːni
caulini	kɑlˈiːni
faroe	ˈfæɹoʊ
porto vecchio	ˌpɔɹtoʊ ˈvɛkioʊ
polisci	ˈpɑ.liˌsaɪ
dadless	ˈdædləs
freester	 /ˈfɹistɚ
crateral	ˈkɹeɪ.tɚ.əl
wet meadow	wɛt ˈmɛdoʊ
qumran	kʊmˈɹæn
sefirah	səˈfiɹə
tech bro	ˈtɛk.bɹoʊ
zero derive	ˌziɹəʊ dəˈɹaɪv
horseshoe moustache	ˈhɔːɹs.ʃuː ˈmʌstæʃ
mexican colony	ˈmɛk.sɪ.kənˈkɑləniː
creeker	kɹikɚ
hiller	ˈhɪlɚ
subcommentary	sʌbˈkɑmənˌtɛɹi
10x developer	ˌtɛˈnɛks dɪˈvɛ.lə.pɚ
apamene	ˌæpəˈmiːn
mclenaghen	məˈklɛnɪhæn
mimbo	ˈmɪmboʊ
inappropro	ˌɪnəˈpɹoʊ.pɹoʊ
arcdegree	ˈɑɹkdɪˌɡɹiː
jokul	ˈjoʊ.kəl
vorlage	ˈfɔɹˌlɑ.ɡə
timb	tɪmb
con amore	ˌkɑn əˈmɔɹeɪ
your guys'	ˈjɹ̩ ɡaɪzəz
barff	bɑɹf
surreptition	səˌɹɛpˈtɪʃən
g'wan	ɡwɑn
sheanderthal	ʃiːˈæn.dɚˌθɑːl
sheanderthal	ʃiːˈæn.dɚˌtɑːl
sheanderthal	ʃiˈændəɹθəl
potrack	ˈpɑtɹæk
patterroller	pætəˈɹoʊlɚ
run-awayer	ˈɹʌnəweɪɚ
wrop	ɹɑp
homes in	hoʊm ɪn
homing in	hoʊmɪŋ ɪn
manual reversion	ˈmænjə(wə)l ɹɨˈvɚʒn̩
airgasm	ˈɛəɹ.ɡæz.əm
berger picard	bɛɹˌʒeɪ pɪˈkɑɹ
yokelry	ˈjoʊkəlɹi
kanye	ˈkɑnjeɪ
chauceriana	tʃɔˌsɪɹiˈænə
chaucerianism	tʃɔˈsɪɹi.ənɪzəm
