animal	neuter
attention	c
bird	c
boat	c
book	c
brother	c
bug	neuter
clothing	neuterÂ pl
daughter	c
dog	c
door	c
drum	c
enemy	c
fire	c
food	c
gift	c
glass	neuter
guard	c
horse	c
house	neuter
livestock	neuter
love	c
idea	c
man	masculine
monster	neuter
name	neuter
rock	c
rope	neuter
size	c
son	c
sound	neuter
warmth	c
warmth	neuter
water	neuter
way	c
wind	c
window	neuter
woman	c
work	neuter
