*	foreign	native
*	infinitive	group
be	бы́ть	irregular
see	ви́деть	irregular
give	дава́ть	irregular
give2	да́ть	
eat	е́сть	irregular
live	жить	irregular
call	зва́ть	irregular
go	идти́	irregular
write	писа́ть	irregular
read	чита́ть	
return	верну́ть	1, -нуть
draw	рисова́ть	1, -овать
spit	плевать	1, -евать
dance	танцева́ть	1, -евать
be able	мо́чь	1, -чь
bake	пе́чь	1, -чь
carry	нести́	1, -сти
lead	вести́	1, -сти
sweep	мести́	1, -сти
row	грести́	1, -сти
steal	кра́сть	1, -сть
convey	везти́	
climb	ле́зть	1, -зть
wash	мы́ть	1, -ыть
beat	би́ть	1
wind	ви́ть	1
pour	лить	1
drink	пи́ть	1
sew	шить	1
live	жи́ть	
swim	плы́ть	1
pass for	слыть	1
speak	говори́ть	2
love	люби́ть	2, -бить
catch	лови́ть	2, -вить
sink	топи́ть	2, -пить
feed	корми́ть	2, -мить
ask	проси́ть	2, -сить
convey	вози́ть	2, -зить
pay	плати́ть	2, -тить
go	ходи́ть	2, -стить
forgive	прости́ть	
		
		
		
		
		
		
		
		
		
		
		
		
		
		
		
		
		
		
		
		
		
		
		
		
		
		
		
		
		
		
		
		
		
		
		
		
		
		
		
		
		
		
		
		
		
		
		
		
		
		
		
		
		
		
		
		
		
		
		
		
		
		
		
		
		
		
		
		
		
		
		
		
		
		
		
		
		
		
		
		
		
		
		
		
		
		
		
		
		
		
		
		
		
		
		
		
		
		
		
		
		
		
		
		
		
		
		
		
		
		
		
		
		
		
		
		
		
		
		
		
		
		
		
		
		
		
		
		
		
		
		
		
		
		
		
		
		
		
		
		
		
		
		
		
		
		
		
		
		
		
		
		
		
		
		
		
		
		
		
		
		
		
		
		
		
		
		
		
		
		
		
		
		
		
		
		
		
		
		
		
		
		
		
		
		
		
		
		
		
		
		
		
		
		
		
		
		
		
		
		
		
		
		
		
		
		
		
		
		
		
		
		
		
		
		
		
		
		
		
		
		
		
		
		
		
		
		
		
		
		
		
		
		
		
		
		
		
		
		
		
		
		
		
		
		
		
		
		
		
		
		
		
		
		
		
		
		
		
		
		
		
		
		
		
		
		
		
		
		
		
		
		
		
		
		
		
		
		
		
		
		
		
		
		
		
		
		
		
		
		
		
		
		
		
		
		
		
		
		
		
		
		
		
		
		
		
		
		
		
		
		
		
		
		
		
		
		
		
		
		
		
		
		
		
		
		
		
		
		
		
		
		
		
		
		
		
		
		
