							
catch		WC *kagh-					
cauldron	*kʷ erus						
cave		GA *ka ́iwr̥(t)					
cavity	*h ₂elwos ,*h₂ e ́ryos						
caw	*ker-						
cedar		WC *h₁ elew-					
chaff	*pel(o/e)hₐ-, 	WC *kʷ et-					
chain	*wo ́rghs						
characteristic	*s(w)edh-						
charcoal	*Ho ́ngl̥, 	NW *perk-					
charm	*meng-						
cheat		NW *meug-					
cherry		WC *kr̥nom					
chew	*gˆyeuH-, 	WC *mandh - or *mant-					
chickpea		WC *kˆikˆer-					
child	*teknom						
chin	*men, *smekˆ-, *smo ́kˆwr̥						
circle	*a ̄nos, *h ₃ e ́rbhis, *serk-						
clan	*wikˆ-						
clay	*ml̥dh(o/e)hₐ-, *tkʷ reh₁ yot-, 	WC *gloiwos					
clean	*peuH-, 	WC *kˆleu-					
clear	*leuko ́s, *(s)koitro ́s						
cliff	*pel(i)s-						
cloak	*drap-  *drop-, 	NW *ruk-,	WC *baite ́hₐ-				
close	the eyes *meigh-  *meik-						
cloth	*los-, *p(e)h ₂ n(o/e)hₐ-, 	WC *bhr̥w-,	WC *lo ̄p-				
clothes	*drap-  *drop-, *wosp(o/e)hₐ-,	WC *ke ́ntr/n-					
cloud(y)	*ne ́bhes–, *sneudh-, 	NW *bhlendh-					
club		NW *lorgehₐ-, 	WC *bak-, 	GA *wa ́gˆros			
coal	*g(e)ulo-						
cold	*kˆelto-, *kʷ ruste ̄n, 	NW *gel-, 	WC *h ₃ eug-, *srı ̄ges-				
colour (deep intense shade) 	*kˆyeh ₁-						
comb	*kars-, *kes-						
combat		NW *nant-					
come	*gʷ ehₐ-, *gʷ em-						
commit	a crime 	NW/PIE? *h₂/₃ wergh-					
commotion	(be in) *dheu(H)-						
companion	*so ́kʷ-h ₂-o ̄i, 	NW *dhrougho ́s, 	GA *h₂e ̄pis				
compel		WC *bheidh-					
grunt		WC *g(h)ru(n)(d)-					
guard	*peh ₂-						
guest		NW *ghostis					
gullet	*gutr̥, 	WC *bherug-					
gulp	*srebh-						
gums		NW *ghe ́hₐ(u)-mr̥, 	GA *wo ́lswom				
hail	*ghel(h8₂)d-, 	WC *gro ̄do-, 	WC *kaghlos				
hair	*dekˆ-, *dhrigh-, *go ́wr̥, *ghₐit(so)-, *kˆripo-, *pou-m-s-, *pilos, *pulos, *wendh-, *we/ondhso-, *yo ́kˆu, 	NW *kˆer(es)-					
half	*se ̄mis						
hand	*gˆhe ́sr-, *gˆho ́stos, *me ́hₐr						
hand	(belonging to little) *mei-wos						
handle	*h ₂ensehₐ-						
handle	(skilfully) *sep-						
hang	*lemb-  *remb-, *kˆonk-						
happy	*meud-, *teus-						
hard	*kar-, *sth ₂ei-, 	NW *saiwos					
hare	*kˆasos						
harm	*dhebh-, *dhwerH-, *mel-, *peh ₁(i	WC *sket(h)-					
harrow	*h ₁/4oke ́tehₐ-						
harvest	*kerp-, 	WC *h ₂ merg-					
hate	*h ₃ed-, *kˆehₐ des-, *peik/kˆ-						
haunch	*kˆlo ́unis						
hawk		NW *kap-					
hawthorn	*h ₂ed(h)-						
hazel		NW *ko ́s(V)los					
head	*ghebho ̄l, *kapo ̄lo-, *kˆr̥re ̄h ₂, 	NW *ka ́put					
headband		GA *de ́h ₁ mn̥, 	GA *pukˆ-				
heal	*med-, 	WC *bher-, 	WC *yak(k)-				
healthy		WC *ko ́hₐ ilus					
heap		WC *me ́uH ko ̄(n)					
hear	*kˆleu-, *kˆleus-						
heart	*kˆe ̄rd						
hearth	*h ₂eH sehₐ-, 	WC *h ₂eHtrehₐ-					
heat		WC *wel-					
heavy	*gʷ r(e)hₐ(-u)-, *tengh-						
hedge	*gho ́rdhos, 	NW *kagh-					
hedgehog	*h ₁egˆhis, 	WC *ghe ̄ ́r					
heel	*pe ̄nt-, *pe ́rsnehₐ-, *spr̥h ₁o ́-						
he-goat	*bhugˆos, *hₐ egˆo ́s, *h 4 eli-, *ka ́pros						
height	¼ fort 	WC *bhergˆh-					
heir	*h ₂/₃ orbhos						
hellebore		WC *kemeros					
help		NW *kˆelb-					
hemp		WC *kannabis					
hen	*kerk-						
henbane		NW *bhel-					
herd	*wre ̄tos, 	NW *kerdhehₐ-					
herdsman	*we ́stor-, 	WC *poh ₂ ime ́n-					
here	*h ₁ idhₐ						
hernia	*kˆe ́uH-, *ke ́uH l̥						
hew	*kehₐ u-, *kel-						
hide	(conceal) *gheigˆh-, *gheugˆh-, *kˆeudh-						
hide	(skin) *hₐ egˆı ́nom, *pel-, *(s)kʷe ́H 	WC *na	́k(es)-, 	WC *pe ́ln-			
high	*bhergˆh-, *bhr̥gˆhu ́s  *bhr̥gˆhe ́nt-, *h ₂ erdus, *worh	x dhus					
high	one *bhr̥gˆhn̥tihₐ-						
hill	*bhergˆh-, 	WC *kolH o ̄n					
hind/cow-elk		NW *h ₁ elh₁ nı ́hₐ-					
hip	*kˆlo ́unis, *sre ̄nos/ehₐ-						
hire	*kuHs-						
hiss		WC *ger-					
hoarfrost		WC *kˆer(s)no-					
hock	*kenk-						
hoe	*mat-						
hold	*h ₂ em-, *h₂ erk-, *segˆh-, *skabh	WC *(s)lagw-,	WC *twer-, 	E *yem-			
hole	*gˆhh8a wos, *kˆo ́uH r̥						
hollow	*h ₂ elwos, *kul-						
hollow	of (major) joint *ko ́kˆs-(o/e)hₐ-						
hollow	out *kˆeu(H)-, *keus-						
holy	*kˆwen(to)-, *noibhos, *sakros						
hone	*kˆeH(i)-, *kˆoH nos						
honey	*me ́lit						
honey-coloured,	golden *khₐ o ́nks						
honour	*dekˆes-, 	GA *yagˆ-					
hoof	*kˆoph ₂o ́s						
hook	*h ₂ o ́nkos, *ko(n)gos, 	WC *klehₐ wis					
hoopoe	*h ₁ epop						
hoot	*ul-						
hop	about 	WC *sker-					
horn	*kˆer-, *kˆe ́rh8₂ s, *kˆe ́rh8₂ sr̥, *kˆo ́ru, *kˆr̥nom						
hornbeam		WC *(s)grehₐ b(h)-					
hornet		NW *kˆr̥h ₂sro-(H)on-					
hornless	*kˆem-						
horse	*gˆhe ́yos, *h ₁ e ́kˆwos, 	NW *ma ́rkos,	C *mendyos				
horsehair	*re ́umn-						
hostile	*peik/kˆ-, 	GA *dusmene ̄s					
hot	*h ₂eH-, *tep-, 	NW *keH i-					
house(hold)	*do ̄ ́m, *do ́m(hₐ)os, *kˆe ́iwos, *pe ̄	WC *kˆo	́imos,				
how		WC *kʷ ehₐ m					
howl	*bukk-, *bhels-, *reu-, *ul-, 	NW *ka ̄ ̆u	WC *ger-				
how	much/many *kʷ o ́ti  *kʷ e ́ti						
hue	and cry *kreukˆ-						
hum		NW *kem-					
humble		WC *kaunos					
hundred	*kˆm̥ to ́m						
hunger	*Kos-t-, 	WC *kenk-					
hunt	*hₐegˆrehₐ-, *leuH-, *wreg-						
hurl	*h ₁es-						
hurry	*krob-, *speud-						
husband	*po ́tis, *wiH ro ́s						
husband’s	brother *daihₐ we ̄ ́r						
husband’s	brother’s wife *h ₁yenhₐ-ter-						
husband’s	sister *gˆl̥h₃ wos-						
hush		WC *swı ̄g/k-					
i	*h ₁egˆ, *h ₁ me						
ice	*h ₁eiH(s)-, *yeg-						
icicle	*yeg-						
ill	*h ₃ligos, *swergh-, 	WC *seug-					
immediately		WC *pos					
immobile	*dher-						
impels	*gˆhei-, *yeugˆ-						
in	*h ₁e ́ndo, *h ₁en(i), *h ₁ ente ́r						
incline	*(w)rep-						
increase	*hₐeug-						
infertile	*ster-						
inflated		WC *bhlei-					
in	front of *h ₂enti, *pr̥hₐ e ́h ₁, *pr̥hₐe ́i						
injure		WC *sket(h)-					
innards	*h ₁ent(e)rom						
inner	part *kokˆes-						
insect	*kʷ r̥mis, *mat-, 	WC *wr̥mis					
quail		GA *wortokʷ-					
quarrel	*h ₃enh ₂-						
quern	*gʷ re ́H-won-						
quick		NW *h₂ e ̄H tro-					
quiet	*h₁erh₁-, *kʷ						
eih1-,	*ses-, 	NW/PIE? *t(e)h₂u-s-,	NW *le ̄nos, 	NW *(s)tel-			
rain	*dhreg-, *h₁ wers-, *n̥bh(ro/ri)-, *suH	WC *h	aeghlu (gˆh?), 	WC *mregh-			
raise	*kel-, *telh ₂-						
rake	*h ₁/4ek-, *h ₁/4 oke ́tehₐ-, *h ₂eh ₂er-						
ram	*moiso ́s						
rattle		WC *sner-					
raven	*kVr-	C-					
raw	*h ₂em-, *h ₂omo ́s						
razor		GA *ksuro ́m					
reach	*tem-						
reach	for *seik-						
real	*h ₁so ́nt-						
rear-end	*h ₁o ́rs(o)-, 	WC *n(o)Ht-					
recite	*(s)pel-						
red	*h ₁ei-, *h ₁ elu-, *h ₁ reudh-, *kˆo ́unos						
red	deer *h ₁elh ₁ e ̄n						
red	fox *wl(o)p-						
reed	*hₐer-, *nedo ́s, 	NW *yoinis, 	WC *don	WC *trus-,	E *g(h)rewom		
refresh	*h ₁/4eis-						
reins	*h ₂ensiy(o/e)hₐ-						
rejoice	*gehₐ-, *gehₐ dh-, *gehₐu-						
relation	*bhendhr̥ros						
release	*leuH-, *selgˆ-, *TerK-						
remain	*men-						
remains	*(h ₁ eti)loikʷ os						
remember	*(s)mer-						
remove	*meus-						
rend	*h ₂erk-, *rendh-, 	WC *lak-					
reproach	*h ₁lengh-						
repulse	*(s)peud-						
resin	*sokʷ o ́s						
resound	*gerg-, *klun-, *swenH-, 	WC *(s)wehₐ gh-					
rest	*kʷ eih ₁-, *ses-						
restitution	*serk-						
return	home *nes-						
revel		WC *ghleu-					
revere	*kʷ eh₁(i)-						
revile	*piH(y)-						
reward	*misdho ́s						
rib	*pe ́rkˆus						
rich		GA *h₁ su-dhh ₁ e ́nos					
rich	in milk *pipiH usihₐ						
ride	*wegˆh-, 	NW *reidh-					
right	*de ́kˆsinos, *h ₃regˆtos						
ring	*a ̄nos, 	NW *nedske ́hₐ-					
rise	*swelno-						
river	*dehₐ nu-, *h ₂eb(h)-						
river	bank 	WC *hₐ eH peros(?)					
river	name *drewentih ₂-						
road	*h ₁ e ́itr̥-, 	WC *wegˆhyehₐ-					
roar	*reu-						
roast	*bher-, *bhr̥g-, *h₃ ep-, 	WC *bho ̄g-					
rock	*peru-						
rod	*swer-						
roedeer		WC *yo ́rks					
roof	*h ₁ rebh-, 	NW *kˆro ́pos, 	WC *(s)te ́ges-				
room	*ket-						
room	(hₐve) *telp-						
root	*a ̄lu-, 	WC *wr(hₐ)d-					
rot	*peu(H)-						
rough	*kreup-						
row	(boat) *h ₁ erh₁-						
row	(series) *wo ́rghs						
rub	*bhes-, *kseu-, *merd-, 	WC *ter(i	WC *treu(h	x)-			
rude		NW *saiwos					
rule	*deikˆ-, *po ́tyetoi, *wal-, 	GA *tkeh ₁-					
ruler	*h ₃ re ̄ ́gˆs						
rumble	*ghrem-						
rumen	*reumn-						
rump	*bulis						
run	*bhegʷ-, *drehₐ-, *drem-, *dreu-, *dhen-, *kˆers-,	*reth₂-, *tek-, 	NW *tregh	WC *dhregh-,	GA/PIE? *dheu-		
rush	(reed) *nedo ́s, 	NW *yoinis, 	WC *trus-, 	E *g(h)re-			
wom							
rye	*hₐ e ́rehₐ-, 	NW *rughis					
sacred	power 	GA *ish₁ ros					
sacrifice	*hₐ ed-bher-, *tolk(o/e)hₐ-						
sacrificial	animal 	WC *dibhro-  *dı ̄bhro-					
sacrificial	meal *dapnom, *tolk(o/e)hₐ-						
salmonid	*lo ́kˆs, 	NW *str̥(H)yon-					
salt	*sehₐ-(e)l-						
same	*somos						
sand		WC *samh8x dhos					
sap	*sap-  *sab-, *sokʷ o ́s						
satisfaction	*te ́rptis, 	NW *se ́h ₂ tis					
satisfied	*speh₁-						
satisfy	*seh₂(i)-, *terp-, 	WC *sh8₂ to ́s					
say	*gʷ et-, *h ₁egˆ-, *(s)pel-, *(s)wer-, 	WC *sekʷ-					
saying		WC *bhehₐ mehₐ-					
scabby	*kreup-						
scare	*tergʷ-						
scatter	*(s)ked-						
scrape	*merd-, *red-						
scratch	*drep-, *kars-, *rei-, *reik-, 	NW *skebh	WC *(s)grebh-				
scream		NW *wehₐ b-					
scream	(of birds) 	WC *kla(n)g-					
scrotum	*h ₁endro ́s						
scuttle	along *lek-						
sea	*mo ́ri						
season	*(h ₁)ye ̄r(o/e)hₐ-,						
seat	*sedes-, 	WC *sedlom, 	WC *sedros				
second	*dwi-yos  *dwi-tos						
see	*derkˆ-, *legˆ-, *leuk-, *sekʷ-, *weid-, *wel-, *wet-,	GA *h ₃ekʷ-					
seed		NW *seh₁ men-					
seek	*hₐeis-, *sehₐg-, *sen(hₐ)-						
seep		WC *stag-					
seer		NW *wo ̄t-					
seethe	*bher-, *bhreu-, 	WC *kʷ ap-					
seize	*ghₐbh, *h ₁ep-, *kap-, *la(m)bh	WC *ghe(n)dh-,	WC *sel-				
self	*se ́we						
sell	*pel-						
send	out *selgˆ-						
separate(d)	*widh-, 	GA *h₁ er(h ₁)-					
servant	*h ₂entbhi-kʷ olos, *h 4 upo-sth₂ i/o-, 	NW *slo ́u-					
gos							
set	*sed-, 	NW *dheigʷ-					
smell	(stink) 	WC *h ₃ ed-					
smile	*smei-						
smith	god *wl̥ka ̄nos  *wl̥kehₐ nos						
smoke	*dhuh ₂ mo ́s, 	WC *kʷ ap-, 	WC *(s)m(e)ug(h)-				
smooth		NW *ghleHdh-(ro)-					
smoulder	*(s)mel-, *swelp-						
snail		WC *sleimak-					
snake	*h ₁ o ́gʷ his, 	NW *ne ́h ₁tr-  *nh ₁tr	WC *h	a e ́ngʷ his			
snatch		WC *h ₁ rep-					
sneak	up on *(t)sel-						
sneeze	*pster-, *skeu-, 	WC *pneu-					
snore		WC *srenk-					
snort		WC *pneu-					
snow	*dhreg-, *gˆheim-, *sneigʷ h-, *snigʷ h-	WC *kˆer(s)no-					
soak		WC *teng-					
soft	*meldh-, *mel(h ₁)-, 	NW *l(e)nto-, 	C *menkus				
so	many *te ́hₐwot(s), 	WC *to ́ti					
some	*sm̥ o ́s						
so	much 	WC *to ́ti					
son	*putlo ́s, *suHnu ́s, *suH yu ́s						
song	*sh ₂ o ́men-						
son-in-law	*gˆomH-ter-, 	WC *gˆm̥ H-ro-s					
son’s	wife *snuso ́s						
soon	*mokˆs						
soot	*reh ₁mo ́s						
sorcery		NW *soit(o/e)hₐ-					
sort	(of whₐt) 	NW *kʷ ehₐ k-, 	WC *kʷ ehₐli				
sort	or size (of thₐt) 	WC *tehₐ li					
sound	*dhwen-, *gˆhwonos, *kˆle ́utrom						
sour	*h ₂ emros, 	NW *suH ros					
sow	(verb) *seh ₁-, *sper-						
sparrow	*sper-						
speak	*gal, *h ₁ eugʷ h-, *h ₁/4 o ̄r-, *mleuH-, *rek-, *(s)wer-,	*ter-, *wegʷ h-, *wekʷ-, 	NW *tolk w-, 	WC *bhehₐ-, *(s)preg-			
spear	*gˆhₐiso ́s, *gʷ e ́ru, *kˆu ́H los, 	WC *h ₁negˆhes-,	WC *hₐ eikˆsm(o/e)hₐ-				
spearpoint	*kˆel(H)-						
speckled	*perkˆ-						
spell	*H olu-						
spew	*(s)py(e)uH-, *we ́mH mi						
spin	*melk-, *(s)pen-						
spirit	*hₐ e ́nsus, 	NW *dhwes-, 	WC *lem-				
spit	(spear) *gʷ e ́ru, *kˆu ́H los, 	WC *hₐeikˆsm(o/e)hₐ-					
spit	(spew) *(s)py(e)uH-						
spleen	*sploigˆh ₂-e ̄ ́n						
splinter	*kˆo ́kolos						
split	*bheid-, *bher-, *del-, *drep-, *skel-, *wagˆ-						
spongy		WC *swombhos					
spotted	*pikˆskˆo-, 	NW *rei-, 	GA *kˆe ́rberos				
spouse		WC *sm̥ -loghos					
spread	out *pethₐ-, *pelhₐ k-, *pleth₂-, *ster-, 	NW *klehₐ-					
spring	(season) *we ́sr̥						
spring	(water) 	WC *bhreh ₁wr̥, 	WC *kr̥snehₐ, 	E *hₐ e ́lmos			
sprinkle	*pers-, 	NW *sperH g-					
sprout		WC *dhₐl-					
spurn	*sperh₁-						
sputter	*(s)pr̥Hg-						
squeeze	*bhrak-, *nak-, 	WC *gem-					
squirrel	*werwer-						
stab	*h ₁negˆh-, 	WC *gʷ el-					
staff		NW *gˆhₐsdhos					
stag		WC *bhrento ́s					
stake	*mı ́ts, 	WC/PIE? *wa ́lsos, 	WC *gˆhₐlghehₐ-, *kˆsu ́lom,  *(s)ko ̄los				
stalk	*kˆo ́lHo ̄m, 	WC *kaulo ́s					
stall	*mand-						
stammer	*balba-  barbar-						
stand	*(s)teh ₂-, *stembh-, *wredh-						
star	*h ₂ste ̄ ́r						
starling		NW *storos					
stature	*ste ́h ₂ mo ̄n						
steal	*mus-, *(s)teh4-, *teubh-, 	WC *ster-					
steam	*wa ́po ̄s						
stem	*kˆo ́lHo ̄m						
step	*ghredh-, *gˆhengh-, *spleigˆh-, *steigh-						
stick	(adhere) *leip-, 	NW *dheigʷ-					
sticky	*(s)lei-						
stiff	*(s)terh ₁-, *st(h ₂)eug-						
stiffen	(of hₐir) *gˆhers-						
still		NW *(s)tel-					
sting		NW *dhelg-, 	WC *gʷ el-				
stinger		WC *gʷ elo ̄n					
stink	*peu(H)-, *pu ̄- (*puH-?), *weis-						
stir	*menth₂-, *twer-						
stir	up *yeudh-, *yeugˆ-						
stoat		NW *kˆormon-					
stomach	*gʷ e ́tus, *pant-, *udero-, *ud s tero-						
stone	*h 4 e ́kˆmo ̄n, *pel(i)s, 	WC *leh ₁-w-, 	WC *lep-				
storeroom	*gubh(o/e)hₐ-, *kˆe ̄ls						
stork	*(s)ter-						
stranger		NW *ghostis					
strap		WC *(s)bhondnehₐ					
straw	*kˆo ́lH o ̄m						
strength	*hₐ e ́nr̥, *hₐ euges-, *we ́iH(e)s-, *wo ́r(H)gˆs						
stretch	*h ₃ regˆ-, *pet-, *temp-, *ten-, 	NW *reigˆ-					
strew	*sper-, *ster(h ₃)-, 	NW *sperH g-					
strewn	place *ster(h₃)mn̥						
strike	*bhei(H)-, *bher-, *gʷ hen-, *kehₐu-, *kel-, *kreu(-s)-, *per-, *pyek-, *steup-, *wedh-, *wel(h	₂)-, *wen-, 	NW *bheud-, *bhlagˆ-, *slak-, 	WC *bhliH gˆ-, *depH *g w el-, *kelh₁-, *plehₐ k/g-, 	GA *tkˆen-		
strike	one’s breasts 	WC *plehₐk/g-					
string		WC *strenk-					
strip	*(s)pel-, 	WC *lep-					
striped		NW *rei-					
strive	*wenH-						
strong	*be ́los, *wal-, *wegˆ-, *weiH-						
struck	*temH-						
sturgeon		NW *hₐ ekˆe(tro)-, 	NW *str̥(H)yon-				
subdue	*demH-						
success		NW *kobom					
suck(le)	*dheh ₁-, 	NW *seug/k-					
suckling		WC *dheh ₁ lus-					
suffer	*k(w)eikˆ-, 	WC *kʷ ent(h)-					
suffering	*hₐ em(H)ı ̄wehₐ, *hₐ e ́ngˆhes-, 	GA *pe ́h₁ mn̥					
sufficient	*gʷ hono ́s						
summer	*sem-						
sun	*se ́hₐul						
support	*dher-, 	WC *stl̥nehₐ-					
surpass	*serK-, 	GA *peri-h ₁es-					
surprise	(sound of) *hₐ						
surround	*gherdh-, *wer-						
swallow	*gʷ erh ₃-, *kʷ em-, *peh ₃(i)-						
swamp		WC *H iH lu					
swan		WC ?*h ₁ el-					
swear		GA *hₐ emh ₃-					
sweat	*h 4 elh ₁n-, *sweid-						
sweep	*swep-						
