#english	lemma	part of speech	proto indo european		
I                   	I             	noun                 	éǵh₂(om)                         		
you                 	you           	noun                 	túh₂                             		
he, she, it         	he            	noun                 	éy, is                               		
we                  	we            	noun                 	wéy                              		
you all               	you all      	noun                 	yū                               		
they                	they          	noun                 	éyes                             		
this                	this          	noun                 	só, séh₂, tód                    		
that                	that          	noun                 	yós, yéh₂, yód                   		
here                	here          	noun                 	ḱi                               		
there               	there         	noun                 	h₂en                             		
who                 	who           	noun                 	kʷis (pron.), kʷod (adj.)        		
what                	what          	noun                 	kʷis                             		
where               	where         	noun                 	kʷesmi                           		
when                	when          	noun                 	                                 		
how                 	how           	noun                 	                                 		
not                 	not           	adverb              	n̥-, ne                          		
all                 	all           	determiner            	                                 		
many                	many          	determiner            	monogʰo-                         		
some                	some          	determiner            	kaylo-, solwo-                   		
few                 	few           	determiner            	peh₂w-                           		
other               	other         	determiner            	h₂élyos, h₂el-nó-                		
one                 	one           	noun                 	(H)óynos, (H)óykos, (H)óywos, sḗm		
two                 	two           	noun                 	dwóh₁; dwó                       		
three               	three         	noun                 	tréyes                           		
four                	four          	noun                 	kʷetwóres                        		
five                	five          	noun                 	pénkʷe                           		
six                 	six           	noun                 	swéḱs                           		
seven               	seven         	noun                 	septḿ̥                           		
eight               	eight         	noun                 	oḱtṓw                           		
nine                	nine          	noun                 	h₁néwn̥                           		
ten                 	ten           	noun                 	déḱm̥                           		
hundred             	hundred       	noun                 	ḱm̥tóm                           		
thousand            	thousand      	noun                 	tuHsont                           		
big                 	big           	adjective            	méǵh₂s                           		
long                	long          	adjective            	dl̥h₁gʰós                        		
wide                	wide          	adjective            	stelh₃ós                         		
thick               	thick         	adjective            	bʰenǵʰ, tégus                    		
heavy               	heavy         	adjective            	gʷréh₂us                         		
small               	small         	adjective            	mey-                             		
short               	short         	adjective            	mréǵʰus, (s)ker-                 		
narrow              	narrow        	adjective            	h₂enǵʰ-                          		
thin                	thin          	adjective            	ténh₂us                          		
woman               	woman         	noun                 	gʷḗn, h₁esor-                    		
man                 	man           	noun                 	h₂nḗr, wiHrós                    		
human               	human         	noun                 	dʰéǵʰōm                       		
child               	child         	noun                 	                                 		
wife                	wife          	noun                 	pótnih₂                          		
husband             	husband       	noun                 	wiHrós, pótis                    		
mother              	mother        	noun                 	méh₂tēr                          		
father              	father        	noun                 	ph₂tḗr                     		
animal              	animal        	noun                 	dʰewsóm, ǵʰwer-                  		
worm                	worm          	noun                 	wr̥mis                           		
louse               	louse         	noun                 	ḱ(o)nid-, lewH-                  		
fish                	fish          	noun                 	dʰǵʰu-, peysḱ-                   		
snake               	snake         	noun                 	h₂éngʷʰis, (s)neh₁tr-            		
bird                	bird          	noun                 	h₂éwis                           		
grass               	grass         	noun                 	koyno-                           		
tree                	tree          	noun                 	dóru (genitive dréws)            		
forest              	forest        	noun                 	                                 		
marsh               	marsh         	noun                 	sélos		
stick               	stick         	noun                 	ǵʰasto-                          		
fruit, crop, harvest	fruit         	noun                  	(s)h₁es-		
seed                	seed          	noun                 	séh₁mn̥                          		
leaf                	leaf          	noun                 	lewbʰ-, bʰolh₃yom                		
root                	root          	noun                 	wréh₂ds                          		
bark                	bark          	noun                 	bʰérHǵos                         		
flower              	flower        	noun                 	bʰleh₃-                          		
rope                	rope          	noun                 	roypnós                          		
skin                	skin          	noun                 	pel-, twékos                     		
meat                	meat          	noun                 	mḗms, krewh₂-                    		
blood               	blood         	noun                 	krewh₂-, h₁ésh₂r̥                		
bone                	bone          	noun                 	h₂óst, kost-                     		
fat                 	fat           	noun                 	smérus                           		
egg                 	egg           	noun                 	h₂ōwyóm                          		
horn                	horn          	noun                 	ḱr̥nom, ḱerh₂(s), ḱerh₂sr̥, koru 		
tail                	tail          	noun                 	                                 		
feather             	feather       	noun                 	péth₂r̥                          		
hair                	hair          	noun                 	pulh₂-                           		
beard               	beard         	noun                 	bʰardʰéh₂		
head                	head          	noun                 	káput-, gʰebʰelo-                		
ear                 	ear           	noun                 	h₂ṓws                            		
eye                 	eye           	noun                 	h₃ókʷs                           		
nose                	nose          	noun                 	Hnéh₂s                           		
mouth               	mouth         	noun                 	h₃éh₁os                          		
tooth               	tooth         	noun                 	h₃dónts, ǵómbʰos		
tongue              	tongue        	noun                 	dn̥ǵʰwéh₂s                       		
lip                 	lip           	noun                  	leb-		
cheek, jaw, chin    	chin          	noun                 	ǵénus		
forehead            	forehead      	noun                 	h₂énts		
eyebrow             	eyebrow       	noun                 	h₃bʰrúhs		
fingernail          	fingernail    	noun                 	h₃negʰ-                          		
foot                	foot          	noun                 	pṓds                             		
leg                 	leg           	noun                 	kroksko                          		
knee                	knee          	noun                 	ǵónu                             		
hand                	hand          	noun                 	ǵʰésr̥, mar-                     		
belly               	belly         	noun                 	úderos                           		
guts                	guts          	noun                 	eh₁ter-                          		
neck                	neck          	noun                 	mon-, gʷrihwéh₂		
back                	back          	noun                 	                                 		
shoulder            	shoulder      	noun                 	h₂ṓms		
chest, rib          	chest         	noun                	pérḱus		
navel               	navel         	noun                 	h₃nebʰ-		
heart               	heart         	noun                 	ḱḗr (genitive ḱr̥dés)            		
brain, marrow       	brain         	noun                 	mosgʰós		
liver               	liver         	noun                 	Hyékʷr̥                          		
kidney              	kidney        	noun                 	negʷʰrós		
lung                	lung          	noun                 	pléwmō		
womb                	womb          	noun                	gʷelbʰ-		
wing                	wing          	noun                 	péth₂r̥                          		
eat                 	eat           	verb                 	h₁ed-                            		
drink               	drink         	verb                 	píph₃eti, h₁egʷʰ-                		
breathe             	breathe       	verb                 	pnew-                            		
sleep               	sleep         	verb                 	swep-, drem-                     		
sweat               	sweat         	verb                	sweyd-		
bite                	bite          	verb                 	denḱ-, h₁ed-                     		
suck                	suck          	verb                 	dʰeh₁(y)-                        		
spit                	spit          	verb                 	sp(y)ew-                         		
vomit               	vomit         	verb                 	wemh₁-, h₁reug-                  		
blow                	blow          	verb                 	h₂weh₁-                          		
laugh               	laugh         	verb                 	(s)mey-                          		
see                 	see           	verb                 	derḱ-, weyd-                     		
hear                	hear          	verb                 	ḱlew-                            		
smell               	smell         	verb                 	h₃ed-                            		
taste               	taste         	verb                 	ǵéwstus, ǵews-, sep-		
know                	know          	verb                 	ǵneh₃-, ǵnéh₃-sḱ-, weyd-         		
think               	think         	verb                 	memóne, teng-                    		
fear                	fear          	verb                 	pr̥k-		
live                	live          	verb                 	gʷeyh₃-                          		
die                 	die           	verb                 	mer-, dʰew-                      		
alive, living       	living        	adjective             	gʷih₃wós, gʷíh₃weti		
dead, mortal        	dead          	adjective             	mr̥tós		
kill                	kill          	verb                 	gʷʰen-                           		
fight               	fight         	verb                 	keh₃-                        		
hunt                	hunt          	verb                 	weyh₁-, sekʷh₃-                  		
hit                 	hit           	verb                 	pleh₂k-                          		
cut                 	cut           	verb                 	kr̥t-                            		
split               	split         	verb                 	skéydt, skinédti                 		
stab                	stab          	verb                 	dʰeygʷ-, bʰod-                   		
scratch             	scratch       	verb                 	gerbʰ-                           		
dig                 	dig           	verb                 	dʰeygʷ-                          		
swim                	swim          	verb                 	(s)neh₂-                         		
fly                 	fly           	verb                 	peth₂-, gʷel-                    		
walk                	walk          	verb                 	gʰredʰ-                          		
climb               	climb         	verb                  	steygʰ-		
jump                	jump          	verb                  	prew-		
go                  	go            	verb                  	h₁ey-, gʷem-, ǵʰeh₁-		
do, make, build     	build         	verb                  	kʷer-		
work, make          	work          	verb                  	wérǵom, h₃ep-		
come                	come          	verb                 	gʷémt, gʷm̥sḱéti, gʷeh₂-         		
lay                 	lay           	verb                 	légʰyeti, ḱéytor                 		
sit                 	sit           	verb                 	sédt, sísdeti                    		
stand               	stand         	verb                 	stéh₂t, stestóh₂e, stísteh₂ti    		
turn                	turn          	verb                 	wértti                           		
fall                	fall          	verb                 	ḱh₂d-                            		
give                	give          	verb                 	déh₃t, dédeh₃ti                  		
hold                	hold          	verb                 	segʰ-                            		
squeeze             	squeeze       	verb                 	                                 		
rub                 	rub           	verb                 	melh₂-                           		
wash                	wash          	verb                 	lewh₃-, neygʷ-                   		
wipe                	wipe          	verb                 	                                 		
pull                	pull          	verb                 	tragʰ-                           		
push                	push          	verb                 	trenkʷ-, (s)tew-		
throw               	throw         	verb                 	swep-                            		
tie                 	tie           	verb                 	yewg-		
sew                 	sew           	verb                 	syuh₁-                           		
count               	count         	verb                 	dol-, del-                       		
say                 	say           	verb                 	sekʷ-, wéwket                    		
sing                	sing          	verb                 	kan-, sengʷʰ-                             		
play                	play          	verb                 			
float               	float         	verb                 	plew-                            		
flow                	flow          	verb                 	plew-                            		
freeze              	freeze        	verb                 	gel-                             		
swell               	swell         	verb                 	tewh₂-                           		
sun                 	sun           	noun                 	sóh₂wl̥                          		
moon                	moon          	noun                 	mḗh₁n̥s, lówksneh₂               		
star                	star          	noun                 	h₂stḗr                           		
water               	water         	noun                 	h₂ekʷeh₂, h₂ep-, wódr̥           		
rain                	rain          	noun                 	h₂ekmon                          		
river               	river         	noun                 	h₂ékʷeh₂                         		
lake                	lake          	noun                 	léymō                            		
river               	river         	noun                 	h₂ep-                           		
sea                 	sea           	noun                 	móri                             		
salt                	salt          	noun                 	séh₂ls                           		
stone               	stone         	noun                 	h₂éḱmō                           		
sand                	sand          	noun                 	sámh₂dʰos                        		
dust                	dust          	noun                 	pers-                            		
earth               	earth         	noun                 	dʰéǵʰōm                          		
cloud               	cloud         	noun                 	nébʰos                           		
fog                 	fog           	noun                 	snewdʰ-                          		
sky                 	sky           	noun                 	dyḗws                            		
wind                	wind          	noun                 	ḱewero-, h₂wéh₁n̥ts              		
snow                	snow          	noun                 	snóygʷʰos                        		
ice                 	ice           	noun                 	yeǵ-                             		
smoke               	smoke         	noun                 	dʰuh₂mós                         		
fire                	fire          	noun                 	h₁eh₂ter-, h₁n̥gʷnis, péh₂wr̥    		
ash                 	ash           	noun                 	h₃és-no-, h₃és-i-                		
burn                	burn          	verb                 	dʰegʷʰ-, swel-, h₁ews-           		
road                	road          	noun                 	pónth₁s                          		
mountain            	mountain      	noun                 	men-, bʰerǵʰ-                    		
red                 	red           	adjective            	h₁rewdʰós                        		
green               	green         	adjective            	ǵʰelh₃-, gʰreh₁-                 		
yellow              	yellow        	adjective            	ǵʰelh₃-                          		
brown               	brown         	adjective            	bʰerh-		
black               	black         	adjective            	swordós, h₂ems-, kr̥snós         		
white               	white         	adjective            	h₂elbʰós                         		
grey                	grey          	adjective            	pelh-		
light               	light         	noun                	h₁lengʷʰ-		
darkness            	darkness      	noun                 	h₁régʷos, (s)ḱeh₃-, témhos		
night               	night         	noun                 	nókʷts                           		
day                 	day           	noun                 	h₂eǵh-, dei-n-                   		
morning             	morning       	noun                 	h₂éwsōs		
evening             	evening       	noun                 	wek(ʷ)speros		
yesterday           	yesterday     	noun                 	dʰǵʰyésteros, dʰǵʰyes-		
month               	month         	noun                 	mḗh₁n̥s		
year                	year          	noun                 	yeh₁-, wétos                     		
spring              	spring        	noun                 	wósr̥		
summer              	summer        	noun                  	semh₂-		
fall                	fall          	noun                  	(s)h₁es-		
winter              	winter        	noun                 	ǵʰéyōm		
warm                	warm          	adjective            	tep-, gʷʰer-                     		
cold                	cold          	adjective            	gel-                             		
full                	full          	adjective            	pl̥h₁nós                         		
new                 	new           	adjective            	néwos                            		
old                 	old           	adjective            	sénos                            		
good                	good          	adjective            	bʰed-, h₁su-, h₁wésus            		
bad                 	bad           	adjective            	h₂wap-, dus-                     		
rotten              	rotten        	adjective            	pu-                              		
dirty               	dirty         	adjective            	swerd-                           		
straight            	straight      	adjective            	h₃reǵtós                         		
round               	round         	adjective            	                                 		
sharp               	sharp         	adjective            	h₁edʰ-, h₂ḱrós                   		
dull                	dull          	adjective            	dʰwel-                           		
smooth              	smooth        	adjective            	gʰleh₂dʰ-		
wet                 	wet           	adjective            	wed-                             		
dry                 	dry           	adjective            	ters-                            		
correct             	correct       	adjective            	weh₁-                            		
near                	near          	adjective            	h₁opi, h₁epi, h₂énti             		
far                 	far           	adjective            	wi                               		
right               	right         	adjective            	deḱs-                            		
left                	left          	adjective            	leh₂ywós                         		
at                  	at            	preposition          	h₁epi, opi, h₂éd, h₃ebʰi, h₃bʰi  		
in                  	in            	preposition          	h₁en, h₁(e)ntér                  		
with                	with          	preposition          	ḱóm, pe, me                      		
and                 	and           	conjunction          	-kʷe, de, nu, h₁é                		
name                	name          	noun                 	h₁nómn̥                          		
cover               	cover         	verb                 	(es)t		
sweet               	sweet         	adjective            	swéh₂dus, délkus		
sour, salty         	sour          	adjective            	súhros		
bitter              	bitter        	adjective            	h₂eh₃mós		
grain               	grain         	noun                	ǵr̥h₂nóm, dʰohnéh₂		
apple               	apple         	noun                	h₂ébōl		
acorn               	acorn         	noun                 	gʷelh₂-		
juice               	juice         	noun                	sokʷós		
beer                	beer          	noun                	h₂elut-		
wine                	wine          	noun                	wéyh₁ō		
milk                	milk          	noun                	h₂melǵ-		
honey               	honey         	noun                	mélit, kn̥h₂ónks		
brother             	brother       	noun                	bʰréh₂tēr		
sister              	sister        	noun                 	swésōr		
son                 	son           	noun                  	suhnús		
daughter            	daughter      	noun                  	dʰugh₂tḗr		
uncle, grandfather  	grandfather   	noun                  	h₂éwh₂os		
niece, granddaughter	granddaughter 	noun                  	néptih₂		
nephew, grandson    	grandson      	noun                  	népōts		
silver              	silver        	noun                 	h₂r̥ǵn̥tóm		
gold                	gold          	noun                 	h₂eus		
bronze              	bronze        	noun                	h₂éyos		
charcoal            	charcoal      	noun                	h₁óngʷl̥		
turn                	turn          	verb                	kʷel-		
wheel               	wheel         	noun                 	kʷékʷlos		
axle                	axle          	noun                	h₂eḱs-		
vehicle             	vehicle       	noun                 	ḱr̥sós		
house               	house         	noun                 	dṓm		
dwelling            	dwelling      	noun                 	h₂wóstu		
door                	door          	noun                 	dʰwṓr		
breast              	breast        	noun                 	peg-, pstḗn		
buttocks, hip       	buttocks      	noun                 	ḱlównis		
vulva               	vulva         	noun                 	písdeh₂		
penis               	penis         	noun                	pes-		
testicle            	testicle      	noun                	h₄órǵʰis		
defecate            	defecate      	verb                 	kakka-		
urinate             	urinate       	verb                 	h₃méyǵʰeti		
copulate            	copulate      	verb                 	h₃yebʰ-		
fart                	fart          	verb                	perd-		
excrement           	excrement     	noun                 	múhtrom		
leech               	leech         	noun                	leech		
flea                	flea          	noun                 	plúsis		
bee                 	bee           	noun                 	bʰey-		
ant                 	ant           	noun                 	morwi-		
wasp                	wasp          	noun                 	wóps		
whale, shark        	shark         	noun                 	(s)kʷálos		
dragon, serpent     	dragon        	noun                 	h₁ógʷʰis		
eagle               	eagle         	noun                  	h₃érō		
crane               	crane         	noun                  	gerh₂ḗn		
sparrow             	sparrow       	noun                  	spḗr		
goose               	goose         	noun                 	ǵʰh₂éns		
duck                	duck          	noun                 	h₂énh₂ts		
woodpecker, magpie  	bird          	noun                  	(s)peyk-		
cow                 	cow           	noun                 	h₂eǵʰ-		
horse               	horse         	noun                	ǵʰéyos		
hog, pig, swine     	pig           	noun                 	suh-		
sheep               	sheep         	noun                 	h₂ówis		
goat                	goat          	noun                 	h₂eyǵ-		
cattle              	cattle        	noun                  	gʷṓws		
livestock           	livestock     	noun                 	péḱu		
flock, herd            	herd          	noun                 	h₂ger-		
dog                 	dog           	noun                 	ḱwṓ                              		
wolf                	wolf          	noun                 	wĺ̥kʷos                              		
bear                	bear          	noun                	h₂ŕ̥tḱos		
deer, elephant      	deer          	noun                	h₁el		
beaver              	beaver        	noun                	bʰébʰrus		
hedgehog            	hedgehog      	noun                	ǵʰḗr		
mouse               	mouse         	noun                 	múh₂s		
stallion            	stallion      	noun                 	h₁éḱwos		
mare                	mare          	noun                 	h₁éḱweh₂		
bull                	bull          	noun                	uksḗn, táwros		
she-cow             	cow           	noun                	woḱéh₂		
heifer              	heifer        	noun                	steríh₂s		
piglet              	piglet        	noun                 	pórḱos		
lamb                	lamb          	noun                	h₂egʷnós		
ram                 	ram           	noun                	wr̥h₁ḗn, moysós		
he-goat             	goat          	noun                 	kápros		
buck                	buck          	noun                 	bʰuǵ-		
nest                	nest          	noun                 	nisdós		
yoke                	yoke          	noun                 	yugóm		
hoof                	hoof          	noun                	ḱoph₂ós		
wool                	wool          	noun                	h₂wĺ̥h₁neh₂		
oak                 	oak           	noun                	pérkus		
ash tree            	tree         	noun                	heh₃s-		
alder               	alder         	noun                	wern-		
birch               	birch         	noun                	bʰerhǵós		
beech               	beech         	noun                	bʰeh₂ǵos		
elm                 	elm           	noun                	h₁élem		
fern                	fern          	noun                 	p(t)erh-		
moss                	moss          	noun                 	mews-		
cereal, barley      	barley        	noun                	yéwos, h₂élbʰit		
rye                 	rye           	noun                 	hrugʰís		
wheat               	wheat         	noun                 	puhrós		
awl                 	awl           	noun                 	h₁ólos		
adze                	adze          	noun                 	h₃edʰḗs		
