# vowels	ipa	
la            	/la/	'a' sounds like 'a' in 'car'                                       
là            	/la/	'à' sounds like 'a' in 'car'                                       
âne           	/an/	'â' sounds like 'a' in 'car', but longer                           
mer           	/mɛʁ/	'e' between consonants sounds like 'ai' in 'fair'                  
le            	/lə/	'e' at the end of a syllable sounds like e in 'her'                
tasse         	/tɑs/	final 'e' is silent                                                
été           	/e.te/	'é' sounds like 'ay'                                               
père          	/pɛə(ɹ)/	'è' sounds like 'ai' in 'fair'                                     
tête          	/tɛt/	'ê' sounds like 'ai' in 'fair'                                     
ski           	/ski/	'i' sounds like 'i' in 'martini'                                   
poste         	/pɔst/	'o' sounds like 'o' in 'not'                                       
tôt           	/to/	'ô' sounds like 'o' in 'note'
cône          	/kon/	'ô' sounds like 'o' in 'note'
vu            	/vy/	'u' sounds like 'i' in 'martini', but lips rounded like 'u' in rune
roi           	/ʁwa/	'oi' sounds like 'wah'                                             
roue          	/ʁu/	'ou' sounds like 'oo' in 'book'                                    
laine         	/lɛn/	'ai' sounds like 'e' in 'let'                                      
au            	/o/	'au' sounds like 'o' in 'note'                                     
beau          	/bo/	'eau' sounds like 'o' in 'note'                                    
neuf          	/nœ/	'eu' sounds like 'eu' in 'her'                                     
soeur         	/sœʁ/	'oeu' sounds like 'er' in 'her'                                   
              		
		# exceptional consonants
ceci          	/sə.si/	'c' before e or i sounds like s                                    
car           	/kaʁ/	'c' before a, o, or u it sounds like k                             
ça            	/ˈsa/	'ç' sounds like s                                                  
château       	/ʃɑ.to/	'ch' sounds like 'sh'                                              
général       	/ʒe.ne.ʁal/	'g' before e or i sounds like s in 'measure'                       
gare          	/ɡaʁ/	'c' before a, o, or u it sounds like g in 'go'                     
hôtel         	/o.tɛl/	'h' is silent                                                      
je            	/ʒə/	'j' sounds like s in ‘measure'                                     
qui           	/ki/	'q' sound like k                                                   
rire          	/ʁiʁ/	'r' sounds like r in 'gourmand'                                    
salle         	/sal/	's' at the beginning of a word sounds like s                       
rose          	/ʁoz/	's' between vowels sounds like z                                   
              		
# nasals		
nom           	/nɔ̃/	'om' sounds like 'ong' in 'song'                                   
non           	/nɔ̃/	'on' sounds like 'ong' in 'song'                                   
un            	/œ̃/	'un' sounds like 'ung' in 'sung'                                   
brun          	/bʁœ̃/	'un' sounds like 'ung' in 'sung'                                   
champ         	/ʃɑ̃/	'am','an','em','en' sound like 'ahng'                              
an            	/ɑ̃/	'am','an','em','en' sound like 'ahng'                              
temps         	/tɑ̃/	'am','an','em','en' sound like 'ahng'                              
en            	/ɑ̃/	'am','an','em','en' sound like 'ahng'                              
simple        	/sɛ̃pl/	'im','in','aim','ain','ein' sound like ang in 'sang'               
vin           	/vɛ̃/	'im','in','aim','ain','ein' sound like ang in 'sang'               
faim          	/fɛ̃/	'im','in','aim','ain','ein' sound like ang in 'sang'               
bain          	/bɛ̃/	'im','in','aim','ain','ein' sound like ang in 'sang'               
plein         	/plɛ̃/	'im','in','aim','ain','ein' sound like ang in 'sang'               
bien          	/bjɛ̃/	'ien' sounds like 'ee-ang’     
		
# french variations		
parler        	/paʁ.le/	'er' at the end of a word of two or more syllables sounds like 'ay'
nez           	/ne/	'ez' at the end of a word sounds like 'ay'                         
travail       	/tʁa.vaj/	'ail' at the end of a word sounds like ‘ah'ee'                     
soleil        	/sɔ.lɛj/	'eil','eille' sounds like 'a'ee'                                   
bouteille     	/bu.tɛj/	'eil','eille' sounds like 'a'ee'                                   
billet        	/bi.jɛ/	final t is silent, 'ill' usually sounds like 'ee'y' 
signal        	/si.ɲal/	'gn' sounds like ni in 'onion'                                     
              		
# blended words		
deux ans      	/dø zɑ̃/	final 's','x' sounds like z                                        
un grand arbre	/œ̃ gran taʁbʁ/	final 'd' sounds like t                                            
neuf heures   	/nœ vœʁ/	final 'v' sounds like v                                            
              		
              		
		# complete enumeration of all phonemes in all positions, from Wikipedia
# consonants		
bon           	/bɔ̃/	
deux          	/dø/	
grande        	/ɡʁɑ̃d/	
faire         	/fɛʁ/	
vif           	/vif/	
garçon        	/ɡaʁ.sɔ̃/	
longue        	/lɔ̃ɡ/	
corps         	/kɔʁ/	
avec          	/a.vɛk/	
laisser       	/lɛ.se/	
possible      	/pɔ.sibl/	
seul          	/sœl/	
même          	/mɛm/	
nous          	/nu/	
bonne         	/bɔn/	
gagner        	/ɡa.ɲe/	
champagne     	/ʃɑ̃.paɲ/	
camping       	/kɑ̃.piŋ/	
funk          	/fynk/	
père          	/pɛʁ/	
groupe        	/ɡʁup/	
regarder      	/ʁə.ɡaʁ.de/	
nôtre         	/notʁ/	
sans          	/sɑ̃/	
ça            	/ˈsa/	'ç' sounds like s                                                  
assez         	/a.se/	
chance        	/ʃɑ̃s/	
tout          	/tu/	
thé           	/te/	
grand-oncle   	/ɡʁɑ̃.t‿ɔ̃kl/	
vous          	[ˈvou̯s]	
wagon         	/wa.ɡɔ̃/	
neuf heures   	/nœ vœʁ/	
zéro          	/ze.ʁo/	
raison        	/ʁɛ.zɔ̃/	
chose         	/ʃoz/	
jamais        	/ʒa.mɛ/	
visage        	/ˈvɪzɪdʒ/	
		
# semivowels		
fief          	/fiːf/	
payer         	/ˈpeɪ.ɚ/	
fille         	/fij/	
travail       	/tʁa.vaj/	
hier          	/jɛʁ/	
oui           	/wi/	
loi           	/lwa/	
moyen         	/mwa.jɛ̃/	
web           	/web/	
whisky        	/wis.ki/	
huit          	/ɥit/	
Puy           	/pɥi/	
              		
# vowels		
patte         	/pat/	
là            	/la/	
femme         	/fam/	
pâte          	/pɑt/	
glas	/ɡlɑ/	
clé           	/kle/	
les           	/le/	
chez          	/ʃeɪ/	
aller         	/a.le/	
pied          	/pje/	
journée       	/ʒuʁ.ne/	
et            	/e/	
baie          	/bɛ/	
faite         	/fɛt/	
mettre        	/mɛtʁ/	
renne         	/ʁɛn/	
crème         	/kʁɛm/	
peine         	/pɛn/	
violet        	/vjɔ.lɛ/	
fête          	/fɛt/	
maître        	/mɛtʁ/	
mètre         	/mɛtʁ/	
reine         	/ʁɛn/	
reître        	/ʁɛtʁ/	
caisse        	/kɛs/	
presse        	/pʁɛs/	
Lévesque	/le.vɛk/	
reposer       	/ʁə.po.ze/	
monsieur      	/mə.sjø/	
faisons       	/fə.zɔ̃/	
si            	/si/	
île           	/il/	
régie         	/ʁe.ʒi/	
pays          	/pɛ.i/	
fils          	/fis/	
sœur          	/sœʁ/	
jeune         	/ʒœn/	
club	/klœb/	
ceux          	/sø/	
jeûner        	/ʒø.ne/	
queue         	/kø/	
saut          	/so/	
haut          	/o/	
bureau        	/by.ʁo/	
chose         	/ʃoz/	
tôt           	/to/	'ô' sounds like 'o' in 'note'
cône          	/kon/	'ô' sounds like 'o' in 'note'
sort          	/sɔʁ/	
minimum       	/mi.ni.mɔm/	
pomme         	/pɔm/	
coup          	/ku/	demonstrates final u
roue          	/ʁu/	demonstrates final u
tu            	/ty/	demonstrates final y
sûr           	/syʁ/	demonstrates middle y
rue           	/ʁy/	demonstrates final y
             		
# nasal vowels 		
sans          	/sɑ̃/	
champ         	/ʃɑ̃/	
vent          	/vɑ̃/	
temps         	/tɑ̃/	
Jean          	/ʒɑ̃/	
taon          	/tɑ̃/	
vin           	/vɛ̃/	
impair		
pain          	/pɛ̃/	
daim          	/dɛ̃/	
plein         	/plɛ̃/	
Reims         		
synthèse      	/sɛ̃.tɛz/	
sympathique   	/sɛ̃.pa.tik/	
bien          	/bjɛ̃/	
un            	/œ̃/	
parfum        	/paʁ.fœ̃/	
son           	/sɔ̃/	
nom           	/nɔ̃/	