gratis	verb
pie	adverb
kun	preposition
nu	interjection
bone	adverb
de	preposition
en	preposition
o	noun
parole	adverb
i	noun
hundo	noun
luu	verb
sabato	noun
tago	noun
peso	noun
relegate	adverb
urban	adjective
religion	noun
radio	noun
ci	pronoun
time	adverb
colon	noun
angla	adjective
mi	pronoun
ami	verb
vi	pronoun
fero	noun
absolute	adverb
nomo	noun
ĝenerala	adjective
ĥoro	noun
ŝati	verb
banko	noun
hebrea	adjective
tomato	noun
blue	adverb
magenta	adjective
tempo	noun
nature	adverb
person	noun
el	preposition
for	adverb
zebra	adjective
abandono	noun
to	noun
mikado	noun
angle	adverb
male	adverb
vertebra	adjective
salmon	noun
lemon	noun
al	preposition
alo	noun
barato	noun
familia	adjective
balan	adjective
se	noun
mb	phrase
nu	noun
so	noun
ne	noun
gracia	adjective
cicisbeo	noun
plata	adjective
he	interjection
pico	noun
kara	adjective
magia	adjective
moro	noun
servus	verb
pato	noun
do	noun
do	adverb
baru	verb
ia	determiner
dia	adjective
ke	conjunction
sana	adjective
dua	adjective
satu	verb
reloj	noun
rato	noun
sama	adjective
dimension	noun
dodo	noun
go	noun
simile	adverb
sin	pronoun
simple	adverb
stimulate	adverb
era	adjective
limo	noun
iron	noun
vero	noun
abato	noun
abako	noun
piano	noun
penis	verb
vole	adverb
mole	adverb
nin	pronoun
du	numeral
far	preposition
live	adverb
sal	interjection
e	noun
baron	noun
rin	pronoun
bo	noun
k	conjunction
u	noun
ano	noun
home	adverb
anime	adverb
opinion	noun
moron	noun
mason	noun
lui	verb
kies	pronoun
ekster	preposition
file	adverb
help	interjection
kata	adjective
ah	interjection
aha	interjection
ha	interjection
sango	noun
ni	pronoun
due	adverb
tre	adverb
nove	adverb
kimono	noun
duo	noun
acido	noun
floro	noun
libro	noun
mielo	noun
eta	adjective
hm	interjection
boron	noun
radon	noun
ol	conjunction
li	pronoun
ne	particle
au	conjunction
emu	verb
na	preposition
si	pronoun
co	noun
se	conjunction
ho	noun
ho	interjection
po	preposition
po	noun
sole	adverb
pa	interjection
tri	numeral
tien	adverb
informacio	noun
pure	adverb
strange	adverb
mega	adjective
kaj	conjunction
multi	verb
mep	noun
apron	noun
flue	adverb
negro	noun
slave	adverb
union	noun
zoo	noun
feta	adjective
destino	noun
chi	particle
bari	verb
pole	adverb
tie	adverb
insula	adjective
radius	verb
forte	adverb
judo	noun
kava	adjective
ruse	adverb
ach	interjection
ido	noun
flamingo	noun
fare	adverb
dio	noun
video	noun
melon	noun
da	preposition
fo	noun
mane	adverb
je	preposition
simian	adjective
pare	adverb
poo	noun
pirate	adverb
sumo	noun
harmonia	adjective
mango	noun
stimulus	verb
juni	verb
ursa	adjective
opero	noun
homo	noun
volo	noun
vendo	noun
via	determiner
vetera	adjective
vetero	noun
lanterna	adjective
lento	noun
mano	noun
pugno	noun
danke	adverb
danke	interjection
neu	verb
nur	adverb
felon	noun
vane	adverb
agi	verb
per	preposition
semi	verb
ja	adverb
same	adverb
alternative	adverb
puso	noun
fuga	adjective
simia	adjective
mode	adverb
rana	adjective
tigon	noun
hola	interjection
trio	noun
jam	adverb
abrupta	adjective
luna	adjective
lago	noun
lupo	noun
fik	interjection
neus	verb
historia	adjective
natura	adjective
barbe	adverb
admire	adverb
ada	adjective
nei	verb
sono	noun
ordinare	adverb
ritmo	noun
haste	adverb
agate	adverb
agitate	adverb
ago	noun
nun	adverb
lobo	noun
ĵaŭdo	noun
fio	noun
fieri	verb
gnomon	noun
private	adverb
amen	interjection
adan	adjective
batis	verb
anglo	noun
anon	noun
anticipate	verb
koti	verb
juna	adjective
urso	noun
sata	adjective
tension	noun
virta	adjective
sano	noun
sano	noun
numero	noun
deci	verb
urinate	adverb
tera	adjective
median	adjective
vento	noun
vera	adjective
vino	noun
caro	noun
punto	noun
oni	pronoun
ani	verb
pelata	adjective
lumi	verb
centre	adverb
finite	adverb
bistro	noun
deka	adjective
nano	noun
fame	adverb
odo	noun
bolus	verb
malina	adjective
profeta	adjective
tornado	noun
torni	verb
ilo	noun
veli	verb
pace	adverb
pasto	noun
kuba	adjective
kuba	adjective
pro	preposition
che	preposition
domo	noun
legato	noun
legato	noun
legato	noun
portato	noun
ek	interjection
psikologia	adjective
lo	noun
koran	adjective
ablativo	noun
media	adjective
colo	noun
filtrate	adverb
patron	noun
amare	adverb
sub	preposition
brave	interjection
brave	adverb
radii	verb
super	preposition
alto	noun
relative	adverb
agro	noun
masturbate	adverb
anima	adjective
dominus	verb
albino	noun
listo	noun
dike	adverb
pirata	adjective
mono	noun
por	preposition
para	adjective
geometria	adjective
io	pronoun
vice	adverb
vampire	adverb
balai	verb
metro	noun
decas	verb
unco	noun
longa	adjective
eno	noun
poro	noun
fine	adverb
penetrate	verb
moku	verb
ko	noun
ero	noun
plu	adverb
mona	adjective
facile	adverb
idiota	adjective
historio	noun
trans	preposition
vagina	adjective
spite	adverb
mute	adverb
agitato	noun
azalea	adjective
ave	adverb
nome	adverb
tra	preposition
zo	noun
nia	determiner
tio	pronoun
tia	determiner
logika	adjective
skeleton	noun
bombus	verb
politika	adjective
enigma	adjective
merda	adjective
matematika	adjective
demonstrate	noun
serene	adverb
des	particle
eran	adjective
paca	adjective
grave	adverb
lace	adverb
tubo	noun
ujo	noun
karoo	noun
citron	noun
ok	numeral
ĉ	particle
ĉ	preposition
pere	adverb
absorboj	noun
adoptoj	noun
afishoj	noun
afrikan	adjective
oko	noun
misa	adjective
teo	noun
caron	noun
rojo	noun
pala	adjective
araba	adjective
nuo	noun
gea	adjective
ion	pronoun
dingo	noun
nana	adjective
polo	noun
rp	phrase
tendon	noun
opera	adjective
militate	adverb
kuna	adjective
distrito	noun
algo	noun
futon	noun
septembro	noun
jo	noun
femina	adjective
amo	noun
paro	noun
emo	noun
emas	verb
baton	noun
boa	adjective
borate	adverb
faro	noun
fermi	verb
flatus	verb
iris	verb
lulu	verb
meson	noun
mire	adverb
muon	noun
notate	adverb
operon	noun
pion	noun
romano	noun
romano	noun
rondo	noun
sago	noun
sen	preposition
servo	noun
trompe	adverb
inter	preposition
celebrate	adverb
char	conjunction
diverse	adverb
embargo	noun
finance	adverb
lame	adverb
ree	adverb
sane	adverb
stimuli	verb
aĉeto	noun
aĉeti	verb
cis	preposition
batu	verb
supra	adjective
cetera	adjective
peloton	noun
perihelion	noun
fermata	adjective
legion	noun
nova	adjective
mem	particle
mem	pronoun
shin	pronoun
mato	noun
gustus	verb
sia	pronoun
karaoke	adverb
diablo	noun
fungo	noun
onda	adjective
pension	noun
normale	adverb
finito	noun
ege	adverb
biro	noun
robota	adjective
cito	noun
sala	adjective
avion	noun
ametista	adjective
donate	adverb
fermion	noun
graviton	noun
firma	adjective
valo	noun
melodia	adjective
homa	adjective
suv	noun
humane	adverb
fore	adverb
alfabeto	noun
larme	adverb
muro	noun
variante	adverb
muu	interjection
fi	interjection
pasko	noun
mise	adjective
persona	adjective
grade	adverb
viola	adjective
plus	conjunction
post	preposition
aroma	adjective
pesto	noun
zefiro	noun
nuna	adjective
zoologo	noun
albedo	noun
metate	adverb
ora	adjective
dense	adverb
obligate	verb
salita	adjective
telefono	noun
administrate	adverb
mil	numeral
indiana	adjective
halo	noun
status	verb
version	noun
viro	noun
radiate	adverb
vin	pronoun
intimate	adverb
tolerate	adverb
uzi	verb
vegetate	adverb
logos	verb
dogma	adjective
mia	determiner
karma	adjective
abelo	noun
abio	noun
aboni	verb
acero	noun
acida	adjective
adiaŭ	interjection
administri	verb
admiri	verb
adori	verb
adulti	verb
aero	noun
aĝo	noun
akaro	noun
akcento	noun
akra	adjective
alia	adjective
monotone	adverb
almenaŭ	adverb
alta	adjective
alteo	noun
alterni	verb
aludi	verb
amaso	noun
ambaŭ	determiner
amelo	noun
anĝelo	noun
angulo	noun
animo	noun
ankaŭ	adverb
ankoraŭ	adverb
ansero	noun
anstataŭ	preposition
antaŭ	preposition
antaŭtuko	noun
aparta	adjective
apenaŭ	adverb
aplaŭdi	verb
apro	noun
aprilo	noun
apud	preposition
arbitra	adjective
arĉo	noun
areno	noun
arĝento	noun
argumenti	verb
arko	noun
armi	verb
aroganta	adjective
arto	noun
aso	noun
asparago	noun
atendi	verb
atenta	adjective
atesti	verb
aŭ	conjunction
aŭdi	verb
aŭgusto	noun
aŭtuno	noun
avo	noun
avara	adjective
aventuro	noun
avida	adjective
averti	verb
avizo	noun
azoto	noun
baki	verb
balanci	verb
baldaŭ	adverb
baleno	noun
bani	verb
bando	noun
banto	noun
barbo	noun
barĉo	noun
barko	noun
basto	noun
bastiono	noun
bati	verb
bedo	noun
beko	noun
bela	adjective
beni	verb
benko	noun
bero	noun
beto	noun
beto	noun
besto	noun
bindi	verb
birdo	noun
bismuto	noun
blanka	adjective
blato	noun
blinda	adjective
boji	verb
boli	verb
bona	adjective
bori	verb
bordo	noun
borso	noun
boto	noun
sur	preposition
bramo	noun
brano	noun
branĉo	noun
brando	noun
branko	noun
brava	adjective
breto	noun
brido	noun
brodi	verb
bronzo	noun
bruna	adjective
bruto	noun
bubo	noun
minus	conjunction
bubalo	noun
buĉi	verb
budo	noun
bufo	noun
buko	noun
bulo	noun
burdo	noun
burĝo	noun
buŝo	noun
decide	adverb
viva	adjective
ĉamo	noun
periodo	noun
ĉambro	noun
ĉampano	noun
ĉano	noun
ĉapo	noun
ĉapelo	noun
ĉar	conjunction
ĉarma	adjective
ĉarpenti	verb
ĉarpio	noun
ĉasi	verb
ĉasta	adjective
ĉe	preposition
cedi	verb
cedro	noun
ĉefo	noun
celi	verb
ĉelo	noun
cemento	noun
ĉeno	noun
ĉerizo	noun
certa	adjective
certigi	verb
cervo	noun
ĉesi	verb
regenerate	verb
imitate	adverb
sfera	adjective
mondo	noun
animus	verb
aux	conjunction
origine	adverb
severe	adverb
morte	adverb
matura	adjective
min	pronoun
avaro	noun
avaro	noun
spirito	noun
spirito	verb
flora	adjective
fondo	noun
energia	adjective
benis	verb
dek	numeral
nul	numeral
ĉielo	noun
novembro	noun
ŝi	pronoun
ri	pronoun
patro	noun
patriĉo	noun
perdu	verb
metodo	noun
lumo	noun
granda	adjective
lando	noun
fino	noun
olda	adjective
ronda	adjective
dorso	noun
parto	noun
multa	adjective
angula	adjective
esto	noun
fora	adjective
formo	noun
ludo	noun
sika	adjective
plano	noun
oro	noun
komuna	adjective
ordinara	adjective
luno	noun
profunda	adjective
pomo	noun
plena	adjective
roto	noun
ses	numeral
nulo	noun
klara	adjective
mento	noun
forta	adjective
minuto	noun
libera	adjective
varma	adjective
rapida	adjective
verda	adjective
stelo	noun
programo	noun
blogo	noun
noto	noun
aj	interjection
sabaton	noun
aktiva	adjective
merito	noun
absoluta	adjective
absurda	adjective
agus	verb
milito	noun
disko	noun
jene	adverb
sola	adjective
regno	noun
ro	noun
dum	preposition
frue	adverb
ovo	noun
elektro	noun
anemia	adjective
poste	adverb
tremolo	noun
arda	adjective
alio	noun
papo	noun
dika	adjective
popo	noun
gravitas	verb
malo	noun
sinjoro	noun
reĝo	noun
fraŭlo	noun
gratulate	adverb
verde	adverb
manifesto	noun
historian	adjective
veteran	adjective
animate	adverb
monako	noun
selon	noun
ĝi	pronoun
rete	adverb
zumo	noun
linda	adjective
silicio	noun
uranio	noun
urbano	noun
resto	noun
utile	adverb
primo	noun
pesante	adverb
petite	adverb
litio	noun
berilio	noun
boro	noun
aluminio	noun
titanio	noun
vanadio	noun
galio	noun
bromo	noun
rubidio	noun
itrio	noun
niobio	noun
rutenio	noun
rodio	noun
paladio	noun
indio	noun
iodo	noun
bario	noun
hafnio	noun
renio	noun
osmio	noun
iridio	noun
talio	noun
talio	noun
polonio	noun
astato	noun
cerio	noun
prometio	noun
samario	noun
gadolinio	noun
terbio	noun
holmio	noun
erbio	noun
tulio	noun
iterbio	noun
lutecio	noun
torio	noun
neptunio	noun
plutonio	noun
americio	noun
berkelio	noun
fermio	noun
mendelevio	noun
nobelio	noun
dubnio	noun
ordo	noun
naive	adverb
parte	adverb
geografia	adjective
evidente	adverb
eterno	noun
centra	adjective
gusto	noun
fumo	noun
fundas	verb
soldo	noun
dominate	adverb
cento	noun
centimetro	noun
centro	noun
ie	adverb
determinate	adverb
formate	adverb
satis	verb
teoria	adjective
industria	adjective
tragedia	adjective
pene	adverb
astron	noun
principe	adverb
stato	noun
atmosfera	adjective
fortuna	adjective
goo	noun
ama	adjective
sincere	adverb
kvar	numeral
perse	adverb
vive	adverb
foton	noun
rapido	noun
ilia	determiner
studi	verb
lavi	verb
ŝatas	verb
ŝatos	verb
ŝatu	verb
ŝatus	verb
bis	interjection
persan	adjective
pago	noun
meze	adverb
sento	noun
jugo	noun
julio	noun
junio	noun
fluoro	noun
fosforo	noun
justa	adjective
vida	adjective
amnion	noun
amate	adverb
fini	verb
finis	verb
senti	verb
kota	adjective
koko	noun
aloo	noun
fundus	verb
ties	determiner
nevera	adjective
cimbalo	noun
mdr	interjection
agita	adjective
ĉielarko	noun
cigno	noun
cimo	noun
ĉi	particle
ĉiam	adverb
ĉie	adverb
ĉiel	adverb
ĉio	pronoun
ciro	noun
citi	verb
citro	noun
ĉiu	pronoun
ĉiu	determiner
ĉizi	verb
ĉokolado	noun
ĉu	particle
loĝi	verb
damasko	noun
danci	verb
dando	noun
dato	noun
dativo	noun
daŭri	verb
decidi	verb
decembro	noun
deĉifri	verb
defendi	verb
degradi	verb
deliri	verb
densa	adjective
dento	noun
detala	adjective
detrui	verb
devi	verb
diamanto	noun
diamanto	noun
digo	noun
diligenta	adjective
saltus	verb
blazon	noun
olde	adverb
ravi	verb
litro	noun
a	noun
e	noun
k	conjunction
n	noun
s	noun
s	pronoun
sinjoro	noun
w	noun
poon	noun
radiata	adjective
france	adverb
buteo	noun
inundate	adverb
georgia	adjective
bolivia	adjective
eritrea	adjective
serbian	adjective
siria	adjective
mo	noun
korea	adjective
nd	phrase
serbia	adjective
terni	verb
devon	noun
kina	adjective
avon	noun
papago	noun
june	adverb
plato	noun
venus	verb
metis	verb
latina	adjective
kuri	verb
cian	adjective
breton	noun
paki	verb
sloveno	noun
oleo	noun
dido	noun
amerikan	adjective
amerika	adjective
volos	verb
fondu	verb
satan	adjective
geja	adjective
meg	numeral
ideo	noun
momento	noun
damno	noun
vivo	noun
pura	adjective
ghi	pronoun
medio	noun
nula	numeral
nula	adjective
alii	verb
klingon	noun
disputi	verb
distingi	verb
diversa	adjective
dividi	verb
dolĉa	adjective
ili	pronoun
amato	noun
amato	verb
amante	adverb
ame	adverb
amas	verb
aman	adjective
mbr	phrase
norman	adjective
su	noun
kia	determiner
ria	determiner
abortus	verb
ovan	adjective
hu	interjection
instigate	adverb
aktive	adverb
ien	adverb
ies	pronoun
oho	interjection
amputate	adverb
peli	verb
paraplegia	adjective
aro	noun
lato	noun
pian	adjective
ligate	adverb
peto	noun
pino	noun
bruno	noun
spermatozoon	noun
diaspora	adjective
malice	adverb
logi	verb
bolivian	adjective
selo	noun
pri	preposition
kontraŭ	preposition
krom	preposition
ĝis	preposition
ĝis	interjection
verso	noun
sed	conjunction
laŭ	preposition
preter	preposition
kio	pronoun
kiu	pronoun
kiu	determiner
kiel	adverb
kiel	conjunction
kiel	preposition
kie	conjunction
kie	adverb
kiam	conjunction
kiam	adverb
kial	adverb
kial	conjunction
tiu	pronoun
tiu	determiner
tiel	adverb
tiam	adverb
tial	conjunction
hieraŭ	adverb
morgaŭ	adverb
jes	adverb
meso	noun
hodiaŭ	adverb
iu	determiner
iu	pronoun
iel	adverb
iam	adverb
iom	determiner
ĉial	adverb
ĉies	determiner
ruĝa	adjective
flava	adjective
nigra	adjective
griza	adjective
kato	noun
nenia	determiner
unu	numeral
naŭ	numeral
bolos	verb
jen	particle
jen	interjection
jen	phrase
ĵus	adverb
kvazaŭ	conjunction
fila	adjective
menton	noun
germane	adverb
testudo	noun
goon	noun
tuj	adverb
tro	adverb
tamen	adverb
preskaŭ	adverb
pli	adverb
plej	adverb
eĉ	adverb
nek	conjunction
doni	verb
esti	verb
fari	verb
feliĉa	adjective
grava	adjective
ĝoji	verb
havi	verb
iri	verb
jaro	noun
kampo	noun
kapo	noun
kapo	noun
koni	verb
koro	noun
labori	verb
salmo	noun
moskito	noun
pako	noun
velo	noun
lasta	adjective
legi	verb
levi	verb
meti	verb
militi	verb
peti	verb
porti	verb
preni	verb
respondi	verb
resti	verb
riĉa	adjective
ridi	verb
sidi	verb
stari	verb
teni	verb
tero	noun
veni	verb
vidi	verb
vivi	verb
voli	verb
morti	verb
movi	verb
nacio	noun
fundi	verb
saman	adjective
vika	adjective
amata	adjective
kultura	adjective
bildo	noun
dormi	verb
edzo	noun
fali	verb
filo	noun
halti	verb
haro	noun
horo	noun
intereso	noun
ĵeti	verb
kanti	verb
kosti	verb
lasi	verb
lito	noun
manĝi	verb
manki	verb
maro	noun
memori	verb
cedo	noun
pika	adjective
manipulate	adverb
miri	verb
monto	noun
naski	verb
paco	noun
pagi	verb
pasi	verb
peco	noun
pensi	verb
perdi	verb
persono	noun
popolo	noun
postuli	verb
premi	verb
provi	verb
regi	verb
serĉi	verb
simpla	adjective
soni	verb
suno	noun
ŝanĝi	verb
timi	verb
tiri	verb
valoro	noun
vesto	noun
tipolo	noun
abata	adjective
celo	noun
daŭro	noun
doloro	noun
esperi	verb
fiŝo	noun
gaja	adjective
ĝardeno	noun
ĝusta	adjective
hela	adjective
interna	adjective
kaŝi	verb
oran	adjective
tima	adjective
posta	adjective
raviolo	noun
libanon	noun
formulate	adverb
savon	noun
sati	verb
kaŭzo	noun
kolo	noun
kuŝi	verb
laca	adjective
larĝa	adjective
ligo	noun
ligno	noun
ludi	verb
marko	noun
mezo	noun
neĝo	noun
nombro	noun
nubo	noun
pano	noun
paŝi	verb
peni	verb
plori	verb
hispano	noun
navigate	adverb
venu	verb
brito	noun
vo	noun
foto	noun
provo	noun
abstrakta	adjective
historie	adverb
arteria	adjective
kare	adverb
ete	adverb
taksi	verb
miru	verb
laboro	noun
oriente	adverb
proceso	noun
ministro	noun
atena	adjective
seminario	noun
amari	verb
igi	verb
parada	adjective
socio	noun
soldado	noun
eco	noun
estante	adverb
certe	adverb
vere	adverb
parlamento	noun
tenis	verb
duelo	noun
lacan	adjective
ve	interjection
vide	adverb
imperio	noun
tono	noun
iro	noun
alero	noun
anhelo	noun
templon	noun
argumento	noun
insulto	noun
alternativa	adjective
agon	noun
individuo	noun
labio	noun
progreso	noun
mita	adjective
bento	noun
aborto	noun
ministerio	noun
ceremonia	adjective
signo	noun
modo	noun
trono	noun
foro	noun
bono	noun
sistema	adjective
modelo	noun
turismo	noun
obligato	verb
mito	noun
instrumento	noun
barba	adjective
narciso	noun
kore	adverb
oceano	noun
imago	noun
umi	verb
feran	adjective
magneto	noun
ondo	noun
faru	verb
kuban	adjective
brite	adverb
korean	adjective
triangulate	adverb
endi	verb
gean	adjective
definitive	adverb
kemia	adjective
folio	noun
honte	adverb
fama	adjective
amis	verb
estas	verb
bebo	noun
dormo	noun
estos	verb
imperia	adjective
mtr	phrase
esperanto	noun
pinto	noun
favorite	adverb
turbo	noun
ova	adjective
palan	adjective
amon	noun
diable	adverb
diable	interjection
ema	adjective
sob	adverb
morale	adverb
kubo	noun
etan	adjective
lesbo	noun
iru	verb
chia	determiner
dana	adjective
shi	pronoun
zoon	noun
biblia	adjective
pesos	verb
etimologia	adjective
tako	noun
lanugo	noun
variola	adjective
legate	adverb
oka	adjective
fundu	verb
eki	verb
koto	noun
plastron	noun
favorita	adjective
tragedian	adjective
flagon	noun
salon	noun
energie	adverb
sonata	adjective
vintre	adverb
katon	noun
amu	verb
estrato	noun
censo	noun
dubu	verb
raton	noun
deke	adverb
luis	verb
ups	interjection
vado	noun
valida	adjective
kombu	verb
kolombo	noun
grasa	adjective
idioma	adjective
pavo	noun
regulo	noun
paso	noun
ringo	noun
radios	verb
garbo	noun
anason	noun
kripto	noun
jako	noun
tento	noun
loka	adjective
rasa	adjective
starigi	verb
p.s.	phrase
mala	adjective
festa	adjective
enorme	adverb
vampira	adjective
utero	noun
angora	adjective
norma	adjective
lin	pronoun
kuru	verb
sorbate	adverb
importante	adverb
pisti	verb
baston	noun
figo	noun
fera	adjective
sor	adverb
estrus	verb
talion	noun
aina	adjective
muta	adjective
busa	adjective
pia	adjective
kora	adjective
kanto	noun
savas	verb
vadas	verb
nomi	verb
estus	verb
estu	verb
magneton	noun
kelta	adjective
vana	adjective
kino	noun
nomu	verb
ena	adjective
tirano	noun
iras	verb
amaro	noun
liven	adverb
loti	verb
semis	verb
diru	verb
hura	interjection
havas	verb
pozo	noun
premio	noun
aĝas	verb
aĝi	verb
sonus	verb
gravis	verb
masto	noun
levis	verb
semita	adjective
malva	adjective
ĝoja	adjective
pulo	noun
puno	noun
puni	verb
rusa	adjective
monda	adjective
vaka	adjective
boj	interjection
ŝafo	noun
ŝalo	noun
ŝelo	noun
ŝerco	noun
ŝimo	noun
ŝinko	noun
ŝipo	noun
ĝemelo	noun
ĝojo	noun
ŝtalo	noun
ŝtato	noun
ŝtono	noun
ŝuo	noun
ŝvito	noun
osta	adjective
feo	noun
morto	noun
tere	adverb
pulmo	noun
naĝi	verb
orto	noun
fago	noun
nuda	adjective
ŝelko	noun
ŝtormo	noun
dati	verb
temas	verb
moka	adjective
stati	verb
gasto	noun
mendi	verb
palmo	noun
polpo	noun
organon	noun
mara	adjective
ponto	noun
barite	adverb
polica	adjective
salo	noun
skoto	noun
juste	adverb
puto	noun
moko	noun
dogo	noun
kardo	noun
kono	noun
karbo	noun
kulo	noun
kuro	noun
kuko	noun
kudri	verb
hati	verb
spina	adjective
ulo	noun
kalo	noun
tanu	verb
brodu	verb
rano	noun
oto	noun
serba	adjective
tani	verb
bato	noun
siko	noun
agos	verb
ardi	verb
volante	adverb
rango	noun
umo	noun
baro	noun
ina	adjective
pepo	noun
fia	adjective
jeton	noun
serbo	noun
vico	noun
peka	adjective
ota	adjective
sorbitan	adjective
tombo	noun
apio	noun
prudente	adverb
arde	adverb
tremas	verb
borato	noun
suna	adjective
nitrato	noun
bele	adverb
ks	phrase
firme	adverb
nesti	verb
lado	noun
urina	adjective
ramo	noun
avio	noun
fosfato	noun
pensas	verb
savu	verb
teko	noun
vasta	adjective
sapo	noun
amos	verb
plasmon	noun
panteismo	noun
virga	adjective
espero	noun
milde	adverb
amoro	noun
restoracio	noun
suko	noun
taso	noun
leki	verb
tagon	noun
foran	adjective
kuo	noun
helicon	noun
torturi	verb
torturo	noun
beno	noun
salu	verb
saka	adjective
studu	verb
teran	adjective
vanta	adjective
aperitivo	noun
abismo	noun
fina	adjective
kraĉi	verb
krado	noun
kruco	noun
rando	noun
samo	noun
fridu	verb
tartufo	noun
melo	noun
metu	verb
nevo	noun
vesti	verb
anomalia	adjective
balo	noun
bano	noun
batata	adjective
observatorio	noun
fendo	noun
gelo	noun
domini	verb
rono	noun
timo	noun
festo	noun
mero	noun
granita	adjective
monta	adjective
beton	noun
rado	noun
relo	noun
lau	preposition
luti	verb
antisepsis	verb
rufa	adjective
intima	adjective
uro	noun
pedalo	noun
nepotismo	noun
nimbo	noun
negativa	adjective
boko	noun
odon	noun
majo	noun
kolera	adjective
rabo	noun
originale	adverb
tria	adjective
ferma	adjective
imita	adjective
lia	determiner
tente	adverb
rombo	noun
admira	adjective
astro	noun
butano	noun
carino	noun
hele	adverb
decus	verb
golo	noun
genio	noun
kilometro	noun
bunta	adjective
lavas	verb
reveni	verb
impresario	noun
ŝanĝo	noun
konstanta	adjective
ebria	adjective
kiso	noun
stranga	adjective
gufo	noun
moderna	adjective
pendi	verb
oficiala	adjective
titolo	noun
cilindro	noun
demando	noun
ebla	adjective
ial	adverb
multe	adverb
saluto	noun
pesi	verb
momenta	adjective
deflorate	adverb
hedonismo	noun
orgasmo	noun
avokado	noun
patronus	verb
intrigo	noun
ofte	adverb
valsi	verb
borde	adverb
emos	verb
intimas	verb
salto	noun
saltas	verb
decido	noun
decida	adjective
decidas	verb
decidan	adjective
vivan	adjective
dependas	verb
leda	adjective
vivas	verb
absorbas	verb
abundo	noun
abundas	verb
abunda	adjective
abunde	adverb
adaptas	verb
administras	verb
administra	adjective
administre	adverb
admiro	noun
admiras	verb
adopto	noun
adoptas	verb
adopta	adjective
adoro	noun
adoras	verb
agiganto	noun
agiganta	adjective
agigante	adverb
agito	noun
agite	adverb
agoto	noun
agota	adjective
agote	adverb
teismo	noun
alarmo	noun
alarma	adjective
aleo	noun
alimento	noun
alineo	noun
alojo	noun
amara	adjective
amase	adverb
amputo	noun
amputas	verb
anhela	adjective
anhele	adverb
animas	verb
aparte	adverb
araban	adjective
argumentas	verb
armo	noun
armas	verb
barata	adjective
barata	adjective
asfalto	noun
asignas	verb
asimilas	verb
asocio	noun
atrofio	noun
basan	adjective
batas	verb
cedas	verb
celebras	verb
citas	verb
datas	verb
debato	noun
debatas	verb
debuta	adjective
decanto	noun
decanta	adjective
decante	adverb
degeneras	verb
degradas	verb
deliras	verb
demandas	verb
determinas	verb
dinamito	noun
disciplino	noun
disciplinas	verb
disputo	noun
disputas	verb
dividas	verb
domen	adverb
dominas	verb
servos	verb
entera	adjective
fascina	adjective
figuro	noun
figuras	verb
filmo	noun
filtras	verb
firmo	noun
firman	adjective
formas	verb
formulo	noun
formulas	verb
fragmento	noun
fragmenta	adjective
frustras	verb
esperas	verb
fumado	noun
fumas	verb
fundamento	noun
fundamenta	adjective
fundamente	adverb
fundo	noun
funde	adverb
fusilo	noun
estimo	noun
estimas	verb
grado	noun
gravas	verb
gravito	noun
gustas	verb
gusta	adjective
gustan	adjective
heredo	noun
heredas	verb
hereda	adjective
hidrato	noun
gesto	noun
evitas	verb
jubila	adjective
juro	noun
laboras	verb
lamentas	verb
lamo	noun
parlamenta	adjective
parodio	noun
participo	noun
levanto	noun
levanta	adjective
pasas	verb
levante	adverb
libere	adverb
limito	noun
lindan	adjective
pelas	verb
peno	noun
penas	verb
pendas	verb
penetro	noun
penetras	verb
penetra	adjective
persistas	verb
perturbo	noun
pesas	verb
piloto	noun
pisas	verb
planto	noun
plantas	verb
plantaron	noun
plasmo	noun
portas	verb
postulo	noun
postulas	verb
premias	verb
preparo	noun
preparas	verb
pretendas	verb
procedas	verb
procesas	verb
progresas	verb
progrese	adverb
propulsas	verb
malbarato	noun
malbarata	adjective
prospero	noun
malbarate	adverb
protesto	noun
protestas	verb
pulso	noun
pulsas	verb
pulsara	adjective
pulsaran	adjective
mamo	noun
manipulo	noun
manipulas	verb
medie	adverb
meditas	verb
metas	verb
militas	verb
milita	adjective
militan	adjective
mino	noun
miro	noun
miras	verb
modela	adjective
modera	adjective
mondan	adjective
montan	adjective
montara	adjective
motivo	noun
murmuro	noun
murmuras	verb
mutan	adjective
nivelo	noun
nivelas	verb
notas	verb
novelo	noun
nutras	verb
observas	verb
ofendas	verb
oferto	noun
ordeno	noun
oriento	noun
orienta	adjective
orienten	adverb
origino	noun
origina	adjective
ornamos	verb
oscilas	verb
radias	verb
rajo	noun
raspas	verb
reformo	noun
regeneras	verb
regulan	adjective
regule	adverb
rememoro	noun
rememoras	verb
rento	noun
resaltas	verb
respondas	verb
restas	verb
resumas	verb
reto	noun
retiras	verb
salas	verb
salan	adjective
salivo	noun
rimo	noun
robo	noun
sanas	verb
rompo	noun
rompas	verb
tabulo	noun
taja	adjective
serena	adjective
tarda	adjective
sobra	adjective
temo	noun
templo	noun
templa	adjective
termino	noun
timas	verb
tiras	verb
tirito	noun
tirita	adjective
tirite	adverb
sondas	verb
toleras	verb
sorbas	verb
torturas	verb
sube	adverb
suben	adverb
suba	adjective
trabo	noun
tramo	noun
sudo	noun
suda	adjective
sude	adverb
suden	adverb
transformas	verb
sume	adverb
transportas	verb
superas	verb
supera	adjective
trotas	verb
turnas	verb
ulcero	noun
uniformo	noun
valora	adjective
valso	noun
varo	noun
vegetas	verb
vegetara	adjective
velas	verb
vendas	verb
vibras	verb
violo	noun
violan	adjective
violento	noun
vira	adjective
viran	adjective
vomito	noun
vomita	adjective
vomitan	adjective
vomite	adverb
zono	noun
duan	adjective
avare	adverb
kodo	noun
ŝpari	verb
incendio	noun
serio	noun
sti	verb
oceanografia	adjective
oblo	noun
dekan	adjective
longo	noun
franco	noun
no	noun
boras	verb
presos	verb
mola	adjective
alte	adverb
alti	verb
vorta	adjective
tian	adjective
tian	adverb
servi	verb
germana	adjective
legio	noun
purpura	adjective
luma	adjective
semata	adjective
salus	verb
animi	verb
sali	verb
batate	adverb
fermate	adverb
feste	adverb
fumi	verb
rubo	noun
vola	adjective
volate	adverb
rompi	verb
volata	adjective
linko	noun
devo	noun
perso	noun
raso	noun
verbo	noun
rido	noun
speso	noun
papilio	noun
volto	noun
radion	noun
luo	noun
rusto	noun
versio	noun
galo	noun
atleta	adjective
analogia	adjective
antropologia	adjective
supre	adverb
povu	verb
ladon	noun
viron	noun
amus	verb
pisi	verb
pisis	verb
pisos	verb
pisu	verb
poto	noun
vasko	noun
vaska	adjective
vaskan	adjective
anglan	adjective
brita	adjective
latia	adjective
latian	adjective
latinan	adjective
lasis	verb
lasas	verb
lasos	verb
lasus	verb
lasu	verb
pelis	verb
pelos	verb
pelu	verb
ĝeni	verb
damne	interjection
persa	adjective
leono	noun
leonon	noun
azia	adjective
pubo	noun
haron	noun
ĝardeni	verb
ĝardenas	verb
ĝardena	adjective
interesas	verb
plumbo	noun
estri	verb
estris	verb
iros	verb
irus	verb
logis	verb
logas	verb
logus	verb
logu	verb
mian	pronoun
nesto	noun
neston	noun
nestiĝi	verb
nestiĝis	verb
nestiĝas	verb
nestiĝos	verb
nestiĝus	verb
nestiĝu	verb
nestos	verb
nestus	verb
nestigi	verb
nestigis	verb
nestigas	verb
nestigos	verb
nestigus	verb
nestigu	verb
oleon	noun
olivo	noun
matrimonio	noun
fermis	verb
temon	noun
ekzameni	verb
dubo	noun
dubon	noun
mocio	noun
mocion	noun
maso	noun
interne	adverb
epifanio	noun
speciale	adverb
irlanda	adjective
juron	noun
magie	adverb
subsurface	adverb
decimetro	noun
astronomo	noun
laboratorio	noun
pelota	adjective
slavo	noun
monumento	noun
karton	noun
fenomeno	noun
artista	adjective
prete	adverb
sandalo	noun
sonas	verb
despota	adjective
klik	interjection
semaforo	noun
neologismo	noun
arabo	noun
anatomia	adjective
pagus	verb
sinonimo	noun
interno	noun
plurale	adverb
perdita	adjective
volan	adjective
tipografo	noun
definitiva	adjective
kube	adverb
solido	noun
pesu	verb
hirundo	noun
heroo	noun
panero	noun
pilko	noun
salti	verb
lipo	noun
organo	noun
boni	verb
seka	adjective
ŝteli	verb
ŝtona	adjective
ŝtoneto	noun
ligna	adjective
plibonigi	verb
pliboniĝi	verb
eksigi	verb
eksiĝi	verb
faliĝi	verb
instrui	verb
ĝusti	verb
sanigi	verb
saniĝi	verb
anticipo	noun
tondos	verb
kredo	noun
degradante	adverb
fakta	adjective
perineo	noun
parados	verb
peki	verb
gaje	adverb
klare	adverb
konstante	adverb
laste	adverb
longe	adverb
momente	adverb
plene	adverb
publike	adverb
seke	adverb
tute	adverb
varme	adverb
vaste	adverb
ĝoje	adverb
feliĉe	adverb
dolĉe	adverb
atente	adverb
fiere	adverb
emi	verb
ĝui	verb
konkreta	adjective
evolui	verb
koka	adjective
savi	verb
parkas	verb
delirante	adverb
apatia	adjective
vendu	verb
fiasko	noun
lian	pronoun
nian	determiner
telepatia	adjective
jono	noun
banan	adjective
demagogia	adjective
telefoni	verb
visto	noun
geologo	noun
biografia	adjective
ju	particle
jupon	noun
dian	adjective
patologia	adjective
akrobata	adjective
entomologo	noun
liki	verb
krokodilo	noun
vortico	noun
vomi	verb
talento	noun
milo	noun
facili	verb
falsa	adjective
gravi	verb
hidrogeno	noun
karbono	noun
nitrogeno	noun
kloro	noun
sulfuro	noun
invito	noun
verdi	verb
franca	adjective
itala	adjective
zigzago	noun
zebro	noun
voĉo	noun
viziero	noun
vizio	noun
vipero	noun
kruĉo	noun
kuzo	noun
laĉo	noun
lampo	noun
lano	noun
lanco	noun
lapo	noun
lardo	noun
ledo	noun
leĝo	noun
lenso	noun
tibio	noun
kisu	verb
tipa	adjective
origini	verb
n.	adjective
osto	noun
korko	noun
teologia	adjective
konto	noun
agu	verb
pirato	noun
analogie	adverb
krei	verb
golfo	noun
golfo	noun
chu	particle
veleno	noun
intrigante	adverb
liva	adjective
segos	verb
ironia	adjective
belga	adjective
fronta	adjective
albano	noun
albana	adjective
idolo	noun
kd	noun
ignorante	adverb
saboti	verb
longan	adjective
otan	adjective
afgano	noun
shuo	noun
embrion	noun
anatomie	adverb
baza	adjective
memorate	adverb
diametro	noun
imposto	noun
aramea	adjective
salata	adjective
atomo	noun
bandito	noun
altruismo	noun
egoismo	noun
egoista	adjective
lokaj	adjective
fluido	noun
teorie	adverb
akademie	adjective
noti	verb
eble	adverb
dependi	verb
trovato	noun
timida	adjective
valori	verb
alternativo	noun
persone	adverb
persone	adverb
dominos	verb
parazita	adjective
registri	verb
etika	adjective
informa	adjective
procedura	adjective
favori	verb
fiero	noun
leksika	adjective
limon	noun
gambo	noun
urba	adjective
eterne	adverb
tosti	verb
relativa	adjective
pensiono	noun
ateismo	noun
ignori	verb
biologo	noun
biografo	noun
soleo	noun
etimologie	adverb
dominante	adverb
aborti	verb
mitologia	adjective
gluteo	noun
vibri	verb
portate	adverb
tirate	adverb
molekula	adjective
telefona	adjective
flori	verb
benefico	noun
montaj	adjective
adorato	noun
adorate	adverb
inviti	verb
celebri	verb
importi	verb
prenoto	noun
levito	noun
levita	adjective
levata	adjective
ene	adverb
salate	adverb
saltante	adverb
fluo	noun
degradate	adverb
determinante	adverb
destini	verb
determini	verb
formata	adjective
formi	verb
generi	verb
gustante	adverb
gusti	verb
apostrofo	noun
prepari	verb
preparate	adverb
apostolo	noun
protesti	verb
turbino	noun
fotografi	verb
stiri	verb
tenti	verb
tremo	noun
tremi	verb
informo	noun
informi	verb
informate	adverb
fizika	adjective
invento	noun
inventi	verb
salite	adverb
geografie	adverb
tragedie	adverb
tatuo	noun
fonetika	adjective
sistemo	noun
pendolo	noun
integri	verb
integra	adjective
imito	noun
imiti	verb
trombo	noun
imputo	noun
imputi	verb
maceri	verb
lordo	noun
vendi	verb
fendi	verb
andrologo	noun
nebule	adverb
insulti	verb
noci	verb
treni	verb
pagate	adverb
placo	noun
interpreti	verb
anticipi	verb
intimi	verb
ironie	adverb
mitologie	adverb
parametro	noun
indico	noun
varia	adjective
variate	adverb
sciato	noun
scio	noun
sciate	adverb
piki	verb
punita	adjective
agendo	noun
agiti	verb
epilepsia	adjective
subita	adjective
rigida	adjective
afgana	adjective
armena	adjective
armene	adverb
avide	adverb
certi	verb
venene	adverb
diafana	noun
eterna	adjective
fluida	adjective
intime	adverb
inversa	adjective
marini	verb
modesta	adjective
modeste	adverb
morta	adjective
nominativa	adjective
rara	adjective
sani	verb
severa	adjective
sincera	adjective
solida	adjective
superflua	adjective
transitiva	adjective
nutri	verb
ekonomie	adverb
servite	adverb
varios	verb
lavate	adverb
ekonomia	adjective
genealogia	adjective
meridiano	noun
sprono	noun
siron	noun
polan	adjective
valon	noun
kolon	noun
lukon	noun
solan	adjective
vian	pronoun
luon	noun
amento	noun
karan	adjective
antropologo	noun
gramatika	adjective
esploro	noun
maran	adjective
interesante	adverb
androgino	noun
androgina	adjective
slovena	adjective
krampi	verb
damo	noun
turo	noun
genro	noun
spira	adjective
spiro	noun
spiri	verb
grafika	adjective
problemo	noun
gesti	verb
regali	verb
abolo	noun
uzis	verb
magian	adjective
kera	adjective
haki	verb
sian	pronoun
kajo	noun
pola	adjective
veti	verb
kelo	noun
emon	noun
eron	noun
pipo	noun
lemu	verb
mirate	adverb
mirante	adverb
reen	adverb
rostro	noun
insisti	verb
insiste	adverb
musa	adjective
persisti	verb
tinti	verb
fido	noun
ostan	adjective
kinan	noun
junan	adjective
pakon	noun
sakon	noun
koron	noun
trion	noun
pinon	noun
polimero	noun
sanon	noun
maton	noun
strato	noun
celos	verb
satana	adjective
penetrante	verb
penetri	verb
flirti	verb
analfabeta	adjective
spirali	verb
anonima	adjective
aeri	verb
aera	adjective
animis	verb
deprimi	verb
situo	noun
situi	verb
armato	noun
armata	adjective
armate	adverb
varano	noun
grati	verb
ununbio	noun
ununseptio	noun
kalon	noun
invadi	verb
heroe	adverb
mordi	verb
anodo	noun
elfe	adverb
roso	noun
bazo	noun
lustro	noun
kurus	verb
tendo	noun
pretendi	verb
pikas	verb
termometro	noun
esperantisto	noun
estinta	adjective
volvi	verb
pigmento	noun
fotos	verb
timpano	noun
regis	verb
plaĝo	noun
egala	adjective
s-ro	noun
penso	noun
analoga	adjective
granato	noun
ŝia	determiner
1a	adjective
munti	verb
laton	noun
diligente	adverb
kanon	noun
indiga	adjective
sulo	noun
interrompo	noun
interrompi	verb
armis	verb
solvi	verb
sorgo	noun
germano	noun
resumi	verb
ungo	noun
digno	noun
bv.	interjection
konu	verb
filozofie	adverb
drogo	noun
perdo	noun
vina	adjective
spontanee	adverb
falus	verb
servis	verb
animos	verb
sorbite	adverb
ruso	noun
paragrafo	noun
salito	noun
patra	adjective
perfido	noun
purgatorio	noun
vandalo	noun
klaki	verb
maski	verb
falas	verb
sudano	noun
estro	noun
infesto	noun
biokemia	adjective
rutina	adjective
deveni	verb
tubero	noun
kvalita	adjective
fika	adjective
bombo	noun
bombi	verb
fermenti	verb
agronomo	noun
pelote	adverb
siro	noun
literatura	adjective
procedi	verb
investi	verb
procesos	verb
helo	noun
orbita	adjective
punas	verb
aerostato	noun
plani	verb
pruno	noun
politeismo	noun
lingvistika	adjective
atm	adverb
akustika	adjective
muzika	adjective
aron	noun
embrio	noun
ujon	noun
anekdota	adjective
dinamo	noun
turon	noun
varmi	verb
m.m.	noun
aktivan	adjective
alkoholan	adjective
analiza	adjective
balon	noun
fek	interjection
heleno	noun
rameno	noun
spiran	adjective
sakan	adjective
fida	adjective
temi	verb
gemo	noun
balistika	adjective
kripton	noun
lantan	adjective
elektron	noun
donato	noun
donata	adjective
treti	verb
figurante	adverb
figuri	verb
figurate	adverb
kilogramo	noun
lamenti	verb
perfida	adjective
perimetro	noun
premo	noun
prema	adjective
premiate	adverb
geometrie	adverb
apokalipsa	adjective
sfere	adverb
simpatia	adjective
reno	noun
halon	noun
lapon	noun
sepon	noun
supon	noun
strategia	adjective
strategie	adverb
anticipa	adjective
antidoto	noun
bolas	verb
barate	adverb
sankta	adjective
eviti	verb
evitate	adverb
filtri	verb
kokon	noun
sangon	noun
impalo	noun
kombi	verb
incenso	noun
inciti	verb
remi	verb
sako	noun
intesto	noun
manovro	noun
mastro	noun
sablon	noun
onta	adjective
ortografia	adjective
pelate	adverb
penti	verb
pio	noun
tiun	determiner
vuon	noun
prepucio	noun
manato	noun
opo	noun
socia	adjective
socie	adverb
superi	verb
komo	noun
meleagro	noun
januaro	noun
februaro	noun
oktobro	noun
telegrafo	noun
isto	noun
oranĝo	noun
pugo	noun
silentigi	verb
iĝi	verb
nederlanda	adjective
nederlandanino	noun
nederlanda	adjective
naiva	adjective
ĉi tie	adverb
verdo	noun
virino	noun
poligono	noun
amika	adjective
aŭto	noun
aŭtomobilo	noun
buso	noun
helikoptero	noun
fagopiro	noun
rizo	noun
milio	noun
stano	noun
adulta	adjective
koketa	adjective
tribo	noun
preta	adjective
malsekigi	verb
gladi	verb
ventro	noun
metalo	noun
fasti	verb
fotografu	verb
grafo	noun
funkcio	noun
bufon	noun
honesta	adjective
pleonasmo	noun
albina	adjective
vagino	noun
rolo	noun
disigi	verb
disiĝi	verb
palato	noun
opio	noun
peko	noun
gaŭĉo	noun
marto	noun
gaso	noun
loza	adjective
ambiguo	noun
ambigua	adjective
ambigue	adverb
ardo	noun
brunigi	verb
antonimo	noun
inflacio	noun
portugala	adjective
portugalo	noun
greko	noun
greka	adjective
hungara	adjective
hungaro	noun
paralela	adjective
ŝako	noun
blasfemo	noun
venku	verb
varon	noun
mongolo	noun
mongola	adjective
vito	noun
paradis	verb
mirus	verb
etero	noun
faceti	verb
koston	noun
frustri	verb
maniero	noun
masturbata	adjective
monotona	adjective
belo	noun
odoro	noun
pagana	adjective
sambo	noun
faka	adjective
barometro	noun
dimero	noun
larma	adjective
enantiomero	noun
pozos	verb
soneto	noun
pasos	verb
humana	adjective
bombas	verb
manometro	noun
monomero	noun
solvate	adverb
solvato	noun
gramo	noun
tenu	verb
proletario	noun
meteoro	noun
adu	verb
grego	noun
hardi	verb
postulata	verb
ŝipon	noun
procento	noun
termo	noun
ega	adjective
altan	adjective
komunista	adjective
returne	adverb
neato	noun
komodo	noun
migri	verb
helan	adjective
satira	adjective
ganto	noun
regu	verb
dominanta	adjective
pedofilo	noun
segante	adverb
vato	noun
vato	noun
ng	phrase
ekspansion	noun
folion	noun
spongo	noun
lazo	noun
latva	adjective
ktp	phrase
stango	noun
antipatia	adjective
ombro	noun
kronikan	adjective
oferi	verb
mangano	noun
bardo	noun
bastono	noun
bendo	noun
atento	noun
tiros	verb
orgasmos	verb
agha	adjective
aghas	noun
agas	verb
fresko	noun
dushi	verb
diplomata	adjective
chau	interjection
sonate	adverb
pornografo	noun
pornografa	adjective
taktika	adjective
fugo	noun
metronomo	noun
bekoj	noun
agata	adjective
filon	noun
astra	adjective
bakteria	adjective
unio	noun
prosperi	verb
fendus	verb
cinamon	noun
blinde	adverb
falu	verb
segmento	noun
informas	verb
formos	verb
tritono	noun
vibrafono	noun
frivolo	noun
frivola	adjective
gardas	verb
volas	verb
ceceo	noun
importas	verb
alterne	adverb
alternas	verb
brodas	verb
soula	adjective
ignoras	verb
boru	verb
takoj	noun
ovario	noun
abono	noun
abstemio	noun
abandonas	verb
masturbas	verb
sangas	verb
varias	verb
chie	adverb
trie	adverb
subiras	verb
punis	verb
agis	verb
investis	verb
ttt	noun
skuas	verb
sentis	verb
dormis	verb
mordu	verb
mordus	verb
perdis	verb
perdus	verb
tondu	verb
tondus	verb
eko	noun
levas	verb
celas	verb
semas	verb
supo	noun
sepa	adjective
sepan	adjective
oke	adverb
tenus	verb
instruis	verb
fikan	adjective
bekon	noun
boan	adjective
apatian	adjective
aramean	adjective
biblian	adjective
biografian	adjective
hebrean	adjective
laikan	adjective
latvan	adjective
malan	adjective
mitan	adjective
diras	verb
pekan	adjective
veran	adjective
vidas	verb
rompu	verb
rompis	verb
interrompis	verb
metron	noun
partio	noun
moldava	adjective
digon	noun
turkmena	adjective
balais	verb
duona	adjective
haloo	noun
volvate	adverb
stilo	noun
situas	verb
kalva	adjective
abona	adjective
kokan	adjective
muron	noun
puton	noun
velon	noun
eston	noun
kulon	noun
kuron	noun
mokan	adjective
pipon	noun
estona	adjective
karpo	noun
fondus	verb
freshe	adverb
revu	verb
revis	verb
formuli	verb
meteorologo	noun
aldonate	adverb
voras	verb
punos	verb
kamela	adjective
geno	noun
nervon	noun
m.	verb
savo	noun
aino	noun
aboli	verb
kero	noun
vadi	verb
absorbate	adverb
eto	noun
tineo	noun
inventas	verb
apokalipse	adverb
geografo	noun
frisa	adjective
friso	noun
friso	noun
maŭro	noun
ploro	noun
poeto	noun
tikli	verb
reĝa	adjective
lignan	adjective
spektro	noun
amputi	verb
platan	adjective
tantalo	noun
sese	adverb
bason	noun
adepte	adverb
patronite	adverb
monstro	noun
simetria	adjective
kolonia	adjective
lardon	noun
astrologo	noun
promeni	verb
neŭtrino	noun
cefalopodo	noun
haŭto	noun
neŭra	adjective
momentan	adjective
ebe	adverb
veston	noun
paci	verb
cin	pronoun
voĉi	verb
voĉis	verb
voĉas	verb
voĉos	verb
voĉus	verb
juku	verb
perspektiva	adjective
amfibia	adjective
fikus	verb
formaldehido	noun
lulus	verb
sinteza	adjective
antisemitismo	noun
augusto	noun
parton	noun
indianan	noun
mediti	verb
orbito	noun
favoris	verb
ekstra	adjective
somero	noun
kasko	noun
fiaĉa	adjective
simio	noun
epopea	adjective
emus	verb
kartografia	adjective
titano	noun
trista	adjective
luus	verb
aĉ	interjection
aĉa	adjective
regas	verb
laika	adjective
dimensio	noun
milion	noun
aĉe	adverb
diplomo	noun
pikon	noun
finos	verb
aĉulo	noun
levite	adverb
baroko	noun
rokoko	noun
gotika	adjective
pesis	verb
ino	noun
portalo	noun
kommando	noun
propagando	noun
alies	determiner
foso	noun
libreto	noun
ciano	noun
filologo	noun
salamandra	adjective
patologo	noun
tolo	noun
liberalismo	noun
sendo	noun
etnografo	noun
tempesto	noun
furon	noun
legas	verb
ligas	verb
migras	verb
floras	verb
profeto	noun
multo	noun
fraŭlino	noun
giganto	noun
multas	verb
bakis	verb
religio	noun
venas	verb
fonografo	noun
navigas	verb
banton	noun
usona	adjective
kirli	verb
envias	verb
sentas	verb
palpi	verb
propono	noun
imitas	verb
imitan	adjective
obligas	verb
satiro	noun
interesa	adjective
interese	adverb
jodo	noun
ardan	adjective
ardas	verb
velante	adverb
okupas	verb
okupo	noun
invitas	verb
insistas	verb
invadas	verb
vestis	verb
venis	verb
devenis	verb
vagas	verb
pagas	verb
revenis	verb
pego	noun
sonaron	noun
inventis	verb
banas	verb
monoteismo	noun
falo	noun
instalas	verb
devas	verb
mordas	verb
volvas	verb
teologo	noun
saltis	verb
saltos	verb
salis	verb
ruinas	verb
ruino	noun
stimulon	noun
civilizas	verb
civilizo	noun
paralizas	verb
paralizo	noun
organizas	verb
organiza	adjective
organizo	noun
analizas	verb
analizo	noun
lupino	noun
kaco	noun
piĉo	noun
piĉo	noun
berilo	noun
petaton	noun
plago	noun
doktrina	adjective
duko	noun
tusas	verb
tuso	noun
strio	noun
multan	adjective
normo	noun
verba	adjective
abonas	verb
abortas	verb
aborta	adjective
honoro	noun
honoras	verb
moke	adverb
amasa	adjective
anticipas	verb
anticipe	adverb
donas	verb
iluminas	verb
ilustras	verb
imputas	verb
infestas	verb
inflamas	verb
inflamo	noun
inflamos	verb
gluta	adjective
inhalas	verb
insertas	verb
instigas	verb
insultas	verb
interpretas	verb
inundas	verb
inundo	noun
triangulas	verb
triangula	adjective
triangule	adverb
triangulo	noun
meritas	verb
meza	adjective
ermita	adjective
paralelo	noun
datos	verb
fanfaron	noun
glacio	noun
lemas	verb
tritio	noun
lante	adverb
ĵetanto	noun
esence	adverb
polon	noun
silka	adjective
mateo	noun
oftalmologo	noun
ideologo	noun
soldatiĝi	verb
estimi	verb
dudek	numeral
etnologo	noun
soldatigi	verb
malico	noun
kantu	verb
klaku	verb
malica	adjective
gamo	noun
gamo	noun
favo	noun
filantropo	noun
ardu	verb
sanga	adjective
ludos	verb
fidos	verb
palto	noun
majoron	noun
industrio	noun
orgasmus	verb
kapitalisme	adverb
karbon	noun
arseno	noun
tuŝi	verb
binara	adjective
lami	verb
tensio	noun
tetano	noun
monolito	noun
tondi	verb
gustos	verb
paleontologo	noun
suchi	noun
portus	verb
bankon	noun
aĵo	noun
ejo	noun
telencefalo	noun
litografi	verb
celebrita	adjective
presbitero	noun
apatie	adverb
ludita	adjective
reva	adjective
iŝi	pronoun
aludas	verb
fondos	verb
restos	verb
branon	noun
falsos	verb
falsas	verb
sanos	verb
premios	verb
filozofia	adjective
sero	noun
festus	verb
resp.	adverb
havo	noun
presas	verb
palos	verb
paceman	adjective
ĝia	determiner
onia	determiner
neas	verb
furo	noun
danco	noun
eĥo	noun
ĵurnalo	noun
poŝo	noun
seĝo	noun
plie	adverb
abrupte	adverb
ĝentila	adjective
plaĉi	verb
ĉokolada	adjective
pelite	adverb
ameli	verb
pupo	noun
sangi	verb
pafi	verb
opinio	noun
cimbalon	noun
roziĝo	noun
roziĝi	verb
formu	verb
meron	noun
galon	noun
bovido	noun
tage	adverb
kurta	adjective
poŝto	noun
bazas	verb
unuiĝinta	adjective
unuiĝinta	verb
ĉefe	adverb
freŝa	adjective
droni	verb
diabla	adjective
erotika	adjective
trafe	adverb
perfekte	adverb
neĝi	verb
vegeti	verb
razas	verb
ĉina	adjective
kabo	noun
vulvo	noun
facon	noun
roza	adjective
predo	noun
krokodilu	verb
vori	verb
lutos	verb
italo	noun
glate	adverb
itale	adverb
tedi	verb
vango	noun
laŭta	adjective
pravi	verb
skandale	adverb
oligomero	noun
alcedo	noun
voru	verb
vorus	verb
metropolita	adjective
elastan	adjective
manko	noun
diversos	verb
cervino	noun
finas	verb
bindis	verb
hermafrodita	adjective
liro	noun
liro	noun
heroon	noun
heroa	adjective
tigro	noun
dek unu	numeral
dek du	numeral
dek tri	numeral
dek kvar	numeral
dek kvin	numeral
dek ses	numeral
dek sep	numeral
dek ok	numeral
dek naŭ	numeral
baku	verb
varianta	adjective
epididimo	noun
lutra	adjective
segmentate	adverb
moŝto	noun
eŭro	noun
stebi	verb
juda	adjective
n.b.	phrase
notus	verb
malvarmigi	verb
antonima	adjective
pravus	verb
econ	noun
ŝviti	verb
usona	adjective
posho	noun
radiu	verb
citita	adjective
citite	adverb
tolerante	adverb
orta	adjective
organizoj	noun
murmurate	adverb
antero	noun
plektron	noun
katastrofa	adjective
ametis	verb
grafito	noun
esperantista	adjective
acetilo	noun
aleno	noun
ponton	noun
velu	verb
atentas	verb
lms	adverb
venenos	verb
aboco	noun
siringo	noun
pobo	noun
spino	noun
sekvoj	noun
celu	verb
rabis	verb
telepatie	adverb
sonĝo	noun
fisho	noun
foresto	noun
danko	noun
fion	noun
doktoro	noun
spozo	noun
autuno	noun
atesto	noun
richa	adjective
inteligenta	adjective
interesanta	adjective
kelke	adverb
piro	noun
sekrete	adverb
vados	verb
prenos	verb
sonu	verb
unuiĝo	noun
bova	adjective
gorĝo	noun
prava	adjective
s-ino	noun
domaĝe	adverb
vergo	noun
daŭre	adverb
plenigi	verb
purigi	verb
ŝerci	verb
ŝŝ	interjection
ankoraŭ ne	adverb
pretigi	verb
ĝuste	adverb
marŝi	verb
servalo	noun
sciigi	verb
iam ajn	adverb
malalta	adjective
edziĝi	verb
eliri	verb
manĝo	noun
varmiĝi	verb
malvarmiĝi	verb
longiĝi	verb
verdiĝi	verb
propraĵo	noun
kontentigi	verb
petola	adjective
daŭra	adjective
ribo	noun
tuja	adjective
mendo	noun
ne dankinde	phrase
ptm.	adverb
atm.	adverb
pasaĝero	noun
proksimiĝi	verb
jaketo	noun
ŝarĝi	verb
saĝa	adjective
loĝanto	noun
ktp.	phrase
ĵurnalisto	noun
pozicio	noun
f-ino	noun
neŭtrala	adjective
kreskigi	verb
forto	noun
peza	adjective
malĝojiĝi	verb
kontento	noun
krome	adverb
vigla	adjective
montego	noun
aŭdiĝi	verb
disvastiĝi	verb
translokiĝi	verb
parkere	adverb
advento	noun
flui	verb
efektiviĝi	verb
ŝuisto	noun
notu	verb
fosi	verb
aĥ	interjection
realiĝi	verb
neniiĝi	verb
aŭstra	adjective
katoliko	noun
katolika	adjective
absorbi	verb
lumiĝi	verb
arĝenta	adjective
revo	noun
perlo	noun
ĉarmo	noun
planti	verb
indiĝeno	noun
timema	adjective
sidiĝi	verb
klarigi	verb
preferi	verb
tuko	noun
ĝenerale	adverb
torĉo	noun
preĝo	noun
mistere	adverb
laciĝi	verb
ĵazo	noun
jazo	noun
vergi	verb
cervido	noun
ĉiela	adjective
ĉiela	adjective
tradicio	noun
viena	adjective
ostro	noun
pruda	adjective
sopiro	noun
murdo	noun
edziniĝi	verb
nacian	adjective
evidentigi	verb
ŝategi	verb
sabate	adverb
kristnasko	noun
karto	noun
oportuna	adjective
luigi	verb
vulgara	adjective
aerodromo	noun
miris	verb
aerolito	noun
tapiŝo	noun
kroma	adjective
varmigi	verb
tranĉi	verb
faligi	verb
lucerno	noun
turko	noun
obstine	adverb
sonĝi	verb
precipe	adverb
reakcio	noun
bolis	verb
mezon	noun
nukleon	noun
transformi	verb
sciiĝi	verb
alproksimiĝi	verb
rekte	adverb
sepio	noun
alfabeta	adjective
obstina	adjective
obstinas	verb
obstino	noun
vataman	adjective
sep	numeral
timu	verb
retino	noun
forigi	verb
kaŭzi	verb
batalo	noun
praktika	adjective
unuigi	verb
ŝiri	verb
neniigi	verb
bruligi	verb
moki	verb
alproksimigi	verb
1-a	adjective
ĉijare	adverb
krio	noun
ripozo	noun
indiĝena	adjective
kurbigi	verb
harpon	noun
paŝti	verb
dek-unua	adjective
ho ve	interjection
mendoj	noun
kamero	noun
tusi	verb
glita	adjective
svate	adverb
ŝvita	adjective
ŝovi	verb
kune	adverb
tegi	verb
venĝo	noun
ĉeĥa	adjective
ĥina	adjective
regimento	noun
inĝeniero	noun
impona	adjective
ŝakalo	noun
flustre	adverb
ordono	noun
marĉo	noun
marĉa	adjective
sonos	verb
frison	noun
vendos	verb
rozo	noun
laŭdi	verb
surprizi	verb
ruza	adjective
gratuli	verb
kanapo	noun
rampi	verb
juĝi	verb
rosti	verb
verŝi	verb
brulante	adverb
tegu	verb
tegus	verb
sangu	verb
2a	adjective
lumas	verb
pasiva	adjective
fuko	noun
stas	verb
bojo	noun
nigre	adverb
sorbi	verb
kronika	adjective
bluu	verb
floris	verb
nea	adjective
petate	adverb
brulas	verb
brula	adjective
bruite	adverb
centriolo	noun
amnio	noun
honore	adverb
honora	adjective
direkte	adverb
parapeto	noun
varius	verb
manĝas	verb
manĝu	verb
manĝis	verb
manĝos	verb
deca	adjective
kanton	noun
anso	noun
flanken	adverb
flanke	adverb
ŝ	pronoun
silabo	noun
ech	adverb
pozitivan	adjective
vagi	verb
vorte	adverb
ŝatis	verb
ŝiaj	pronoun
ŝian	pronoun
ŝiajn	pronoun
ĝino	noun
kanabo	noun
jogon	noun
pezas	verb
stis	verb
provis	verb
erupcio	noun
boaco	noun
manĝata	adjective
ĉenero	noun
ŝuldo	noun
manĝante	adverb
tuno	noun
fono	noun
ĥoroj	noun
ĥoron	noun
ĥorojn	noun
ĉarman	adjective
flavan	adjective
bluaj	adjective
muson	noun
musojn	noun
musoj	noun
tablon	noun
arbon	noun
sunon	noun
lunon	noun
agoj	noun
centralizas	verb
forestas	verb
luman	adjective
vaporo	noun
domon	noun
ovoj	noun
manon	noun
steloj	noun
stelon	noun
stelojn	noun
nomas	verb
nomos	verb
honto	noun
lumos	verb
milimetro	noun
tereno	noun
mekanismo	noun
liberigi	verb
preciza	adjective
fikcio	noun
atestas	verb
atestis	verb
triki	verb
eksa	adjective
aŭton	noun
pere de	preposition
dividis	verb
areo	noun
igas	verb
igis	verb
igos	verb
igus	verb
igu	verb
iĝas	verb
iĝis	verb
iĝos	verb
iĝus	verb
iĝu	verb
fone	adverb
varii	verb
ĉesis	verb
akcentoj	noun
akcenton	noun
akcentojn	noun
anunciacion	noun
hasio	noun
haŝio	noun
veno	noun
ostroj	noun
ostron	noun
financi	verb
financas	verb
financis	verb
balancas	verb
balancis	verb
balancos	verb
reĝlando	noun
prenas	verb
atribui	verb
seĝon	noun
kaloj	noun
intrigas	verb
anodon	noun
abaton	noun
senco	noun
norvega	adjective
influi	verb
derivaĵo	noun
ĝuante	adverb
eduki	verb
foti	verb
duaj	adjective
kvaran	adjective
okan	adjective
dudek unu	numeral
pagoj	noun
pagon	noun
pagojn	noun
napo	noun
establi	verb
napoj	noun
leontodon	noun
fondon	noun
seloj	noun
selojn	noun
taŭro	noun
uzita	adjective
bitokon	noun
miriametro	noun
dungas	verb
teamo	noun
kreis	verb
fantomon	noun
krampas	verb
krampus	verb
vergon	noun
lukso	noun
vidis	verb
vidu	verb
vidus	verb
inflacion	noun
eksplodas	verb
eksplodis	verb
unuigo	noun
unuigoj	noun
unuigon	noun
unuigojn	noun
vitala	adjective
brizo	noun
orbiton	noun
zumu	verb
monton	noun
spinon	noun
opalo	noun
administris	verb
manĝojn	noun
manĝon	noun
manĝoj	noun
brunan	adjective
sidu	verb
kacon	noun
paĝo	noun
paĝojn	noun
paĝon	noun
paĝoj	noun
melki	verb
midzi	verb
subiro	noun
silko	noun
anusa	adjective
frosti	verb
hamako	noun
humiliĝi	verb
eĥi	verb
juko	noun
akceptante	adverb
akceptate	adverb
titana	adjective
batos	verb
siajn	pronoun
siaj	pronoun
ilian	pronoun
ĝian	pronoun
deko	noun
felto	noun
delto	noun
duobligi	verb
duobliĝi	verb
triobligi	verb
triobliĝi	verb
islamo	noun
roko	noun
navigi	verb
raŭpo	noun
suĉi	verb
trovas	verb
vokalo	noun
briĝo	noun
a-oj	noun
aŭdas	verb
aŭdis	verb
aŭdos	verb
aŭdita	adjective
aŭditan	adjective
senvestigi	verb
senvestiĝi	verb
serĉo	noun
serĉoj	noun
serĉon	noun
serĉojn	noun
serĉas	verb
serĉis	verb
serĉos	verb
serĉus	verb
serĉu	verb
serĉanta	adjective
serĉantaj	adjective
serĉinta	adjective
serĉintaj	adjective
serĉonta	adjective
serĉontaj	adjective
serĉantan	adjective
serĉantajn	adjective
serĉintan	adjective
serĉintajn	adjective
serĉontan	adjective
serĉontajn	adjective
serĉanto	noun
serĉantoj	noun
serĉinto	noun
serĉintoj	noun
serĉonto	noun
serĉontoj	noun
serĉanton	noun
serĉantojn	noun
serĉinton	noun
serĉintojn	noun
serĉonton	noun
serĉontojn	noun
serĉante	adverb
serĉinte	adverb
serĉonte	adverb
aŭdito	noun
aŭdus	verb
aŭdu	verb
aŭdite	adverb
ŝablonon	noun
ŝoko	noun
ŝoki	verb
ĵazon	noun
kosmo	noun
trudi	verb
garantio	noun
glatigi	verb
glatiĝi	verb
platigi	verb
platiĝi	verb
aluvio	noun
fungon	noun
3a	adjective
4a	adjective
elektrodo	noun
neŭrologo	noun
neŭrologia	adjective
reagi	verb
meĥanika	adjective
viskoza	adjective
izoterma	adjective
ĉuro	noun
ĉuri	verb
anhidrido	noun
aŭroro	noun
aldehido	noun
idon	noun
esploras	verb
limigi	verb
aprobas	verb
fantomas	verb
filtris	verb
filtru	verb
fluis	verb
fluus	verb
imponan	adjective
ŝarko	noun
fotis	verb
fotus	verb
prenate	adverb
prenote	adverb
predikante	adverb
presu	verb
melku	verb
melkite	adverb
leku	verb
fandu	verb
leviĝas	verb
leviĝanto	noun
leviĝante	adverb
efektiviĝas	verb
efektiviĝis	verb
efektiviĝos	verb
efektiviĝus	verb
efektiviĝu	verb
efektiviĝanta	adjective
efektiviĝantaj	adjective
efektiviĝantan	adjective
efektiviĝantajn	adjective
efektiviĝinta	adjective
efektiviĝintaj	adjective
efektiviĝintan	adjective
efektiviĝintajn	adjective
efektiviĝonta	adjective
efektiviĝontaj	adjective
efektiviĝontan	adjective
efektiviĝontajn	adjective
efektiviĝanto	noun
efektiviĝantoj	noun
efektiviĝanton	noun
efektiviĝantojn	noun
efektiviĝinto	noun
efektiviĝintoj	noun
efektiviĝinton	noun
efektiviĝintojn	noun
efektiviĝonto	noun
efektiviĝontoj	noun
efektiviĝonton	noun
efektiviĝontojn	noun
efektiviĝante	adverb
efektiviĝinte	adverb
efektiviĝonte	adverb
longiĝas	verb
longiĝis	verb
longiĝos	verb
longiĝus	verb
longiĝu	verb
longiĝanta	adjective
longiĝantaj	adjective
longiĝantan	adjective
longiĝantajn	adjective
longiĝinta	adjective
longiĝintaj	adjective
longiĝintan	adjective
longiĝintajn	adjective
longiĝonta	adjective
longiĝontaj	adjective
longiĝontan	adjective
longiĝontajn	adjective
longiĝanto	noun
longiĝantoj	noun
longiĝanton	noun
longiĝantojn	noun
longiĝinto	noun
longiĝintoj	noun
longiĝinton	noun
longiĝintojn	noun
longiĝonto	noun
longiĝontoj	noun
longiĝonton	noun
longiĝontojn	noun
longiĝante	adverb
longiĝinte	adverb
longiĝonte	adverb
malvarmiĝas	verb
malvarmiĝis	verb
malvarmiĝos	verb
malvarmiĝus	verb
malvarmiĝu	verb
malvarmiĝanta	adjective
malvarmiĝantaj	adjective
malvarmiĝantan	adjective
malvarmiĝantajn	adjective
malvarmiĝinta	adjective
malvarmiĝintaj	adjective
malvarmiĝintan	adjective
malvarmiĝintajn	adjective
malvarmiĝonta	adjective
malvarmiĝontaj	adjective
malvarmiĝontan	adjective
malvarmiĝontajn	adjective
malvarmiĝanto	noun
malvarmiĝantoj	noun
malvarmiĝanton	noun
malvarmiĝantojn	noun
malvarmiĝinto	noun
malvarmiĝintoj	noun
malvarmiĝinton	noun
malvarmiĝintojn	noun
malvarmiĝonto	noun
malvarmiĝontoj	noun
malvarmiĝonton	noun
malvarmiĝontojn	noun
malvarmiĝante	adverb
malvarmiĝinte	adverb
malvarmiĝonte	adverb
varmiĝas	verb
varmiĝis	verb
varmiĝos	verb
varmiĝus	verb
varmiĝu	verb
varmiĝanta	adjective
varmiĝantaj	adjective
varmiĝantan	adjective
varmiĝantajn	adjective
varmiĝinta	adjective
varmiĝintaj	adjective
varmiĝintan	adjective
varmiĝintajn	adjective
varmiĝonta	adjective
varmiĝontaj	adjective
varmiĝontan	adjective
varmiĝontajn	adjective
varmiĝanto	noun
varmiĝantoj	noun
varmiĝanton	noun
varmiĝantojn	noun
varmiĝinto	noun
varmiĝintoj	noun
varmiĝinton	noun
varmiĝintojn	noun
varmiĝonto	noun
varmiĝontoj	noun
varmiĝonton	noun
varmiĝontojn	noun
varmiĝante	adverb
varmiĝinte	adverb
varmiĝonte	adverb
vekiĝas	verb
vekiĝis	verb
vekiĝos	verb
vekiĝus	verb
biografio	noun
a.t.m.	adverb
jukon	noun
i.a.	phrase
p.k.	adverb
tenas	verb
tenos	verb
tenata	adjective
tenate	adverb
tenite	adverb
ludas	verb
ludis	verb
ludu	verb
rostas	verb
rostis	verb
rostos	verb
rostu	verb
rostite	adverb
dekoj	noun
riveron	noun
verkas	verb
triobligas	verb
triobligis	verb
triobligos	verb
triobligus	verb
triobligu	verb
triobliganta	adjective
triobligantaj	adjective
triobligantan	adjective
triobligantajn	adjective
triobliginta	adjective
triobligintaj	adjective
triobligintan	adjective
triobligintajn	adjective
triobligonta	adjective
triobligontaj	adjective
triobligontan	adjective
triobligontajn	adjective
triobliganto	noun
triobligantoj	noun
triobliganton	noun
triobligantojn	noun
triobliginto	noun
triobligintoj	noun
triobliginton	noun
triobligintojn	noun
triobligonto	noun
triobligontoj	noun
triobligonton	noun
triobligontojn	noun
triobligante	adverb
triobliginte	adverb
triobligonte	adverb
triobliĝas	verb
triobliĝis	verb
triobliĝos	verb
triobliĝus	verb
triobliĝu	verb
triobliĝanta	adjective
triobliĝantaj	adjective
triobliĝantan	adjective
triobliĝantajn	adjective
triobliĝinta	adjective
triobliĝintaj	adjective
triobliĝintan	adjective
triobliĝintajn	adjective
triobliĝonta	adjective
triobliĝontaj	adjective
triobliĝontan	adjective
triobliĝontajn	adjective
triobliĝanto	noun
triobliĝantoj	noun
triobliĝanton	noun
triobliĝantojn	noun
triobliĝinto	noun
triobliĝintoj	noun
triobliĝinton	noun
acetaldehido	noun
triobliĝintojn	noun
triobliĝonto	noun
triobliĝontoj	noun
triobliĝonton	noun
triobliĝontojn	noun
triobliĝante	adverb
triobliĝinte	adverb
triobliĝonte	adverb
duobligas	verb
duobligis	verb
duobligos	verb
duobligus	verb
duobligu	verb
duobliganta	adjective
duobligantaj	adjective
duobligantan	adjective
duobligantajn	adjective
duobliginta	adjective
duobligintaj	adjective
duobligintan	adjective
duobligintajn	adjective
duobligonta	adjective
duobligontaj	adjective
duobligontan	adjective
duobligontajn	adjective
duobliganto	noun
duobligantoj	noun
duobliganton	noun
duobligantojn	noun
duobliginto	noun
duobligintoj	noun
duobliginton	noun
duobligintojn	noun
duobligonto	noun
duobligontoj	noun
duobligonton	noun
duobligontojn	noun
duobligante	adverb
duobliginte	adverb
duobligonte	adverb
duobliĝas	verb
duobliĝis	verb
duobliĝos	verb
duobliĝus	verb
duobliĝu	verb
duobliĝanta	adjective
duobliĝantaj	adjective
duobliĝantan	adjective
duobliĝantajn	adjective
duobliĝinta	adjective
duobliĝintaj	adjective
duobliĝintan	adjective
duobliĝintajn	adjective
duobliĝonta	adjective
duobliĝontaj	adjective
duobliĝontan	adjective
duobliĝontajn	adjective
duobliĝanto	noun
duobliĝantoj	noun
duobliĝanton	noun
duobliĝantojn	noun
duobliĝinto	noun
duobliĝintoj	noun
duobliĝinton	noun
duobliĝintojn	noun
duobliĝonto	noun
duobliĝontoj	noun
duobliĝonton	noun
duobliĝontojn	noun
duobliĝante	adverb
duobliĝinte	adverb
duobliĝonte	adverb
agojn	noun
disigas	verb
disigis	verb
disigos	verb
disigus	verb
disigu	verb
disiganta	adjective
disigantaj	adjective
disigantan	adjective
disigantajn	adjective
disiginta	adjective
disigintaj	adjective
disigintan	adjective
disigintajn	adjective
disigonta	adjective
disigontaj	adjective
disigontan	adjective
disigontajn	adjective
disiganto	noun
disigantoj	noun
disiganton	noun
disigantojn	noun
disiginto	noun
disigintoj	noun
disiginton	noun
disigintojn	noun
disigonto	noun
disigontoj	noun
disigonton	noun
disigontojn	noun
disigante	adverb
disiginte	adverb
disigonte	adverb
bombardos	verb
dankos	verb
danku	verb
degelas	verb
detruis	verb
detruite	adverb
kuras	verb
kuris	verb
kuros	verb
disputis	verb
donis	verb
donos	verb
donus	verb
donu	verb
inerta	adjective
faras	verb
legis	verb
legos	verb
legus	verb
legu	verb
legota	adjective
lemos	verb
parolu	verb
mortu	verb
dormu	verb
kreskigas	verb
kreskigis	verb
kreskigos	verb
kreskigus	verb
kreskigu	verb
kreskiganta	adjective
kreskigantaj	adjective
kreskigantan	adjective
kreskigantajn	adjective
kreskiginta	adjective
kreskigintaj	adjective
kreskigintan	adjective
kreskigintajn	adjective
kreskigonta	adjective
kreskigontaj	adjective
kreskigontan	adjective
kreskigontajn	adjective
kreskiganto	noun
kreskigantoj	noun
kreskiganton	noun
kreskigantojn	noun
kreskiginto	noun
kreskigintoj	noun
kreskiginton	noun
kreskigintojn	noun
kreskigonto	noun
kreskigontoj	noun
kreskigonton	noun
kreskigontojn	noun
kreskigante	adverb
kreskiginte	adverb
kreskigonte	adverb
plugi	verb
violonĉelo	noun
distribui	verb
adopti	verb
aŭtonoma	adjective
aŭtonoman	adjective
drako	noun
sparko	noun
barono	noun
ĉifro	noun
kulpa	adjective
rekta	adjective
sekigi	verb
malsekiĝi	verb
sekiĝi	verb
pliboniĝas	verb
pliboniĝis	verb
pliboniĝos	verb
pliboniĝus	verb
pliboniĝu	verb
pliboniĝanta	adjective
pliboniĝantaj	adjective
pliboniĝantan	adjective
pliboniĝantajn	adjective
pliboniĝinta	adjective
pliboniĝintaj	adjective
pliboniĝintan	adjective
pliboniĝintajn	adjective
pliboniĝonta	adjective
pliboniĝontaj	adjective
pliboniĝontan	adjective
pliboniĝontajn	adjective
pliboniĝanto	noun
pliboniĝantoj	noun
pliboniĝanton	noun
pliboniĝantojn	noun
pliboniĝinto	noun
pliboniĝintoj	noun
pliboniĝinton	noun
pliboniĝintojn	noun
pliboniĝonto	noun
pliboniĝontoj	noun
pliboniĝonton	noun
pliboniĝontojn	noun
pliboniĝante	adverb
pliboniĝinte	adverb
pliboniĝonte	adverb
mencias	verb
mencius	verb
invitis	verb
flirtis	verb
masku	verb
roziĝas	verb
roziĝos	verb
roziĝus	verb
roziĝu	verb
voku	verb
purigas	verb
purigis	verb
purigos	verb
purigus	verb
purigu	verb
puriganta	adjective
purigantaj	adjective
purigantan	adjective
purigantajn	adjective
puriginta	adjective
purigintaj	adjective
purigintan	adjective
purigintajn	adjective
purigonta	adjective
purigontaj	adjective
purigontan	adjective
purigontajn	adjective
puriganto	noun
purigantoj	noun
puriganton	noun
purigantojn	noun
puriginto	noun
purigintoj	noun
puriginton	noun
purigintojn	noun
purigonto	noun
purigontoj	noun
purigonton	noun
purigontojn	noun
purigante	adverb
puriginte	adverb
purigonte	adverb
sciigas	verb
sciigis	verb
sciigos	verb
sciigus	verb
sciigu	verb
sciiganta	adjective
sciigantaj	adjective
sciigantan	adjective
sciigantajn	adjective
sciiginta	adjective
sciigintaj	adjective
sciigintan	adjective
sciigintajn	adjective
sciigonta	adjective
sciigontaj	adjective
sciigontan	adjective
sciigontajn	adjective
sciiganto	noun
sciigantoj	noun
sciiganton	noun
sciigantojn	noun
sciiginto	noun
sciigintoj	noun
sciiginton	noun
sciigintojn	noun
sciigonto	noun
sciigontoj	noun
sciigonton	noun
sciigontojn	noun
sciigante	adverb
sciiginte	adverb
sciigonte	adverb
neniigas	verb
neniigis	verb
neniigos	verb
neniigus	verb
neniigu	verb
neniiganta	adjective
neniigantaj	adjective
neniigantan	adjective
neniigantajn	adjective
neniiginta	adjective
neniigintaj	adjective
neniigintan	adjective
neniigintajn	adjective
neniigonta	adjective
neniigontaj	adjective
neniigontan	adjective
neniigontajn	adjective
neniiganto	noun
neniigantoj	noun
neniiganton	noun
neniigantojn	noun
neniiginto	noun
neniigintoj	noun
neniiginton	noun
neniigintojn	noun
neniigonto	noun
neniigontoj	noun
neniigonton	noun
neniigontojn	noun
neniigante	adverb
neniiginte	adverb
neniigonte	adverb
bruligas	verb
bruligis	verb
bruligos	verb
bruligus	verb
bruligu	verb
bruliganta	adjective
bruligantaj	adjective
bruligantan	adjective
bruligantajn	adjective
bruliginta	adjective
bruligintaj	adjective
bruligintan	adjective
bruligintajn	adjective
bruligonta	adjective
bruligontaj	adjective
bruligontan	adjective
bruligontajn	adjective
bruliganto	noun
bruligantoj	noun
bruliganton	noun
bruligantojn	noun
bruliginto	noun
bruligintoj	noun
bruliginton	noun
bruligintojn	noun
bruligonto	noun
bruligontoj	noun
bruligonton	noun
bruligontojn	noun
bruligante	adverb
bruliginte	adverb
bruligonte	adverb
akute	adverb
kruci	verb
tajli	verb
liberigas	verb
liberigis	verb
liberigos	verb
liberigus	verb
liberigu	verb
liberiganta	adjective
liberigantaj	adjective
liberigantan	adjective
liberigantajn	adjective
liberiginta	adjective
liberigintaj	adjective
liberigintan	adjective
liberigintajn	adjective
liberigonta	adjective
liberigontaj	adjective
liberigontan	adjective
liberigontajn	adjective
liberiganto	noun
liberigantoj	noun
liberiganton	noun
liberigantojn	noun
liberiginto	noun
liberigintoj	noun
liberiginton	noun
liberigintojn	noun
liberigonto	noun
liberigontoj	noun
liberigonton	noun
liberigontojn	noun
liberigante	adverb
liberiginte	adverb
liberigonte	adverb
bonan	adjective
admiris	verb
adoris	verb
ekzistas	verb
ekzistis	verb
ekzistos	verb
ekzistus	verb
navigos	verb
navigus	verb
navigu	verb
senvestigas	verb
senvestigis	verb
senvestigos	verb
senvestigus	verb
senvestigu	verb
senvestiganta	adjective
senvestigantaj	adjective
senvestigantan	adjective
senvestigantajn	adjective
senvestiginta	adjective
senvestigintaj	adjective
senvestigintan	adjective
senvestigintajn	adjective
senvestigonta	adjective
senvestigontaj	adjective
senvestigontan	adjective
senvestigontajn	adjective
senvestiganto	noun
senvestigantoj	noun
senvestiganton	noun
senvestigantojn	noun
senvestiginto	noun
senvestigintoj	noun
senvestiginton	noun
senvestigintojn	noun
senvestigonto	noun
senvestigontoj	noun
senvestigonton	noun
senvestigontojn	noun
senvestigante	adverb
senvestiginte	adverb
senvestigonte	adverb
senvestiĝas	verb
senvestiĝis	verb
senvestiĝos	verb
senvestiĝus	verb
senvestiĝu	verb
senvestiĝanta	adjective
senvestiĝantaj	adjective
senvestiĝantan	adjective
senvestiĝantajn	adjective
senvestiĝinta	adjective
senvestiĝintaj	adjective
senvestiĝintan	adjective
senvestiĝintajn	adjective
senvestiĝonta	adjective
senvestiĝontaj	adjective
senvestiĝontan	adjective
senvestiĝontajn	adjective
senvestiĝanto	noun
senvestiĝantoj	noun
senvestiĝanton	noun
senvestiĝantojn	noun
senvestiĝinto	noun
senvestiĝintoj	noun
senvestiĝinton	noun
senvestiĝintojn	noun
senvestiĝonto	noun
senvestiĝontoj	noun
senvestiĝonton	noun
senvestiĝontojn	noun
senvestiĝante	adverb
senvestiĝinte	adverb
senvestiĝonte	adverb
vestas	verb
vestu	verb
efektivigi	verb
specifiku	verb
iranta	adjective
ironton	noun
levinta	adjective
levitan	adjective
levanton	noun
levonte	adverb
ŝokon	noun
ŝokas	verb
ŝokis	verb
ŝokos	verb
ŝokus	verb
ŝoku	verb
ŝokantan	adjective
ŝokoto	noun
ŝokate	adverb
ŝokite	adverb
ŝokote	adverb
ŝuon	noun
ĝemeloj	noun
ĝemelojn	noun
imponas	verb
trudu	verb
flosi	verb
garantias	verb
garantiu	verb
nivelate	adverb
glatigas	verb
glatigis	verb
glatigos	verb
glatigus	verb
glatigu	verb
glatiganta	adjective
glatigantaj	adjective
glatigantan	adjective
glatigantajn	adjective
glatiginta	adjective
glatigintaj	adjective
glatigintan	adjective
glatigintajn	adjective
glatigonta	adjective
glatigontaj	adjective
glatigontan	adjective
glatigontajn	adjective
glatiganto	noun
glatigantoj	noun
glatiganton	noun
glatigantojn	noun
glatiginto	noun
glatigintoj	noun
glatiginton	noun
glatigintojn	noun
glatigonto	noun
glatigontoj	noun
glatigonton	noun
glatigontojn	noun
glatigante	adverb
glatiginte	adverb
glatigonte	adverb
glatiĝas	verb
glatiĝis	verb
glatiĝos	verb
glatiĝus	verb
glatiĝu	verb
glatiĝanta	adjective
glatiĝantaj	adjective
glatiĝantan	adjective
glatiĝantajn	adjective
glatiĝinta	adjective
glatiĝintaj	adjective
glatiĝintan	adjective
glatiĝintajn	adjective
glatiĝonta	adjective
glatiĝontaj	adjective
glatiĝontan	adjective
glatiĝontajn	adjective
glatiĝanto	noun
glatiĝantoj	noun
glatiĝanton	noun
glatiĝantojn	noun
glatiĝinto	noun
glatiĝintoj	noun
glatiĝinton	noun
glatiĝintojn	noun
glatiĝonto	noun
glatiĝontoj	noun
glatiĝonton	noun
glatiĝontojn	noun
glatiĝante	adverb
glatiĝinte	adverb
glatiĝonte	adverb
plataj	adjective
platigas	verb
platigis	verb
platigos	verb
platigus	verb
platigu	verb
platiganta	adjective
platigantaj	adjective
platigantan	adjective
platigantajn	adjective
platiginta	adjective
platigintaj	adjective
platigintan	adjective
platigintajn	adjective
platigonta	adjective
platigontaj	adjective
platigontan	adjective
platigontajn	adjective
fronto	noun
platiganto	noun
platigantoj	noun
platiganton	noun
platigantojn	noun
platiginto	noun
platigintoj	noun
platiginton	noun
platigintojn	noun
platigonto	noun
platigontoj	noun
platigonton	noun
platigontojn	noun
platigante	adverb
platiginte	adverb
platigonte	adverb
platiĝas	verb
platiĝis	verb
platiĝos	verb
platiĝus	verb
platiĝu	verb
platiĝanta	adjective
platiĝantaj	adjective
platiĝantan	adjective
platiĝantajn	adjective
platiĝinta	adjective
platiĝintaj	adjective
platiĝintan	adjective
platiĝintajn	adjective
platiĝonta	adjective
platiĝontaj	adjective
platiĝontan	adjective
platiĝontajn	adjective
platiĝanto	noun
platiĝantoj	noun
platiĝanton	noun
platiĝantojn	noun
platiĝinto	noun
platiĝintoj	noun
platiĝinton	noun
platiĝintojn	noun
platiĝonto	noun
platiĝontoj	noun
platiĝonton	noun
platiĝontojn	noun
platiĝante	adverb
platiĝinte	adverb
platiĝonte	adverb
aluvion	noun
neŭrologian	adjective
reagis	verb
neŭtralan	adjective
pezu	verb
ablativon	noun
recepto	noun
ĉuras	verb
ĉuris	verb
ĉuru	verb
ĉuranto	noun
ĉurante	adverb
orgasmu	verb
alian	adjective
bakas	verb
bakos	verb
bakita	adjective
dediĉas	verb
dediĉata	adjective
dediĉanto	noun
dediĉato	noun
dediĉante	adverb
dediĉate	adverb
eklipsis	verb
ŝarkon	noun
arbitraj	adjective
arĝentan	adjective
aĉan	adjective
binaran	adjective
feki	verb
kulturas	verb
kulturos	verb
kulturu	verb
kaprico	noun
anĝela	adjective
anĝelino	noun
enua	adjective
enuigi	verb
enuiĝi	verb
plugas	verb
adoptis	verb
esperis	verb
esperanton	noun
ĵetas	verb
ĵetis	verb
ĵetos	verb
ĵetus	verb
ĵetanta	adjective
ĵetinta	adjective
ĵetonta	adjective
ĵetata	adjective
ĵetita	adjective
ĵetota	adjective
ĵetinto	noun
ĵetonto	noun
ĵetato	noun
ĵetito	noun
ĵetoto	noun
ĵetante	adverb
ĵetinte	adverb
ĵetonte	adverb
ĵetate	adverb
ĵetite	adverb
ĵetote	adverb
apriloj	noun
aprilon	noun
aprilojn	noun
rektan	adjective
sekigas	verb
sekigis	verb
sekigos	verb
sekigus	verb
sekigu	verb
sekiganta	adjective
sekigantaj	adjective
sekigantan	adjective
sekigantajn	adjective
sekiginta	adjective
sekigintaj	adjective
sekigintan	adjective
sekigintajn	adjective
sekigonta	adjective
sekigontaj	adjective
sekigontan	adjective
sekigontajn	adjective
sekiganto	noun
sekigantoj	noun
sekiganton	noun
sekigantojn	noun
sekiginto	noun
sekigintoj	noun
sekiginton	noun
sekigintojn	noun
sekigonto	noun
sekigontoj	noun
sekigonton	noun
sekigontojn	noun
sekigante	adverb
sekiginte	adverb
sekigonte	adverb
malsekiĝas	verb
malsekiĝis	verb
malsekiĝos	verb
malsekiĝus	verb
malsekiĝu	verb
malsekiĝanta	adjective
malsekiĝantaj	adjective
malsekiĝantan	adjective
malsekiĝantajn	adjective
malsekiĝinta	adjective
malsekiĝintaj	adjective
malsekiĝintan	adjective
malsekiĝintajn	adjective
malsekiĝonta	adjective
malsekiĝontaj	adjective
malsekiĝontan	adjective
malsekiĝontajn	adjective
malsekiĝanto	noun
malsekiĝantoj	noun
malsekiĝanton	noun
malsekiĝantojn	noun
malsekiĝinto	noun
malsekiĝintoj	noun
malsekiĝinton	noun
malsekiĝintojn	noun
malsekiĝonto	noun
malsekiĝontoj	noun
malsekiĝonton	noun
malsekiĝontojn	noun
malsekiĝante	adverb
malsekiĝinte	adverb
malsekiĝonte	adverb
sekiĝas	verb
sekiĝis	verb
sekiĝos	verb
sekiĝus	verb
sekiĝu	verb
sekiĝanta	adjective
sekiĝantaj	adjective
sekiĝantan	adjective
sekiĝantajn	adjective
sekiĝinta	adjective
sekiĝintaj	adjective
sekiĝintan	adjective
sekiĝintajn	adjective
sekiĝonta	adjective
sekiĝontaj	adjective
sekiĝontan	adjective
sekiĝontajn	adjective
sekiĝanto	noun
sekiĝantoj	noun
sekiĝanton	noun
sekiĝantojn	noun
sekiĝinto	noun
sekiĝintoj	noun
sekiĝinton	noun
sekiĝintojn	noun
sekiĝonto	noun
sekiĝontoj	noun
sekiĝonton	noun
sekiĝontojn	noun
sekiĝante	adverb
sekiĝinte	adverb
sekiĝonte	adverb
alarmoj	noun
amputis	verb
alternis	verb
liston	noun
abstraktas	verb
abstraktu	verb
abonis	verb
abonate	adverb
krucoj	noun
krucon	noun
krucojn	noun
krucis	verb
litografas	verb
litografos	verb
tusis	verb
tusos	verb
tusus	verb
tusu	verb
tusanta	adjective
tusantaj	adjective
tusantan	adjective
tusantajn	adjective
tusinta	adjective
tusintaj	adjective
tusintan	adjective
tusintajn	adjective
tusonta	adjective
tusontaj	adjective
tusontan	adjective
tusontajn	adjective
tusanto	noun
tusantoj	noun
tusanton	noun
tusantojn	noun
tusinto	noun
tusintoj	noun
tusinton	noun
tusintojn	noun
tusonto	noun
tusontoj	noun
tusonton	noun
tusontojn	noun
tusante	adverb
tusinte	adverb
tusonte	adverb
tuson	noun
tuŝas	verb
tuŝis	verb
tuŝos	verb
tuŝus	verb
tuŝu	verb
tuŝanta	adjective
tuŝantaj	adjective
tuŝantan	adjective
tuŝantajn	adjective
tuŝinta	adjective
tuŝintaj	adjective
tuŝintan	adjective
tuŝintajn	adjective
tuŝonta	adjective
tuŝontaj	adjective
tuŝontan	adjective
tuŝontajn	adjective
tuŝata	adjective
tuŝataj	adjective
tuŝatan	adjective
tuŝatajn	adjective
tuŝita	adjective
tuŝitaj	adjective
tuŝitan	adjective
tuŝitajn	adjective
tuŝota	adjective
tuŝotaj	adjective
tuŝotan	adjective
tuŝotajn	adjective
tuŝanto	noun
tuŝantoj	noun
tuŝanton	noun
tuŝantojn	noun
tuŝinto	noun
tuŝintoj	noun
tuŝinton	noun
tuŝintojn	noun
tuŝonto	noun
tuŝontoj	noun
tuŝonton	noun
tuŝontojn	noun
tuŝato	noun
tuŝatoj	noun
tuŝaton	noun
tuŝatojn	noun
tuŝito	noun
tuŝitoj	noun
tuŝiton	noun
tuŝitojn	noun
tuŝoto	noun
tuŝotoj	noun
tuŝoton	noun
tuŝotojn	noun
tuŝante	adverb
tuŝinte	adverb
tuŝonte	adverb
tuŝate	adverb
tuŝite	adverb
tuŝote	adverb
timis	verb
timos	verb
timus	verb
trotus	verb
trotu	verb
tiris	verb
tirus	verb
tiru	verb
tirinto	noun
buntan	adjective
danan	adjective
dek-unuaj	adjective
dek-unuan	adjective
dek-unuajn	adjective
efektivigas	verb
efektivigis	verb
efektivigos	verb
efektivigus	verb
efektivigu	verb
efektiviganta	adjective
efektivigantaj	adjective
efektivigantan	adjective
efektivigantajn	adjective
efektiviginta	adjective
efektivigintaj	adjective
efektivigintan	adjective
efektivigintajn	adjective
efektivigonta	adjective
efektivigontaj	adjective
efektivigontan	adjective
efektivigontajn	adjective
efektiviganto	noun
efektivigantoj	noun
efektiviganton	noun
efektivigantojn	noun
efektiviginto	noun
efektivigintoj	noun
efektiviginton	noun
efektivigintojn	noun
efektivigonto	noun
efektivigontoj	noun
efektivigonton	noun
efektivigontojn	noun
efektivigante	adverb
efektiviginte	adverb
efektivigonte	adverb
eman	adjective
enan	adjective
ferman	adjective
fian	adjective
finan	adjective
freŝan	adjective
fronton	noun
portalon	noun
notoj	noun
noton	noun
notis	verb
kapricoj	noun
kapricon	noun
kapricojn	noun
aĝis	verb
aĝos	verb
aĝus	verb
aĝu	verb
aĝanta	adjective
aĝantaj	adjective
aĝantan	adjective
aĝantajn	adjective
aĝinta	adjective
aĝintaj	adjective
aĝintan	adjective
aĝintajn	adjective
aĝonta	adjective
aĝontaj	adjective
aĝontan	adjective
aĝontajn	adjective
aĝanto	noun
aĝantoj	noun
aĝanton	noun
aĝantojn	noun
aĝinto	noun
aĝintoj	noun
aĝinton	noun
aĝintojn	noun
aĝonto	noun
aĝontoj	noun
aĝonton	noun
aĝontojn	noun
aĝante	adverb
aĝinte	adverb
aĝonte	adverb
neĝas	verb
neĝos	verb
neĝus	verb
neĝu	verb
neĝanto	noun
neĝante	adverb
enuigas	verb
enuigis	verb
enuigos	verb
enuigus	verb
enuigu	verb
enuiganta	adjective
enuigantaj	adjective
enuigantan	adjective
enuigantajn	adjective
enuiginta	adjective
enuigintaj	adjective
enuigintan	adjective
enuigintajn	adjective
enuigonta	adjective
enuigontaj	adjective
enuigontan	adjective
enuigontajn	adjective
enuiganto	noun
enuigantoj	noun
enuiganton	noun
enuigantojn	noun
enuiginto	noun
enuigintoj	noun
enuiginton	noun
enuigintojn	noun
enuigonto	noun
enuigontoj	noun
enuigonton	noun
enuigontojn	noun
enuigante	adverb
enuiginte	adverb
enuigonte	adverb
enuiĝas	verb
enuiĝis	verb
enuiĝos	verb
enuiĝus	verb
enuiĝu	verb
enuiĝanta	adjective
enuiĝantaj	adjective
enuiĝantan	adjective
enuiĝantajn	adjective
enuiĝinta	adjective
enuiĝintaj	adjective
enuiĝintan	adjective
enuiĝintajn	adjective
enuiĝonta	adjective
enuiĝontaj	adjective
enuiĝontan	adjective
enuiĝontajn	adjective
enuiĝanto	noun
enuiĝantoj	noun
enuiĝanton	noun
enuiĝantojn	noun
enuiĝinto	noun
enuiĝintoj	noun
enuiĝinton	noun
enuiĝintojn	noun
enuiĝonto	noun
enuiĝontoj	noun
enuiĝonton	noun
enuiĝontojn	noun
enuiĝante	adverb
enuiĝinte	adverb
enuiĝonte	adverb
gajan	adjective
germanaj	adjective
germanan	adjective
germanajn	adjective
heroan	adjective
feron	noun
seleno	noun
zirkonio	noun
selenon	noun
alkohola	adjective
bruliĝi	verb
respektive	adverb
bruliĝas	verb
bruliĝis	verb
bruliĝos	verb
bruliĝus	verb
bruliĝu	verb
bruliĝanta	adjective
bruliĝantaj	adjective
bruliĝantan	adjective
bruliĝantajn	adjective
bruliĝinta	adjective
bruliĝintaj	adjective
bruliĝintan	adjective
bruliĝintajn	adjective
bruliĝonta	adjective
bruliĝontaj	adjective
bruliĝontan	adjective
bruliĝontajn	adjective
bruliĝanto	noun
bruliĝantoj	noun
bruliĝanton	noun
bruliĝantojn	noun
bruliĝinto	noun
bruliĝintoj	noun
bruliĝinton	noun
bruliĝintojn	noun
bruliĝonto	noun
bruliĝontoj	noun
bruliĝonton	noun
bruliĝontojn	noun
bruliĝante	adverb
bruliĝinte	adverb
bruliĝonte	adverb
amortizas	verb
aminta	adjective
amonte	adverb
amite	adverb
amote	adverb
neos	verb
uzas	verb
uzus	verb
uzu	verb
dancas	verb
dancos	verb
dancus	verb
dancu	verb
daŭris	verb
brulis	verb
vidite	adverb
falis	verb
falante	adverb
ŝanĝas	verb
ŝanĝis	verb
ŝanĝos	verb
ŝanĝus	verb
ŝanĝu	verb
ŝanĝanta	adjective
ŝanĝantaj	adjective
ŝanĝantan	adjective
ŝanĝantajn	adjective
ŝanĝinta	adjective
ŝanĝintaj	adjective
ŝanĝintan	adjective
ŝanĝintajn	adjective
ŝanĝonta	adjective
ŝanĝontaj	adjective
ŝanĝontan	adjective
ŝanĝontajn	adjective
ŝanĝanto	noun
ŝanĝantoj	noun
ŝanĝanton	noun
ŝanĝantojn	noun
ŝanĝinto	noun
ŝanĝintoj	noun
ŝanĝinton	noun
ŝanĝintojn	noun
ŝanĝonto	noun
ŝanĝontoj	noun
ŝanĝonton	noun
ŝanĝontojn	noun
ŝanĝante	adverb
ŝanĝinte	adverb
ŝanĝonte	adverb
ligis	verb
ligu	verb
ligita	adjective
ligote	adverb
vorton	noun
aŭkcio	noun
plumon	noun
horoj	noun
horon	noun
horojn	noun
divorci	verb
tremis	verb
informis	verb
informita	adjective
revas	verb
revinta	adjective
sagoj	noun
sagon	noun
sagojn	noun
malvarmigas	verb
malvarmigis	verb
malvarmigos	verb
malvarmigus	verb
malvarmigu	verb
malvarmiganta	adjective
malvarmigantaj	adjective
malvarmigantan	adjective
malvarmigantajn	adjective
malvarmiginta	adjective
malvarmigintaj	adjective
malvarmigintan	adjective
malvarmigintajn	adjective
malvarmigonta	adjective
malvarmigontaj	adjective
malvarmigontan	adjective
malvarmigontajn	adjective
malvarmiganto	noun
malvarmigantoj	noun
malvarmiganton	noun
malvarmigantojn	noun
malvarmiginto	noun
malvarmigintoj	noun
malvarmiginton	noun
malvarmigintojn	noun
malvarmigonto	noun
malvarmigontoj	noun
malvarmigonton	noun
malvarmigontojn	noun
malvarmigante	adverb
malvarmiginte	adverb
malvarmigonte	adverb
marŝas	verb
marŝu	verb
absorbis	verb
varmigas	verb
varmigis	verb
varmigos	verb
varmigus	verb
varmigu	verb
varmiganta	adjective
varmigantaj	adjective
varmigantan	adjective
varmigantajn	adjective
varmiginta	adjective
varmigintaj	adjective
varmigintan	adjective
varmigintajn	adjective
varmigonta	adjective
varmigontaj	adjective
varmigontan	adjective
varmigontajn	adjective
varmiganto	noun
varmigantoj	noun
varmiganton	noun
varmigantojn	noun
varmiginto	noun
varmigintoj	noun
varmiginton	noun
varmigintojn	noun
varmigonto	noun
varmigontoj	noun
varmigonton	noun
varmigontojn	noun
varmigante	adverb
varmiginte	adverb
varmigonte	adverb
pakis	verb
pakos	verb
paku	verb
ĝuis	verb
ĝuu	verb
uzo	noun
botoj	noun
boton	noun
ĝuata	adjective
ĝuita	adjective
ĝuota	adjective
ĝuanto	noun
ĝuato	noun
ĝuaton	noun
ĝuito	noun
ĝuate	adverb
veku	verb
tranĉas	verb
tranĉos	verb
falon	noun
stukas	verb
pufas	verb
decidis	verb
decidu	verb
ĝenas	verb
ĝenis	verb
ĝenus	verb
ĝenu	verb
ĝenante	verb
ĝenita	adjective
ĝenite	verb
ĝenote	verb
ĝenito	noun
ŝercas	verb
ŝercis	verb
ŝercos	verb
ŝercus	verb
ŝercu	verb
ŝercanta	adjective
ŝercantaj	adjective
ŝercantan	adjective
ŝercantajn	adjective
ŝercante	verb
ŝercinta	adjective
ŝercintaj	adjective
ŝercintan	adjective
ŝercintajn	adjective
ŝercinte	verb
ŝerconta	adjective
ŝercontaj	adjective
ŝercontan	adjective
ŝercontajn	adjective
ŝerconte	verb
ŝercanto	adjective
ŝercantoj	verb
ŝercanton	verb
ŝercantojn	verb
ŝercinto	adjective
ŝercintoj	verb
ŝercinton	verb
ŝercintojn	verb
ŝerconto	adjective
ŝercontoj	noun
ŝerconton	verb
ŝercontojn	verb
eŭropio	noun
fenestron	noun
polonion	noun
k.c.	phrase
k.t.p.	phrase
p.t.m.	adverb
s-ano	noun
t.n.	adverb
d-ro	noun
d-ino	noun
dogman	adjective
buŝojn	noun
buŝon	noun
buŝoj	noun
buŝa	adjective
buŝaj	adjective
buŝajn	adjective
buŝan	adjective
ŝakon	noun
penetris	verb
feku	verb
aĉetis	verb
aĉetu	verb
aĉetate	adverb
aĉetita	adjective
aĉetite	adverb
aĉetote	adverb
aĉetato	noun
aĉetito	noun
denton	noun
jaroj	noun
jaron	noun
respondon	noun
neŭtrono	noun
bolu	verb
laŭrencio	noun
ruterfordio	noun
borio	noun
hasion	noun
darmŝtatio	noun
obolo	noun
paladion	noun
oron	noun
aŭtomobiloj	noun
aŭtomobilon	noun
aŭtomobilojn	noun
aluminia	adjective
meduzo	noun
meduzon	noun
ramon	noun
ekzekuti	verb
vasalo	noun
flami	verb
polara	adjective
propanon	noun
butanon	noun
kloroformo	noun
poleno	noun
plasmido	noun
lepro	noun
paskon	noun
timon	noun
rajon	noun
utilon	noun
pasoj	noun
pason	noun
pasojn	noun
paŝo	noun
paŝoj	noun
paŝon	noun
paŝojn	noun
daton	noun
hidrologo	noun
kanonon	noun
organa	adjective
melodion	noun
vitamino	noun
venenon	noun
punoj	noun
kerato	noun
gramatikan	adjective
spokoj	noun
nombroj	noun
nombrojn	noun
neŭrono	noun
keston	noun
nomada	adjective
forton	noun
boris	verb
boros	verb
borus	verb
floran	adjective
heliometro	noun
ermito	noun
planton	noun
buŝe	adverb
filipina	adjective
esperantistoj	noun
esperantiston	noun
esperantistojn	noun
guglo	noun
nov-jorkano	noun
meritus	verb
gustigi	verb
flamiĝi	verb
flamigi	verb
mamon	noun
saŭco	noun
paronimo	noun
heleboro	noun
kavan	adjective
mitro	noun
pastroj	noun
pastron	noun
muŝo	noun
muŝoj	noun
muŝon	noun
muŝojn	noun
sorĉisto	noun
mesoj	noun
kaŝtano	noun
formala	adjective
matematikan	adjective
kubon	noun
cedron	noun
balotas	verb
baloto	noun
piero	noun
pieron	noun
pistolon	noun
sepdek unu	numeral
sepdek du	numeral
sepdek tri	numeral
sepdek kvar	numeral
sepdek kvin	numeral
sepdek ses	numeral
sepdek sep	numeral
sepdek ok	numeral
sepdek naŭ	numeral
pitono	noun
serpenton	noun
homonimo	noun
edro	noun
prolapsi	verb
klasika	adjective
konon	noun
lafon	noun
salaj	adjective
saloj	noun
salojn	noun
lunan	adjective
jardon	noun
arkipelago	noun
homino	noun
giganta	adjective
bombon	noun
bombos	verb
atombombo	noun
ĝin	pronoun
atoma	adjective
paston	noun
razilo	noun
purpuro	noun
pseŭdonimo	noun
kuzon	noun
placoj	noun
placon	noun
placojn	noun
rondon	noun
trafiko	noun
solene	adverb
valvo	noun
ligon	noun
skabelon	noun
aperos	verb
prolapsus	verb
celoj	noun
celon	noun
celojn	noun
ruston	noun
halogeno	noun
regos	verb
roton	noun
gemoj	noun
gemon	noun
gemojn	noun
acetimetro	noun
vilaĝon	noun
musketo	noun
ĉeloj	noun
ĉelon	noun
ĉelojn	noun
amortizo	noun
leona	adjective
penson	noun
franko	noun
dunon	noun
sapon	noun
mangoj	noun
mangon	noun
mangojn	noun
anelido	noun
cedis	verb
hematologo	noun
arterio	noun
okdek ok	numeral
okdek sep	numeral
okdek ses	numeral
okdek kvin	numeral
okdek kvar	numeral
okdek tri	numeral
okdek du	numeral
okdek unu	numeral
okdek naŭ	numeral
dudek du	numeral
sesdek naŭ	numeral
kvardek unu	numeral
kvardek tri	numeral
kvardek du	numeral
kvardek kvar	numeral
kvardek kvin	numeral
template:eo-ord form	adjective
batoj	noun
alkinoj	noun
arkon	noun
pafo	noun
ebura	adjective
eburon	noun
grenado	noun
perko	noun
genaro	noun
kankro	noun
kankron	noun
kvardek ses	numeral
kvardek sep	numeral
kvardek ok	numeral
kvardek naŭ	numeral
kvindek unu	numeral
glicerido	noun
maron	noun
gobio	noun
zeolito	noun
aŭtomata	adjective
trianguli	verb
halton	noun
liron	noun
centaŭro	noun
gildo	noun
helico	noun
streta	adjective
kvindek du	numeral
kvindek tri	numeral
kvindek kvar	numeral
kvindek kvin	numeral
kvindek ses	numeral
kvindek sep	numeral
kvindek ok	numeral
kvindek naŭ	numeral
sesdek unu	numeral
sesdek du	numeral
sesdek tri	numeral
sesdek kvar	numeral
sesdek kvin	numeral
sesdek ses	numeral
sesdek sep	numeral
sesdek ok	numeral
tridek unu	numeral
tridek du	numeral
tridek tri	numeral
tridek kvar	numeral
tridek kvin	numeral
tridek ses	numeral
tridek sep	numeral
tridek ok	numeral
tridek naŭ	numeral
dudek tri	numeral
dudek kvar	numeral
dudek kvin	numeral
dudek ses	numeral
dudek sep	numeral
dudek ok	numeral
dudek naŭ	numeral
naŭdek naŭ	numeral
naŭdek ok	numeral
naŭdek sep	numeral
naŭdek ses	numeral
naŭdek kvin	numeral
naŭdek kvar	numeral
naŭdek tri	numeral
naŭdek du	numeral
naŭdek unu	numeral
epifanio	noun
pereon	noun
skisto	noun
mizera	adjective
aĵon	noun
novjorkano	noun
hisopo	noun
reston	noun
ledan	adjective
bieron	noun
fraŭloj	noun
fraŭlon	noun
fraŭlojn	noun
protiston	noun
geloj	noun
paraldehido	noun
nifo	noun
cilindra	adjective
kc	phrase
pensis	verb
peptido	noun
dipeptido	noun
polipeptido	noun
paliso	noun
pulmon	noun
amblo	noun
pezon	noun
tomata	adjective
festoj	noun
feston	noun
ĉinan	adjective
takto	noun
pando	noun
ŝafon	noun
tigron	noun
velos	verb
ostoj	noun
laŭro	noun
laŭron	noun
slavon	noun
inan	adjective
poŝon	noun
svedan	adjective
sudan	adjective
vitraj	adjective
karaj	adjective
flavon	noun
apero	noun
kapilara	adjective
fasado	noun
sinjoron	noun
renon	noun
amoros	verb
reĝido	noun
konkretan	adjective
pasus	verb
kristnaskon	noun
segmentas	verb
provas	verb
lutas	verb
defloras	verb
signon	noun
telefonoj	noun
barbon	noun
fotografas	verb
formon	noun
formigon	noun
rolas	verb
pepos	verb
envolvi	verb
surfaca	adjective
realo	noun
boritan	adjective
borito	noun
bombis	verb
ĉizas	verb
celis	verb
celus	verb
celite	adverb
datis	verb
datu	verb
datita	adjective
disciplinu	verb
dominis	verb
volis	verb
volu	verb
volonta	verb
volonta	adjective
volonte	adverb
volanton	noun
volite	adverb
staras	verb
staros	verb
ŝiras	verb
ŝiris	verb
ŝiru	verb
ŝironta	adjective
ŝirite	adverb
ŝirota	adjective
ŝirotan	adjective
ŝirote	adverb
ŝovas	verb
ŝovu	verb
ŝovinto	noun
ŝovite	adverb
miros	verb
verban	adjective
transmigras	verb
bruis	verb
belege	adverb
peze	adverb
zorge	adverb
kolombon	noun
tradicion	noun
religia	adjective
altaj	adjective
loze	adjective
dieso	noun
plantejo	noun
inda	adjective
indan	adjective
malsanigi	adjective
trankviligi	verb
trankviliĝi	verb
aluminian	adjective
lavus	verb
fotografos	verb
fotografus	verb
banĝo	noun
banĝon	noun
pentrite	adverb
trifolio	noun
bruton	noun
bilo	noun
komunikoj	noun
kredon	noun
gravediĝi	verb
institucion	noun
ovalo	noun
elektrona	adjective
protona	adjective
adjektiva	adjective
decan	adjective
fidele	adverb
silikon	noun
dekunua	adjective
dekunuaj	adjective
dekunuan	adjective
dekunuajn	adjective
dek-dua	adjective
dek-duaj	adjective
dek-duan	adjective
dek-duajn	adjective
dek-tria	adjective
dek-triaj	adjective
dek-trian	adjective
dek-triajn	adjective
stu	verb
dek-kvara	adjective
dek-kvaraj	adjective
dek-kvaran	adjective
dek-kvarajn	adjective
dek-kvina	adjective
dek-kvinaj	adjective
dek-kvinan	adjective
dek-kvinajn	adjective
dek-sesa	adjective
dek-sesaj	adjective
dek-sesan	adjective
dek-sesajn	adjective
dek-sepa	adjective
dek-sepaj	adjective
dek-sepan	adjective
dek-sepajn	adjective
dek-oka	adjective
dek-okaj	adjective
dek-okan	adjective
dek-okajn	adjective
ĝojan	adjective
piĉoj	noun
piĉojn	noun
piĉon	noun
puŝi	verb
puŝo	noun
puŝon	noun
manipuli	verb
fikse	adverb
ŝlosi	verb
dek-naŭa	adjective
dek-naŭaj	adjective
dek-naŭan	adjective
dek-naŭajn	adjective
ian	determiner
ian	adverb
kaŝita	adjective
kaŝitan	adjective
dudek-unua	adjective
dudek-unuaj	adjective
dudek-unuan	adjective
dudek-unuajn	adjective
dudek-dua	adjective
dudek-duaj	adjective
dudek-duan	adjective
dudek-duajn	adjective
dudek-tria	adjective
dudek-triaj	adjective
dudek-trian	adjective
dudek-triajn	adjective
dudek-kvara	adjective
dudek-kvaraj	adjective
dudek-kvaran	adjective
dudek-kvarajn	adjective
dudek-kvina	adjective
dudek-kvinaj	adjective
dudek-kvinan	adjective
dudek-kvinajn	adjective
laboris	verb
faco	noun
imputis	verb
restis	verb
inflami	verb
inflamis	verb
rason	noun
savis	verb
savos	verb
savita	adjective
audi	verb
saŭdado	noun
situacio	noun
damon	noun
plaĝoj	noun
febra	adjective
standon	noun
parki	verb
debatis	verb
parkis	verb
luas	verb
sidas	verb
sireno	noun
dungo	noun
farton	noun
germanoj	noun
germanon	noun
germanojn	noun
manipulis	verb
manipulos	verb
pigon	noun
velis	verb
fraudoj	noun
fraudon	noun
fraudojn	noun
senĉesa	adjective
portos	verb
kien	adverb
ĉien	adverb
nerdo	noun
risko	noun
grandmama	adjective
etigi	verb
fraŭlinojn	noun
fraŭlinon	noun
fraŭlinoj	noun
s-inoj	noun
s-inon	noun
teto	noun
pacaj	adjective
pacan	adjective
pacon	adjective
puca	adjective
prave	adverb
peton	noun
ŝeloj	noun
ŝelon	noun
ŝelojn	noun
spiralis	verb
demokrata	adjective
paron	noun
eton	noun
spado	noun
stos	verb
centa	adjective
baris	verb
betona	adjective
sarkasme	adverb
vivis	verb
portanto	noun
afrika	adjective
defendis	verb
arta	adjective
gustanto	noun
trajtoj	noun
pledon	noun
manion	noun
malŝati	verb
ĝena	adjective
ĝene	adverb
ĝeno	noun
ĝenoj	noun
ĝenon	noun
ĝenojn	noun
romanĉa	adjective
nete	adverb
aĝoj	noun
aĝon	noun
aĝojn	noun
sociala	adjective
emis	verb
petis	verb
petas	verb
petito	noun
premis	verb
proponas	verb
genui	verb
absolvi	verb
eligis	verb
eligi	verb
fundis	verb
vilan	adjective
insistis	verb
influis	verb
nutris	verb
grenon	noun
iamajn	adjective
kotan	adjective
portis	verb
formis	verb
plantis	verb
torturis	verb
larĝan	adjective
laŭtan	adjective
fumis	verb
ulmo	noun
sonis	verb
tabano	noun
angule	adverb
marĉan	adjective
laŭte	adverb
rori	verb
militis	verb
interpretis	verb
morton	noun
dion	noun
gustu	verb
saltu	verb
portu	verb
landon	noun
papon	noun
programon	noun
multis	verb
sanis	verb
flavas	verb
triangulos	verb
diro	noun
diris	verb
tostas	verb
rapidos	verb
rapidas	verb
raŭkan	adjective
1aj	adjective
1an	adjective
1ajn	adjective
1-aj	adjective
1-an	adjective
1-ajn	adjective
reĝan	adjective
riĉan	adjective
ruzan	adjective
samaj	adjective
sangaj	adjective
festas	verb
saĝan	adjective
pravos	verb
pravas	verb
superis	verb
variis	verb
ardis	verb
meritos	verb
citis	verb
signis	verb
argumentis	verb
vadis	verb
unuiĝintaj	adjective
unuiĝintan	adjective
unuiĝintajn	adjective
usonaj	adjective
usonan	adjective
usonajn	adjective
varian	adjective
vienan	adjective
ĥinan	adjective
ĝustaj	adjective
ĝustan	adjective
ĝustajn	adjective
ĝeneralan	adjective
ĉastan	adjective
alie	adverb
ĉino	noun
japano	noun
japana	adjective
haitia	adjective
egipto	noun
egipta	adjective
hieroglifo	noun
belgo	noun
sindikato	noun
nigri	verb
nigro	noun
nigris	verb
nigros	verb
nigras	verb
venenate	adverb
nacion	noun
belgan	adjective
eŭropa	adjective
eŭropan	adjective
putri	verb
figuris	verb
saltanto	noun
frida	adjective
mava	adjective
litova	adjective
avinon	noun
misan	adjective
mavan	adjective
ruson	noun
rusan	adjective
moldavan	adjective
turka	adjective
turkan	adjective
norvego	noun
mongolan	adjective
slovako	noun
slovaka	adjective
uncio	noun
bubon	noun
piko	noun
pikoj	noun
inon	noun
taroko	noun
helenon	noun
leĝon	noun
felisa	adjective
putino	noun
ŝtatoj	noun
ŝtaton	noun
ŝtatojn	noun
prostitui	verb
formulis	verb
cico	noun
pinton	noun
semo	noun
semon	noun
uncion	noun
novjorkanoj	noun
novjorkanon	noun
novjorkanojn	noun
geko	noun
zamenhofa	adjective
zamenhofaj	adjective
zamenhofan	adjective
zamenhofajn	adjective
amerikano	noun
preĝi	verb
preĝas	verb
preĝos	verb
preĝu	verb
estron	noun
iĉo	noun
iĉon	noun
ingo	noun
ismo	noun
polui	verb
poluis	verb
navigacio	noun
federacio	noun
federacion	noun
ulon	noun
cerviĉo	noun
strigo	noun
urson	noun
ursido	noun
abstinas	verb
operacio	noun
operacion	noun
polko	noun
sinto	noun
sinton	noun
graŭ	preposition
kaŭ	conjunction
jc	noun
prononci	verb
prononcas	verb
pasion	noun
animu	verb
bramon	noun
spageta	adjective
ĉipa	adjective
ĉipa	adjective
aŭdio	noun
aŭdion	noun
banis	verb
banos	verb
banus	verb
banu	verb
naĝas	verb
naĝos	verb
naĝu	verb
kostus	verb
kostas	verb
moneron	noun
ĉeko	noun
eŭron	noun
vangoj	noun
kisi	verb
kisis	verb
kisos	verb
kisus	verb
adicion	noun
alabastron	noun
fako	noun
fakon	noun
novaĵo	noun
amason	noun
ambron	noun
duŝi	verb
duŝas	verb
duŝis	verb
duŝu	verb
analizon	noun
vertebro	noun
ĝirafon	noun
ĝirafa	adjective
arĉon	noun
avaron	noun
muzo	noun
muzon	noun
muzoj	noun
muzojn	noun
aĉeton	noun
bandon	noun
ronĝas	verb
ŝtelas	verb
ŝtele	adverb
kranion	noun
barĉon	noun
bariton	noun
beron	noun
betoj	noun
egiptologo	noun
blatoj	noun
blaton	noun
bordon	noun
brandon	noun
ŝorbeto	noun
bridon	noun
poŝtaĵo	noun
poŝtaĵon	noun
poŝtaĵoj	noun
poŝtaĵojn	noun
briton	noun
brilon	noun
poŝton	noun
ŝteleti	verb
bukon	noun
bulon	noun
burdon	noun
picon	noun
picoj	noun
picojn	noun
ĉipo	noun
frankfurto	noun
frankfurton	noun
ĝinzo	noun
ĉaŭ	interjection
busoj	noun
buson	noun
busojn	noun
vestoj	noun
tabuo	noun
senton	noun
regus	verb
sentu	verb
informacion	noun
ciron	noun
jugoj	noun
jugon	noun
jugojn	noun
kapron	noun
damaskon	noun
kardon	noun
numeroj	noun
dativon	noun
portugalon	noun
ŝaloj	noun
ŝalon	noun
ŝalojn	noun
ŝaŭmon	noun
ŝimon	noun
skota	adjective
skotan	adjective
germanon	noun
germanoj	noun
germanojn	noun
haitian	adjective
ĉine	adverb
greke	adverb
portugale	adverb
kapriĉo	noun
kapriĉon	noun
kapriĉoj	noun
kapriĉojn	noun
kapra	adjective
ekon	noun
rulas	verb
zooj	noun
zoojn	noun
biron	noun
havajon	noun
erupcion	noun
reĝi	verb
reĝu	verb
reĝus	verb
reĝos	verb
reĝis	verb
reĝas	verb
ĝigolo	noun
fianĉo	noun
kapono	noun
ŝaho	noun
daimio	noun
guno	noun
paskon	noun
ĵudo	noun
judon	noun
judan	adjective
kristnaskon	noun
kristnaskoj	noun
kristnaskojn	noun
naskas	verb
ĵudon	noun
bokon	noun
moŝton	noun
carojn	noun
caroj	noun
informon	noun
suĉas	verb
suĉis	verb
suĉos	verb
suĉus	verb
suĉu	verb
solvus	verb
sonĝu	verb
sorbus	verb
sorbu	verb
spiros	verb
sangis	verb
sangos	verb
sangus	verb
sanu	verb
telefonis	verb
telefonos	verb
telefonu	verb
unuigas	verb
unuigis	verb
unuigos	verb
unuigus	verb
unuigu	verb
scius	verb
konos	verb
konis	verb
konas	verb
velus	verb
ĉasas	verb
ĉasos	verb
ĉasis	verb
ĉasus	verb
ĉasu	verb
ĉifu	verb
dk	interjection
bv	interjection
ptm	adverb
ioj	pronoun
iojn	pronoun
kian	adjective
kian	adverb
kion	noun
floriston	noun
gorĝon	noun
vd	verb
vd	verb
stus	verb
bkv	phrase
geva	phrase
forumon	noun
mirlando	noun
mirlandon	noun
gaston	noun
kurtaj	adjective
kurtan	adjective
pruo	noun
reĝe	adverb
ĉu ne?	phrase
fride	adjective
varmas	verb
varmu	verb
fridi	verb
malsati	verb
malsatas	verb
malsatis	verb
malsatos	verb
malsatus	verb
malsatu	verb
freŝi	verb
freŝas	verb
freŝis	verb
freŝos	verb
freŝus	verb
freŝu	verb
kanada	adjective
kanadan	adjective
pizon	noun
satos	verb
satus	verb
satas	verb
fdk	phrase
citu	verb
junis	verb
junu	verb
oldi	verb
oldu	verb
genroj	noun
genron	noun
genrojn	noun
golfon	noun
gradon	noun
evoluas	verb
evoluis	verb
stariĝi	verb
starigas	verb
starigis	verb
starigos	verb
starigus	verb
starigu	verb
stariĝas	verb
stariĝis	verb
stariĝos	verb
stariĝus	verb
stariĝu	verb
haŝion	noun
verdon	noun
verdos	verb
verdu	verb
ruĝe	adverb
ruĝi	verb
ruĝas	verb
ruĝis	verb
ruĝos	verb
ruĝo	noun
doloros	verb
jaketoj	noun
jaketon	noun
jaketojn	noun
kameron	noun
komon	noun
kordon	noun
kronon	noun
kruĉoj	noun
kruĉon	noun
kruĉojn	noun
bretono	noun
hepato	noun
dano	noun
rinocero	noun
guto	noun
hipopotamo	noun
ambicio	noun
latoj	noun
laĉon	noun
loĝantoj	noun
loĝanton	noun
lucernon	noun
loĝantojn	noun
lukton	noun
razi	verb
razis	verb
razos	verb
razu	verb
cedu	verb
pravu	verb
pagu	verb
maizon	noun
plantu	verb
dubas	verb
dubis	verb
kuraĝe	adverb
milda	adjective
sanigas	verb
sanigis	verb
sanigos	verb
sanigus	verb
sanigu	verb
omo	noun
omon	noun
okon	noun
maston	noun
mendon	noun
ĉarme	adverb
ĉarmi	verb
teron	noun
jeto	noun
jetoj	noun
jetojn	noun
aŭtogiro	noun
aŭtogiron	noun
azalean	adjective
ĵipo	noun
ĵipon	noun
nov-jorkanoj	noun
nov-jorkanon	noun
nov-jorkanojn	noun
novelon	noun
orton	noun
ŝercoj	noun
ŝercon	noun
ŝercojn	noun
pesoj	noun
kongreso	noun
poton	noun
poŝtoj	noun
preĝon	noun
procesion	noun
provoj	noun
randon	noun
renton	noun
rolon	noun
disponas	verb
distribuis	verb
situacion	noun
slavoj	noun
soldon	noun
statoj	noun
staton	noun
statojn	noun
temis	verb
sepe	adverb
naŭe	adverb
abandonis	verb
abandoni	verb
alarmi	verb
anticipis	verb
gustis	verb
ploris	verb
preparis	verb
tiranon	noun
celebris	verb
unuiĝoj	noun
unuiĝon	noun
unuiĝojn	noun
vestojn	noun
vicon	noun
vipon	noun
ekos	verb
spontane	adverb
svage	adverb
psion	noun
zebron	noun
ĉamon	noun
ĉanon	noun
ĉapon	noun
ŝanĝon	noun
populara	adjective
simbolos	verb
simbolu	verb
nederlandano	noun
nederlandanino	noun
nederlandanoj	noun
nederlandanon	noun
nederlandanojn	noun
nederlandaninoj	noun
nederlandaninon	noun
nederlandaninojn	noun
heroiĉo	noun
broĉo	noun
poŝa	adjective
koncernu	verb
proporcio	noun
estiĝi	verb
estiĝas	verb
estiĝis	verb
estiĝos	verb
estiĝus	verb
estiĝu	verb
konata	adjective
sanganta	adjective
sangantaj	adjective
sangantan	adjective
sangantajn	adjective
indiki	verb
lumbo	noun
pentri	verb
ĉeĥe	adverb
seksa	adjective
registara	adjective
okupante	adverb
nacia	adjective
provos	verb
realigi	verb
ĉarmas	verb
ĉarmate	adverb
alabastra	adjective
ĉiun	determiner
invadis	verb
vespera	adjective
vesperas	verb
deputas	verb
bojos	verb
unuiĝi	verb
pundo	noun
2-a	adjective
tiama	adjective
financa	adjective
ekis	verb
flakon	noun
aŭtomato	noun
benote	adverb
ŝveli	verb
prosperis	verb
prosperos	verb
statuta	adjective
rabi	verb
determinis	verb
kongregacio	noun
ekzerci	verb
morala	adjective
gvido	noun
juĝo	noun
lakta	adjective
etete	adverb
pligrandiĝi	verb
pligrandiĝas	verb
pligrandiĝis	verb
pligrandiĝos	verb
pligrandiĝus	verb
pligrandiĝu	verb
pligrandiĝanta	adjective
pligrandiĝinta	adjective
pligrandiĝonta	adjective
pligrandiĝantaj	adjective
pligrandiĝintaj	adjective
pligrandiĝontaj	adjective
pligrandiĝantan	adjective
pligrandiĝintan	adjective
pligrandiĝontan	adjective
pligrandiĝantajn	adjective
pligrandiĝintajn	adjective
pligrandiĝontajn	adjective
pligrandiĝanto	noun
pligrandiĝinto	noun
pligrandiĝonto	noun
pligrandiĝantoj	noun
pligrandiĝintoj	noun
pligrandiĝontoj	noun
pligrandiĝanton	noun
pligrandiĝinton	noun
pligrandiĝonton	noun
pligrandiĝantojn	noun
pligrandiĝintojn	noun
pligrandiĝontojn	noun
pligrandiĝante	adverb
pligrandiĝinte	adverb
pligrandiĝonte	adverb
realigas	verb
realigis	verb
realigos	verb
realigus	verb
realigu	verb
realiganta	adjective
realiginta	adjective
realigonta	adjective
realigantaj	adjective
realigintaj	adjective
realigontaj	adjective
realigantan	adjective
realigintan	adjective
realigontan	adjective
realigantajn	adjective
realigintajn	adjective
realigontajn	adjective
realiganto	noun
realiginto	noun
realigonto	noun
realigantoj	noun
realigintoj	noun
realigontoj	noun
realiganton	noun
realiginton	noun
realigonton	noun
realigantojn	noun
realigintojn	noun
realigontojn	noun
realigante	adverb
realiginte	adverb
realigonte	adverb
ofici	verb
interagi	verb
fiaskos	verb
idilio	noun
benas	verb
bojas	verb
fastas	verb
flatas	verb
hakas	verb
kronas	verb
vakas	verb
zebran	adjective
fazo	noun
rusta	adjective
resumis	verb
distros	verb
n-ro	noun
prostituis	verb
motivoj	noun
ŝajna	adjective
faŭno	noun
helena	adjective
disĉiplo	noun
graco	noun
kazo	noun
heĝo	noun
uroj	noun
egiptia	adjective
unike	adverb
latero	noun
manifestacio	noun
normala	adjective
manifestacion	noun
lateron	noun
reala	adjective
sindona	adjective
gramatike	adverb
neŭtra	adjective
estigi	verb
roli	verb
ŝtormi	verb
fare de	preposition
ignoris	verb
ĉampiono	noun
laŭdo	noun
komunismo	noun
tabako	noun
akto	noun
kapitalismo	noun
kredite	adverb
atribuis	verb
konite	adverb
posedis	verb
aganta	adjective
aginta	adjective
agonta	adjective
agantaj	adjective
agintaj	adjective
agontaj	adjective
agantan	adjective
agintan	adjective
agontan	adjective
agantajn	adjective
agintajn	adjective
agontajn	adjective
aganto	noun
aginto	noun
agonto	noun
agantoj	noun
agintoj	noun
agontoj	noun
aganton	noun
aginton	noun
agonton	noun
agantojn	noun
agintojn	noun
agontojn	noun
agante	adverb
aginte	adverb
agonte	adverb
agatan	adjective
agato	noun
agaton	noun
suferinta	adjective
suferinte	adverb
lanĉi	verb
lanĉas	verb
lanĉis	verb
ĉesigi	verb
ĉesigas	verb
ĉesigis	verb
ĉesigos	verb
ĉesigus	verb
ĉesiganta	adjective
ĉesiginta	adjective
ĉesigonta	adjective
ĉesiganto	noun
ĉesiginto	noun
ĉesigonto	noun
ĉesigante	adverb
ĉesiginte	adverb
ĉesigonte	adverb
ĉesigata	adjective
ĉesigita	adjective
ĉesigota	adjective
ĉesigato	noun
ĉesigito	noun
ĉesigoto	noun
ĉesigate	adverb
ĉesigite	adverb
ĉesigote	adverb
taŭge	adverb
gliti	verb
libia	adjective
eksigas	verb
eksigis	verb
eksigos	verb
eksigus	verb
eksigu	verb
eksiganta	adjective
eksiginta	adjective
eksigonta	adjective
eksigantaj	adjective
eksigintaj	adjective
eksigontaj	adjective
eksigantan	adjective
eksigintan	adjective
eksigontan	adjective
eksigantajn	adjective
eksigintajn	adjective
eksigontajn	adjective
eksiganto	noun
eksiginto	noun
eksigonto	noun
eksigantoj	noun
eksigintoj	noun
eksigontoj	noun
eksiganton	noun
eksiginton	noun
eksigonton	noun
eksigantojn	noun
eksigintojn	noun
eksigontojn	noun
eksigante	adverb
eksiginte	adverb
eksigonte	adverb
eksiĝas	verb
eksiĝis	verb
eksiĝos	verb
eksiĝus	verb
eksiĝu	verb
eksiĝanta	adjective
eksiĝinta	adjective
eksiĝonta	adjective
eksiĝantaj	adjective
eksiĝintaj	adjective
eksiĝontaj	adjective
eksiĝantan	adjective
eksiĝintan	adjective
eksiĝontan	adjective
eksiĝantajn	adjective
eksiĝintajn	adjective
eksiĝontajn	adjective
eksiĝanto	noun
eksiĝinto	noun
eksiĝonto	noun
eksiĝantoj	noun
eksiĝintoj	noun
eksiĝontoj	noun
eksiĝanton	noun
eksiĝinton	noun
eksiĝonton	noun
eksiĝantojn	noun
eksiĝintojn	noun
eksiĝontojn	noun
eksiĝante	adverb
eksiĝinte	adverb
eksiĝonte	adverb
tunizia	adjective
sud-amerika	adjective
lamentis	verb
alklimatigi	verb
ario	noun
arion	noun
plibonigas	verb
plibonigis	verb
plibonigos	verb
plibonigus	verb
plibonigu	verb
pliboniganta	adjective
pliboniginta	adjective
plibonigonta	adjective
plibonigantaj	adjective
plibonigintaj	adjective
plibonigontaj	adjective
plibonigantan	adjective
plibonigintan	adjective
plibonigontan	adjective
plibonigantajn	adjective
plibonigintajn	adjective
plibonigontajn	adjective
pliboniganto	noun
pliboniginto	noun
plibonigonto	noun
plibonigantoj	noun
plibonigintoj	noun
plibonigontoj	noun
pliboniganton	noun
pliboniginton	noun
plibonigonton	noun
plibonigantojn	noun
plibonigintojn	noun
plibonigontojn	noun
plibonigante	adverb
pliboniginte	adverb
plibonigonte	adverb
fizike	adverb
generacio	noun
ekzili	verb
ekzilas	verb
ekzilis	verb
antaŭhieraŭ	adverb
institucio	noun
iganta	adjective
iginta	adjective
igonta	adjective
igantaj	adjective
igintaj	adjective
igontaj	adjective
igantan	adjective
igintan	adjective
igontan	adjective
igantajn	adjective
igintajn	adjective
igontajn	adjective
iganto	noun
iginto	noun
igonto	noun
igantoj	noun
igintoj	noun
igontoj	noun
iganton	noun
iginton	noun
igonton	noun
igantojn	noun
igintojn	noun
igontojn	noun
igante	adverb
iginte	adverb
igonte	adverb
ĝenro	noun
restu	verb
socialisma	adjective
ĝenroj	noun
ĝenron	noun
ĝenrojn	noun
muslima	adjective
reĝimo	noun
centrisma	adjective
liberiĝi	verb
liberiĝas	verb
liberiĝis	verb
liberiĝos	verb
liberiĝus	verb
liberiĝu	verb
liberiĝanta	adjective
liberiĝinta	adjective
liberiĝonta	adjective
liberiĝantaj	adjective
liberiĝintaj	adjective
liberiĝontaj	adjective
liberiĝantan	adjective
liberiĝintan	adjective
liberiĝontan	adjective
liberiĝantajn	adjective
liberiĝintajn	adjective
liberiĝontajn	adjective
liberiĝanto	noun
liberiĝinto	noun
liberiĝonto	noun
liberiĝantoj	noun
liberiĝintoj	noun
liberiĝontoj	noun
liberiĝanton	noun
liberiĝinton	noun
liberiĝonton	noun
liberiĝantojn	noun
liberiĝintojn	noun
liberiĝontojn	noun
liberiĝante	adverb
liberiĝinte	adverb
liberiĝonte	adverb
migris	verb
metala	adjective
iun	determiner
iun	pronoun
islama	adjective
ĝermana	adjective
rifuĝi	verb
jc.	noun
aŭdaci	verb
kraŝi	verb
obei	verb
obeis	verb
translokigi	verb
translokigas	verb
translokigis	verb
translokigos	verb
translokigus	verb
translokigu	verb
translokiganta	adjective
translokiginta	adjective
translokigonta	adjective
translokigantaj	adjective
translokigintaj	adjective
translokigontaj	adjective
translokigantan	adjective
translokigintan	adjective
translokigontan	adjective
translokigantajn	adjective
translokigintajn	adjective
translokigontajn	adjective
translokiganto	noun
translokiginto	noun
translokigonto	noun
translokigantoj	noun
translokigintoj	noun
translokigontoj	noun
translokiganton	noun
translokiginton	noun
translokigonton	noun
translokigantojn	noun
translokigintojn	noun
translokigontojn	noun
translokigante	adverb
translokiginte	adverb
translokigonte	adverb
translokiĝas	verb
translokiĝis	verb
translokiĝos	verb
translokiĝus	verb
translokiĝu	verb
translokiĝanta	adjective
translokiĝinta	adjective
translokiĝonta	adjective
translokiĝantaj	adjective
translokiĝintaj	adjective
translokiĝontaj	adjective
translokiĝantan	adjective
translokiĝintan	adjective
translokiĝontan	adjective
translokiĝantajn	adjective
translokiĝintajn	adjective
translokiĝontajn	adjective
translokiĝanto	noun
translokiĝinto	noun
translokiĝonto	noun
translokiĝantoj	noun
translokiĝintoj	noun
translokiĝontoj	noun
translokiĝanton	noun
translokiĝinton	noun
translokiĝonton	noun
translokiĝantojn	noun
translokiĝintojn	noun
translokiĝontojn	noun
translokiĝante	adverb
translokiĝinte	adverb
translokiĝonte	adverb
ĉifrado	noun
bazi	verb
bazis	verb
bazu	verb
kalkulado	noun
okuma	adjective
ĉifri	verb
kaŝa	adjective
solvita	adjective
ĉifras	verb
ĉifris	verb
ĉifrante	adverb
ĉifrata	adjective
ĉifrato	noun
ĉifrate	adverb
jeno	noun
marki	verb
markas	verb
markus	verb
proksimigi	verb
procesu	verb
kaŝan	adjective
rimeno	noun
servu	verb
detale	adverb
metio	noun
proporcion	noun
distingis	verb
senĝene	adverb
konigi	verb
guŝo	noun
komika	adjective
adjektive	adverb
matematike	adverb
fantazia	adjective
kanibalismo	noun
nazion	noun
idisto	noun
ekskludi	verb
etiĝi	verb
ĉiaj	determiner
brosi	verb
skorpio	noun
forĝi	verb
longigi	verb
longon	noun
lamon	noun
aŭtismo	noun
centralo	noun
restaŭri	verb
restaŭras	verb
restaŭris	verb
restaŭranto	noun
restaŭrante	adverb
restaŭrata	adjective
restaŭrato	noun
restaŭrate	adverb
petu	verb
petita	adjective
situis	verb
kuniĝi	verb
kuniĝas	verb
kuniĝis	verb
kuniĝos	verb
kuniĝus	verb
kuniĝu	verb
kuniĝanta	adjective
kuniĝinta	adjective
kuniĝonta	adjective
kuniĝantaj	adjective
kuniĝintaj	adjective
kuniĝontaj	adjective
kuniĝantan	adjective
kuniĝintan	adjective
kuniĝontan	adjective
kuniĝantajn	adjective
kuniĝintajn	adjective
kuniĝontajn	adjective
kuniĝanto	noun
kuniĝinto	noun
kuniĝonto	noun
kuniĝantoj	noun
kuniĝintoj	noun
kuniĝontoj	noun
kuniĝanton	noun
kuniĝinton	noun
kuniĝonton	noun
kuniĝantojn	noun
kuniĝintojn	noun
kuniĝontojn	noun
kuniĝante	adverb
kuniĝinte	adverb
kuniĝonte	adverb
didon	noun
dume	adverb
marŝo	noun
marŝon	noun
sablan	adjective
saĝulo	noun
eld.	noun
judaismo	noun
laŭdus	verb
laŭdinto	noun
laŭdis	verb
laŭdinte	adverb
laŭdinta	adjective
laŭdas	verb
laŭdante	adverb
laŭdanta	adjective
laŭdonta	adjective
laŭdonte	adverb
laŭdos	verb
laŭdita	adjective
laŭdote	adverb
laŭdite	adverb
laŭdota	adjective
laŭdata	adjective
laŭdato	noun
laŭdito	noun
laŭdoto	noun
laŭdonto	noun
laŭdate	adverb
laŭdanto	noun
heredite	adverb
balaita	adjective
venkata	adjective
dece	adverb
drinkaĵo	noun
ekato	noun
ekita	adjective
eku	verb
komandanta	adjective
akademia	adjective
defendus	verb
defendu	verb
konfiskate	adverb
ŝtelo	noun
ŝteloj	noun
ŝtelon	noun
ŝtelojn	noun
ĉasita	adjective
ĉasate	adverb
ĉasata	adjective
ĉasato	noun
ĉasota	adjective
vomu	verb
ĉerpu	verb
abandonante	adverb
evitis	verb
baros	verb
ĉaso	noun
ĉason	noun
dinosaŭro	noun
denaskulo	noun
denaskuloj	noun
ŝalti	verb
ŝaltas	verb
ŝaltis	verb
ŝaltos	verb
ŝaltus	verb
ŝaltu	verb
ŝaltanta	adjective
ŝaltinta	adjective
ŝaltonta	adjective
ŝaltantaj	adjective
ŝaltintaj	adjective
ŝaltontaj	adjective
ŝaltantan	adjective
ŝaltintan	adjective
ŝaltontan	adjective
ŝaltantajn	adjective
ŝaltintajn	adjective
ŝaltontajn	adjective
ŝaltanto	noun
ŝaltinto	noun
ŝaltonto	noun
ŝaltantoj	noun
ŝaltintoj	noun
ŝaltontoj	noun
ŝaltanton	noun
ŝaltinton	noun
ŝaltonton	noun
ŝaltantojn	noun
ŝaltintojn	noun
ŝaltontojn	noun
ŝaltante	adverb
ŝaltinte	adverb
ŝaltonte	adverb
ŝaltata	adjective
ŝaltita	adjective
ŝaltato	noun
ŝaltito	noun
ŝaltate	adverb
ŝaltite	adverb
eblis	verb
refuti	verb
blago	noun
ĉioj	pronoun
ĉion	pronoun
maĉi	verb
ĉian	determiner
ĉian	adverb
ĉiajn	determiner
intimus	verb
intimos	verb
relegas	verb
miela	adjective
supron	noun
simbola	adjective
premiu	verb
humida	adjective
ironias	verb
meloj	noun
protestis	verb
kashi	verb
reiras	verb
reiros	verb
ŝuti	verb
ŝutas	verb
ŝutis	verb
ŝutos	verb
ŝutus	verb
ŝutu	verb
ŝutata	adjective
kernan	adjective
jena	adjective
penon	noun
humero	noun
puŝis	verb
puŝos	verb
puŝus	verb
puŝu	verb
puŝata	adjective
egan	adjective
ĝermanaj	adjective
ĝermanan	adjective
ĝermanajn	adjective
deliris	verb
irido	noun
egiĝi	verb
egigi	verb
frostigi	verb
eliro	noun
eliron	noun
matene	adverb
severan	adjective
egale	adverb
vidiĝi	verb
toleri	verb
toleris	verb
tolerus	verb
venos	verb
flamigas	verb
flamigis	verb
flamigos	verb
flamigus	verb
flamigu	verb
flamiganta	adjective
flamiginta	adjective
flamigonta	adjective
flamigantaj	adjective
flamigintaj	adjective
flamigontaj	adjective
flamigantan	adjective
flamigintan	adjective
flamigontan	adjective
flamigantajn	adjective
flamigintajn	adjective
flamigontajn	adjective
flamiganto	noun
flamiginto	noun
flamigonto	noun
flamigantoj	noun
flamigintoj	noun
flamigontoj	noun
flamiganton	noun
flamiginton	noun
flamigonton	noun
flamigantojn	noun
flamigintojn	noun
flamigontojn	noun
flamigante	adverb
flamiginte	adverb
flamigonte	adverb
flamiĝas	verb
flamiĝis	verb
flamiĝos	verb
flamiĝus	verb
flamiĝu	verb
flamiĝanta	adjective
flamiĝinta	adjective
flamiĝonta	adjective
flamiĝantaj	adjective
flamiĝintaj	adjective
flamiĝontaj	adjective
flamiĝantan	adjective
flamiĝintan	adjective
flamiĝontan	adjective
flamiĝantajn	adjective
flamiĝintajn	adjective
flamiĝontajn	adjective
flamiĝanto	noun
flamiĝinto	noun
flamiĝonto	noun
flamiĝantoj	noun
flamiĝintoj	noun
flamiĝontoj	noun
flamiĝanton	noun
flamiĝinton	noun
flamiĝonton	noun
flamiĝantojn	noun
flamiĝintojn	noun
flamiĝontojn	noun
flamiĝante	adverb
flamiĝinte	adverb
flamiĝonte	adverb
fumu	verb
gustanta	adjective
gustinta	adjective
gustonta	adjective
gustantaj	adjective
gustintaj	adjective
gustontaj	adjective
gustantan	adjective
gustintan	adjective
gustontan	adjective
gustantajn	adjective
gustintajn	adjective
gustontajn	adjective
gustinto	noun
gustonto	noun
gustantoj	noun
gustintoj	noun
gustontoj	noun
gustanton	noun
gustinton	noun
gustonton	noun
gustantojn	noun
gustintojn	noun
gustontojn	noun
gustinte	adverb
gustonte	adverb
juĝas	verb
juĝis	verb
juĝos	verb
juĝus	verb
juĝu	verb
juĝanto	noun
juĝante	adverb
juĝata	adjective
juĝato	noun
juĝate	adverb
loganta	adjective
loginta	adjective
logonta	adjective
logantaj	adjective
logintaj	adjective
logontaj	adjective
logantan	adjective
logintan	adjective
logontan	adjective
logantajn	adjective
logintajn	adjective
logontajn	adjective
loganto	noun
loginto	noun
logonto	noun
logantoj	noun
logintoj	noun
logontoj	noun
loganton	noun
loginton	noun
logonton	noun
logantojn	noun
logintojn	noun
logontojn	noun
logante	adverb
loginte	adverb
logonte	adverb
logata	adjective
logita	adjective
logota	adjective
logataj	adjective
logitaj	adjective
logotaj	adjective
logatan	adjective
logitan	adjective
logotan	adjective
logatajn	adjective
logitajn	adjective
logotajn	adjective
logato	noun
logito	noun
logoto	noun
logatoj	noun
logitoj	noun
logotoj	noun
logaton	noun
logiton	noun
logoton	noun
logatojn	noun
logitojn	noun
logotojn	noun
logate	adverb
logite	adverb
logote	adverb
loĝas	verb
loĝis	verb
loĝos	verb
loĝus	verb
loĝu	verb
loĝanta	adjective
loĝinta	adjective
loĝonta	adjective
loĝantaj	adjective
loĝintaj	adjective
loĝontaj	adjective
loĝantan	adjective
loĝintan	adjective
loĝontan	adjective
loĝantajn	adjective
loĝintajn	adjective
loĝontajn	adjective
loĝinto	noun
loĝonto	noun
loĝintoj	noun
loĝontoj	noun
loĝinton	noun
loĝonton	noun
loĝintojn	noun
loĝontojn	noun
loĝante	adverb
loĝinte	adverb
loĝonte	adverb
mastros	verb
paraŝutu	verb
pasis	verb
pasu	verb
pasanta	adjective
pasinta	adjective
pasonta	adjective
pasantaj	adjective
pasintaj	adjective
pasontaj	adjective
pasantan	adjective
pasintan	adjective
pasontan	adjective
pasantajn	adjective
pasintajn	adjective
pasontajn	adjective
pasanto	noun
pasinto	noun
pasonto	noun
pasantoj	noun
pasintoj	noun
pasontoj	noun
pasanton	noun
pasinton	noun
pasonton	noun
pasantojn	noun
pasintojn	noun
pasontojn	noun
pasante	adverb
pasinte	adverb
pasonte	adverb
pasata	adjective
pasita	adjective
pasota	adjective
pasataj	adjective
pasitaj	adjective
pasotaj	adjective
pasatan	adjective
pasitan	adjective
pasotan	adjective
pasatajn	adjective
pasitajn	adjective
pasotajn	adjective
pasato	noun
pasito	noun
pasoto	noun
pasatoj	noun
pasitoj	noun
pasotoj	noun
pasaton	noun
pasiton	noun
pasoton	noun
pasatojn	noun
pasitojn	noun
pasotojn	noun
pasate	adverb
pasite	adverb
pasote	adverb
proksimiĝas	verb
proksimiĝis	verb
proksimiĝos	verb
proksimiĝus	verb
proksimiĝu	verb
proksimiĝanta	adjective
proksimiĝinta	adjective
proksimiĝonta	adjective
proksimiĝantaj	adjective
proksimiĝintaj	adjective
proksimiĝontaj	adjective
proksimiĝantan	adjective
proksimiĝintan	adjective
proksimiĝontan	adjective
proksimiĝantajn	adjective
proksimiĝintajn	adjective
proksimiĝontajn	adjective
proksimiĝanto	noun
proksimiĝinto	noun
proksimiĝonto	noun
proksimiĝantoj	noun
proksimiĝintoj	noun
proksimiĝontoj	noun
proksimiĝanton	noun
proksimiĝinton	noun
proksimiĝonton	noun
proksimiĝantojn	noun
proksimiĝintojn	noun
proksimiĝontojn	noun
proksimiĝante	adverb
proksimiĝinte	adverb
proksimiĝonte	adverb
promesos	verb
sanginta	adjective
sangonta	adjective
sangintaj	adjective
sangontaj	adjective
sangintan	adjective
sangontan	adjective
sangintajn	adjective
sangontajn	adjective
sanganto	noun
sanginto	noun
sangonto	noun
sangantoj	noun
sangintoj	noun
sangontoj	noun
sanganton	noun
sanginton	noun
sangonton	noun
sangantojn	noun
sangintojn	noun
sangontojn	noun
sangante	adverb
sanginte	adverb
sangonte	adverb
saniĝas	verb
saniĝis	verb
saniĝos	verb
saniĝus	verb
saniĝu	verb
saniĝanta	adjective
saniĝinta	adjective
saniĝonta	adjective
saniĝantaj	adjective
saniĝintaj	adjective
saniĝontaj	adjective
saniĝantan	adjective
saniĝintan	adjective
saniĝontan	adjective
saniĝantajn	adjective
saniĝintajn	adjective
saniĝontajn	adjective
saniĝanto	noun
saniĝinto	noun
saniĝonto	noun
saniĝantoj	noun
saniĝintoj	noun
saniĝontoj	noun
saniĝanton	noun
saniĝinton	noun
saniĝonton	noun
saniĝantojn	noun
saniĝintojn	noun
saniĝontojn	noun
saniĝante	adverb
saniĝinte	adverb
saniĝonte	adverb
stariganta	adjective
stariginta	adjective
starigonta	adjective
starigantaj	adjective
starigintaj	adjective
starigontaj	adjective
starigantan	adjective
starigintan	adjective
starigontan	adjective
starigantajn	adjective
starigintajn	adjective
starigontajn	adjective
stariganto	noun
stariginto	noun
starigonto	noun
starigantoj	noun
starigintoj	noun
starigontoj	noun
stariganton	noun
stariginton	noun
starigonton	noun
starigantojn	noun
starigintojn	noun
starigontojn	noun
starigante	adverb
stariginte	adverb
starigonte	adverb
strikis	verb
venenu	verb
ĥaose	adverb
muzike	adverb
laŭdinda	adjective
administracio	noun
administracion	noun
sindromo	noun
emocio	noun
eritrean	adjective
ĵaza	adjective
aglutina	adjective
revolucio	noun
revolucion	noun
referencas	verb
modon	noun
poligloto	noun
restaĵo	noun
satanan	adjective
dungon	noun
foreston	noun
edukado	noun
idaro	noun
maltrankviligi	verb
alaska	adjective
alaskan	adjective
ĉasado	noun
homofono	noun
pesinta	adjective
iĝintojn	noun
iĝantajn	adjective
iĝontaj	adjective
iĝontan	adjective
iĝintajn	adjective
iĝante	adverb
iĝinto	noun
iĝanta	adjective
iĝinte	adverb
iĝanto	noun
iĝontoj	noun
iĝontajn	adjective
iĝonton	noun
iĝintaj	adjective
iĝintan	adjective
iĝontojn	noun
iĝantoj	noun
iĝanton	noun
iĝinta	adjective
iĝintoj	noun
iĝonto	noun
iĝinton	noun
iĝonta	adjective
iĝantaj	adjective
iĝantojn	noun
iĝonte	adverb
iĝantan	adjective
punu	verb
ĉarpentis	verb
cedante	adverb
ŝajnos	verb
trankviligintajn	adjective
trankviligintojn	noun
trankviligis	verb
trankviligos	verb
trankviligontaj	adjective
trankviligontan	adjective
trankviligas	verb
trankviligontojn	noun
trankviligonta	adjective
trankviligonte	adverb
trankviligonton	noun
trankviligontoj	noun
trankviligonto	noun
trankviliginta	adjective
trankviligantajn	adjective
trankviliginte	adverb
trankviliganto	noun
trankviligintaj	adjective
trankviliganta	adjective
trankviligintan	adjective
trankviligante	adverb
trankviliginto	noun
trankviligus	verb
trankviliginton	noun
trankviligintoj	noun
trankviligontajn	adjective
trankviligu	verb
trankviligantojn	noun
trankviligantaj	adjective
trankviligantan	adjective
trankviliganton	noun
trankviligantoj	noun
trankviliĝu	verb
trankviliĝantajn	adjective
trankviliĝantoj	noun
trankviliĝonte	adverb
trankviliĝanton	noun
trankviliĝintoj	noun
trankviliĝinton	noun
trankviliĝis	verb
trankviliĝontojn	noun
trankviliĝintan	adjective
trankviliĝintaj	adjective
trankviliĝanto	noun
trankviliĝantan	adjective
trankviliĝintojn	noun
trankviliĝantaj	adjective
trankviliĝos	verb
trankviliĝante	adverb
trankviliĝas	verb
trankviliĝanta	adjective
trankviliĝontoj	noun
trankviliĝinte	adverb
trankviliĝonton	noun
trankviliĝinta	adjective
trankviliĝinto	noun
trankviliĝintajn	adjective
trankviliĝontajn	adjective
trankviliĝonto	noun
trankviliĝontan	adjective
trankviliĝus	verb
trankviliĝantojn	noun
trankviliĝontaj	adjective
trankviliĝonta	adjective
terorismo	noun
penu	verb
nuran	adjective
stariĝintan	adjective
stariĝintaj	adjective
stariĝanton	noun
stariĝantoj	noun
stariĝontojn	noun
stariĝantojn	noun
stariĝonte	adverb
stariĝantan	adjective
stariĝonta	adjective
stariĝantaj	adjective
stariĝonto	noun
stariĝinton	noun
stariĝontajn	adjective
stariĝintojn	noun
stariĝontan	adjective
stariĝontaj	adjective
stariĝantajn	adjective
stariĝintajn	adjective
stariĝintoj	noun
stariĝinta	adjective
stariĝonton	noun
stariĝinte	adverb
stariĝanto	noun
stariĝontoj	noun
stariĝanta	adjective
stariĝante	adverb
stariĝinto	noun
refaras	verb
alklimatigu	verb
alklimatigas	verb
alklimatigos	verb
alklimatigis	verb
alklimatigus	verb
aludis	verb
amorata	adjective
amorato	noun
amorate	adverb
amorite	adverb
aplaŭdis	verb
aplaŭdas	verb
armu	verb
banata	adjective
banita	adjective
banato	noun
banate	adverb
baraton	noun
baras	verb
baranta	adjective
barus	verb
duŝite	adverb
egigas	verb
egigu	verb
egiganton	noun
egigonto	noun
egigantoj	noun
egigonta	adjective
egigintan	adjective
egigantajn	adjective
egigintaj	adjective
egigintajn	adjective
egigis	verb
egigos	verb
egigantojn	noun
egigonton	noun
egigonte	adverb
egigontoj	noun
egigintojn	noun
egigus	verb
egigante	adverb
egigontan	adjective
egiginto	noun
egiganta	adjective
egigontaj	adjective
egiginte	adverb
egiganto	noun
egiginta	adjective
egigontojn	noun
egiginton	noun
egigintoj	noun
egigontajn	adjective
egigantan	adjective
egigantaj	adjective
egiĝintan	adjective
egiĝintaj	adjective
egiĝanton	noun
egiĝantoj	noun
egiĝinte	adverb
egiĝontojn	noun
egiĝantan	adjective
egiĝantaj	adjective
egiĝanta	adjective
egiĝinto	noun
egiĝante	adverb
egiĝus	verb
egiĝinta	adjective
egiĝanto	noun
egiĝintojn	noun
egiĝontajn	adjective
egiĝintajn	adjective
egiĝontan	adjective
egiĝontaj	adjective
egiĝas	verb
egiĝantajn	adjective
egiĝonton	noun
egiĝu	verb
egiĝontoj	noun
egiĝonto	noun
egiĝinton	noun
egiĝintoj	noun
egiĝonte	adverb
egiĝonta	adjective
egiĝantojn	noun
egiĝos	verb
egiĝis	verb
eliras	verb
estiĝintajn	adjective
estiĝonton	noun
estiĝinta	adjective
estiĝanto	noun
estiĝontoj	noun
estiĝinte	adverb
estiĝanta	adjective
estiĝinto	noun
estiĝontajn	adjective
estiĝintan	adjective
estiĝintaj	adjective
estiĝanton	noun
estiĝontojn	noun
estiĝantoj	noun
estiĝante	adverb
estiĝonte	adverb
estiĝantan	adjective
estiĝonta	adjective
estiĝantaj	adjective
estiĝinton	noun
estiĝonto	noun
estiĝintoj	noun
estiĝantojn	noun
estiĝintojn	noun
estiĝontan	adjective
estiĝantajn	adjective
estiĝontaj	adjective
etigontoj	noun
etigonto	noun
etigontojn	noun
etigonton	noun
etigintojn	noun
etigonte	adverb
etigonta	adjective
etigantoj	noun
etiginto	noun
etigante	adverb
etiganton	noun
etiganta	adjective
etiganto	noun
etiginte	adverb
etigu	verb
etiginta	adjective
etigontan	adjective
etigontaj	adjective
etigus	verb
etigantajn	adjective
etigontajn	adjective
etigas	verb
etigintan	adjective
etigintaj	adjective
etigintoj	noun
etigintajn	adjective
etiginton	noun
etigantojn	noun
etigos	verb
etigis	verb
etigantan	adjective
etigantaj	adjective
etiĝontaj	adjective
etiĝonta	adjective
etiĝontajn	adjective
etiĝontan	adjective
etiĝonte	adverb
etiĝantaj	adjective
etiĝantojn	noun
etiĝinto	noun
etiĝantan	adjective
etiĝonto	noun
etiĝas	verb
etiĝintaj	adjective
etiĝintan	adjective
etiĝis	verb
etiĝinta	adjective
etiĝintajn	adjective
etiĝinte	adverb
etiĝos	verb
etiĝantajn	adjective
etiĝonton	noun
etiĝontoj	noun
etiĝanta	adjective
etiĝante	adverb
etiĝanto	noun
etiĝintojn	noun
etiĝontojn	noun
etiĝus	verb
etiĝantoj	noun
etiĝanton	noun
etiĝu	verb
etiĝinton	noun
etiĝintoj	noun
eĥu	verb
eĥonte	adverb
freŝante	adverb
freŝata	adjective
freŝato	noun
freŝate	adverb
freŝita	adjective
havite	adverb
havita	adjective
kaŝata	adjective
kaŝite	adverb
kaŝus	verb
kaŝu	verb
kaŝis	verb
kaŝos	verb
kuŝas	verb
kuŝu	verb
longigantajn	adjective
longigontoj	noun
longigantoj	noun
longigontojn	noun
longigonte	adverb
longigonton	noun
longiganton	noun
longigantaj	adjective
longigantan	adjective
longigontajn	adjective
longigontaj	adjective
longigus	verb
longigintojn	noun
longigontan	adjective
longiginto	noun
longigu	verb
longigis	verb
longiginte	adverb
longigonto	noun
longigintajn	adjective
longiginta	adjective
longigos	verb
longigintaj	adjective
longiganta	adjective
longigintan	adjective
longigantojn	noun
longigonta	adjective
longiginton	noun
longigas	verb
longigante	adverb
longigintoj	noun
longiganto	noun
malsatintajn	adjective
malsatontoj	noun
malsatonton	noun
malsatontaj	adjective
malsatontan	adjective
malsatanta	adjective
malsatintaj	adjective
malsatintan	adjective
malsatintojn	noun
malsatintoj	noun
malsatantojn	noun
malsatinton	noun
malsatanto	noun
malsatante	adverb
malsatontajn	adjective
malsatantajn	adjective
malsatinte	adverb
malsatantaj	adjective
malsatinta	adjective
malsatantan	adjective
malsatantoj	noun
malsatinto	noun
malsatanton	noun
malsatonta	adjective
malsatonte	adverb
malsatontojn	noun
malsatonto	noun
manipulite	adverb
mankos	verb
mankus	verb
mankas	verb
mendota	adjective
oferis	verb
pagotan	adjective
pagota	adjective
preĝate	adverb
preĝata	adjective
preĝato	noun
preĝante	adverb
proksimigos	verb
proksimiganto	noun
proksimigontajn	adjective
proksimigantoj	noun
proksimigas	verb
proksimiganta	adjective
proksimiganton	noun
proksimigintoj	noun
proksimigintajn	adjective
proksimiginton	noun
proksimigintan	adjective
proksimigintaj	adjective
proksimigantan	adjective
proksimigantaj	adjective
proksimigante	adverb
proksimigantojn	noun
proksimigu	verb
proksimigonto	noun
proksimigontoj	noun
proksimigontojn	noun
proksimigonton	noun
proksimigonte	adverb
proksimigonta	adjective
proksimigantajn	adjective
proksimiginte	adverb
proksimiginta	adjective
proksimigontan	adjective
proksimiginto	noun
proksimigontaj	adjective
proksimigus	verb
proksimigis	verb
proksimigintojn	noun
razota	adjective
razoto	noun
reĝanto	noun
salatan	adjective
salos	verb
saniganton	noun
sanigonte	adverb
sanigantoj	noun
sanigonta	adjective
sanigonto	noun
sanigontajn	adjective
sanigintojn	noun
sanigontojn	noun
sanigantan	adjective
sanigantaj	adjective
saniginton	noun
sanigintoj	noun
sanigintan	adjective
sanigintaj	adjective
sanigontan	adjective
saniginta	adjective
sanigontaj	adjective
saniganto	noun
saniginte	adverb
saniganta	adjective
saniginto	noun
sanigantojn	noun
sanigante	adverb
sanigantajn	adjective
sanigonton	noun
sanigontoj	noun
sanigintajn	adjective
satontajn	adjective
satinton	noun
satonto	noun
satintoj	noun
satonte	adverb
satantan	adjective
satintajn	adjective
satantaj	adjective
satontan	adjective
satontaj	adjective
satonta	adjective
satintojn	noun
satinte	adverb
satantojn	noun
satanta	adjective
satinto	noun
satante	adverb
satonton	noun
satinta	adjective
satanto	noun
satontoj	noun
satantajn	adjective
satontojn	noun
satanton	noun
satantoj	noun
satintan	adjective
satintaj	adjective
sciota	adjective
scioto	noun
kataro	noun
kataro	noun
suĉinto	noun
suĉite	adverb
suĉinta	adjective
suĉate	adverb
suĉitan	adjective
suĉato	noun
suĉante	adverb
suĉote	adverb
suĉito	noun
suĉota	adjective
suĉita	adjective
suĉata	adjective
unuiĝinton	noun
unuiĝintoj	noun
unuiĝus	verb
unuiĝantan	adjective
unuiĝantaj	adjective
unuiĝis	verb
unuiĝos	verb
unuiĝu	verb
unuiĝontajn	adjective
unuiĝanton	noun
unuiĝantoj	noun
unuiĝinte	adverb
unuiĝanto	noun
unuiĝante	adverb
unuiĝinto	noun
unuiĝanta	adjective
unuiĝontojn	noun
unuiĝas	verb
unuiĝintojn	noun
unuiĝonton	noun
unuiĝontoj	noun
unuiĝantojn	noun
unuiĝontan	adjective
unuiĝontaj	adjective
unuiĝonta	adjective
unuiĝonte	adverb
unuiĝonto	noun
unuiĝantajn	adjective
pligrandigi	verb
gratulis	verb
gratulo	noun
aglomero	noun
aglomeri	verb
pligrandigintan	adjective
pligrandigintaj	adjective
pligrandigintojn	noun
pligrandigis	verb
pligrandigu	verb
pligrandigante	adverb
pligrandigontajn	adjective
pligrandigintajn	adjective
pligrandigontan	adjective
pligrandigus	verb
pligrandigontaj	adjective
pligrandigontojn	noun
pligrandigantojn	noun
pligrandiganta	adjective
pligrandiganto	noun
pligrandigonte	adverb
pligrandigas	verb
pligrandigontoj	noun
pligrandigonto	noun
pligrandigonton	noun
pligrandiginto	noun
pligrandigintoj	noun
pligrandiginte	adverb
pligrandiginton	noun
pligrandigantajn	adjective
pligrandiginta	adjective
pligrandigantoj	noun
pligrandiganton	noun
pligrandigantan	adjective
pligrandigos	verb
pligrandigantaj	adjective
pligrandigonta	adjective
pekus	verb
peku	verb
alproksimigito	noun
alproksimiginta	adjective
alproksimiganto	noun
alproksimiginte	adverb
alproksimigitan	adjective
alproksimiganta	adjective
alproksimiginto	noun
alproksimigante	adverb
alproksimigas	verb
alproksimigiton	noun
alproksimigintajn	adjective
alproksimigotan	adjective
alproksimigotaj	adjective
alproksimigontan	adjective
alproksimigato	noun
alproksimigantojn	noun
alproksimigontaj	adjective
alproksimigoton	noun
alproksimigitoj	noun
alproksimigite	adverb
alproksimigatan	adjective
alproksimigonton	noun
alproksimigaton	noun
alproksimigataj	adjective
alproksimigontoj	noun
alproksimigintojn	noun
alproksimigitaj	adjective
alproksimigita	adjective
alproksimigotoj	noun
alproksimigonte	adverb
alproksimigonta	adjective
alproksimigonto	noun
alproksimigantajn	adjective
alproksimigotajn	adjective
alproksimigontojn	noun
alproksimigatajn	adjective
alproksimigitajn	adjective
alproksimigatojn	noun
alproksimigintan	adjective
alproksimigintaj	adjective
alproksimiganton	noun
alproksimigotojn	noun
alproksimigontajn	adjective
alproksimigantoj	noun
alproksimigitojn	noun
alproksimigatoj	noun
alproksimigus	verb
alproksimigota	adjective
alproksimigantan	adjective
alproksimigote	adverb
alproksimigoto	noun
alproksimigantaj	adjective
alproksimiginton	noun
alproksimigis	verb
alproksimigate	adverb
alproksimigintoj	noun
alproksimigu	verb
alproksimigata	adjective
alproksimigos	verb
alproksimiĝonta	adjective
alproksimiĝonte	adverb
alproksimiĝotan	adjective
alproksimiĝonto	noun
alproksimiĝoto	noun
alproksimiĝatan	adjective
alproksimiĝotoj	noun
alproksimiĝontajn	adjective
alproksimiĝas	verb
alproksimiĝato	noun
alproksimiĝanton	noun
alproksimiĝitan	adjective
alproksimiĝoton	noun
alproksimiĝantoj	noun
alproksimiĝitaj	adjective
alproksimiĝintan	adjective
alproksimiĝatojn	noun
alproksimiĝintaj	adjective
alproksimiĝataj	adjective
alproksimiĝiton	noun
alproksimiĝinton	noun
alproksimiĝintojn	noun
alproksimiĝitoj	noun
alproksimiĝintoj	noun
alproksimiĝaton	noun
alproksimiĝantan	adjective
alproksimiĝite	adverb
alproksimiĝontojn	noun
alproksimiĝantaj	adjective
alproksimiĝinte	adverb
alproksimiĝanto	noun
alproksimiĝinta	adjective
alproksimiĝante	adverb
alproksimiĝinto	noun
alproksimiĝanta	adjective
alproksimiĝitajn	adjective
alproksimiĝu	verb
alproksimiĝitojn	noun
alproksimiĝata	adjective
alproksimiĝantojn	noun
alproksimiĝontan	adjective
alproksimiĝus	verb
alproksimiĝotajn	adjective
alproksimiĝontaj	adjective
alproksimiĝintajn	adjective
alproksimiĝotojn	noun
alproksimiĝatajn	adjective
alproksimiĝate	adverb
alproksimiĝotaj	adjective
alproksimiĝita	adjective
alproksimiĝote	adverb
alproksimiĝatoj	noun
alproksimiĝota	adjective
alproksimiĝonton	noun
alproksimiĝos	verb
alproksimiĝantajn	adjective
alproksimiĝontoj	noun
alproksimiĝito	noun
alproksimiĝis	verb
brodis	verb
brodata	adjective
brunigus	verb
brunigas	verb
brunigos	verb
brunigu	verb
buĉotaj	adjective
buĉate	adverb
buĉato	noun
buĉito	noun
buĉos	verb
buĉu	verb
buĉas	verb
buĉota	adjective
buĉante	adverb
buĉata	adjective
buĉoto	noun
buĉita	adjective
celebros	verb
celebrite	adverb
decu	verb
decos	verb
decis	verb
deĉifras	verb
deĉifrato	noun
deĉifrate	adverb
deĉifrata	adjective
deĉifrante	adverb
aviados	verb
aŭdacas	verb
aŭdacos	verb
aŭdacus	verb
aŭdacis	verb
benite	adverb
benita	adjective
benito	noun
benos	verb
benus	verb
degradis	verb
bojis	verb
boju	verb
borderos	verb
bredis	verb
bredu	verb
dependus	verb
dependu	verb
dependis	verb
dependante	adverb
devante	adverb
diferencas	verb
digestate	adverb
disiĝantojn	noun
disiĝantoj	noun
disiĝus	verb
disiĝanton	noun
disiĝanto	noun
disiĝontajn	adjective
disiĝontojn	noun
disiĝantan	adjective
disiĝantajn	adjective
disiĝintaj	adjective
disiĝonte	adverb
disiĝintan	adjective
disiĝintoj	noun
disiĝinton	noun
disiĝonton	noun
disiĝinto	noun
disiĝis	verb
disiĝinte	adverb
disiĝintajn	adjective
disiĝinta	adjective
disiĝos	verb
disiĝanta	adjective
disiĝonta	adjective
disiĝas	verb
disiĝante	adverb
disiĝontoj	noun
disiĝu	verb
disiĝontaj	adjective
disiĝintojn	noun
disiĝonto	noun
disiĝantaj	adjective
disiĝontan	adjective
volvos	verb
vivu	verb
vivu	interjection
vadu	verb
unuigontojn	noun
unuigantan	adjective
unuigantaj	adjective
unuiginton	noun
unuigintoj	noun
unuigintan	adjective
unuigante	adverb
unuigintaj	adjective
unuigontan	adjective
unuiginta	adjective
unuigontaj	adjective
unuiganto	noun
unuiginte	adverb
unuiganta	adjective
unuiginto	noun
unuigantojn	noun
unuigantajn	adjective
unuigonton	noun
unuigontoj	noun
unuigintajn	adjective
unuiganton	noun
unuigonte	adverb
unuigantoj	noun
unuigonta	adjective
unuigonto	noun
unuigontajn	adjective
unuigintojn	noun
turninto	noun
tretis	verb
tretos	verb
transformis	verb
tegos	verb
sinteze	adverb
kosma	adjective
kosman	adjective
malaj	adjective
malon	noun
kompozicio	noun
segu	verb
segito	noun
segas	verb
egalas	verb
ekskludas	verb
ekskludis	verb
eksplikas	verb
eksplikos	verb
eksplikis	verb
eksplikus	verb
emanta	adjective
ĵulo	noun
ĵulon	noun
ĵeto	noun
ĵetoj	noun
ĵeton	noun
ĵetojn	noun
kreskiĝi	verb
kulto	noun
abnegacion	noun
gramofono	noun
lacho	noun
despoto	noun
kreskiĝantoj	noun
kreskiĝanton	noun
kreskiĝontajn	adjective
kreskiĝintaj	adjective
kreskiĝintan	adjective
kreskiĝu	verb
kreskiĝintoj	noun
kreskiĝinton	noun
kreskiĝas	verb
kreskiĝinto	noun
kreskiĝontoj	noun
kreskiĝante	adverb
kreskiĝonton	noun
kreskiĝanta	adjective
kreskiĝantajn	adjective
kreskiĝinte	adverb
kreskiĝinta	adjective
kreskiĝos	verb
kreskiĝis	verb
kreskiĝontojn	noun
kreskiĝontaj	adjective
kreskiĝontan	adjective
kreskiĝantojn	noun
kreskiĝintojn	noun
kreskiĝantaj	adjective
kreskiĝantan	adjective
kreskiĝonto	noun
kreskiĝonta	adjective
kreskiĝonte	adverb
kreskiĝus	verb
kreskiĝanto	noun
kreskiĝintajn	adjective
establis	verb
establu	verb
estigontojn	noun
estiganton	noun
estigantoj	noun
estigintan	adjective
estigintaj	adjective
estigis	verb
estigos	verb
estigontajn	adjective
estigantajn	adjective
estiginton	noun
estigonta	adjective
estigintoj	noun
estigonte	adverb
estigantan	adjective
estigantaj	adjective
estigonto	noun
estigintajn	adjective
estigu	verb
estigontan	adjective
estigas	verb
estigontaj	adjective
estigintojn	noun
estigantojn	noun
estiginte	adverb
estiganto	noun
estiginta	adjective
estigus	verb
estigonton	noun
estigante	adverb
estiginto	noun
estigontoj	noun
estiganta	adjective
etendis	verb
etendu	verb
etendus	verb
fieros	verb
fieris	verb
filozofus	verb
urĝa	adjective
urĝe	adverb
urĝi	verb
urĝis	verb
pendos	verb
flustrate	adverb
lasito	noun
lasita	adjective
lasota	adjective
fosu	verb
gladite	adverb
glitu	verb
glitus	verb
glitas	verb
glitos	verb
grimpis	verb
imagos	verb
importis	verb
delegacio	noun
delegacion	noun
aromo	noun
malĝojigi	verb
ariĝi	verb
aŭtokratia	adjective
ajxo	noun
igxi	verb
imitis	verb
malĝojigantaj	adjective
malĝojiginton	noun
malĝojiganto	noun
malĝojigintoj	noun
malĝojigonte	adverb
malĝojigante	adverb
malĝojigintan	adjective
malĝojiganta	adjective
malĝojigontoj	noun
malĝojigintaj	adjective
malĝojiginte	adverb
malĝojigantojn	noun
malĝojigu	verb
malĝojigintojn	noun
malĝojigonto	noun
malĝojiginto	noun
malĝojigas	verb
malĝojigos	verb
malĝojiganton	noun
malĝojigantoj	noun
malĝojigus	verb
malĝojigantan	adjective
malĝojigintajn	adjective
malĝojigontan	adjective
malĝojiginta	adjective
malĝojigonta	adjective
malĝojigantajn	adjective
malĝojigontaj	adjective
malĝojigontajn	adjective
malĝojigonton	noun
malĝojigontojn	noun
malĝojigis	verb
paradon	noun
ministerion	noun
mision	noun
platon	noun
fuĝi	verb
ŝerifo	noun
adapti	verb
ĵaketo	noun
ĵaketoj	noun
ĵaketon	noun
ĵaketojn	noun
pra	adjective
adaptis	verb
adaptu	verb
forsta	adjective
lifto	noun
tentoj	noun
imperialisma	adjective
deklaracio	noun
civilizacio	noun
civilizacion	noun
haĝo	noun
haĝon	noun
ĥimera	adjective
analizos	verb
analizis	verb
profesion	noun
insultis	verb
soldatigante	adverb
soldatiganta	adjective
soldatiganto	noun
soldatigas	verb
soldatigonta	adjective
soldatigontoj	noun
soldatigonto	noun
soldatigonton	noun
soldatigantojn	noun
soldatigontojn	noun
soldatiginto	noun
soldatiginte	adverb
soldatigintoj	noun
soldatigis	verb
soldatiginta	adjective
soldatiginton	noun
soldatigantoj	noun
soldatigantajn	adjective
soldatiganton	noun
soldatigantan	adjective
soldatigos	verb
soldatigantaj	adjective
soldatigintan	adjective
soldatigintaj	adjective
soldatigontajn	adjective
soldatigu	verb
soldatigintojn	noun
soldatigontan	adjective
soldatigonte	adverb
soldatigontaj	adjective
soldatigus	verb
soldatigintajn	adjective
saltantaj	adjective
saltantan	adjective
saltontan	adjective
saltontoj	noun
saltantojn	noun
saltintajn	adjective
saltanta	adjective
saltonton	noun
saltinta	adjective
saltinte	adverb
saltintojn	noun
saltinto	noun
saltintoj	noun
saltontajn	adjective
saltinton	noun
saltintaj	adjective
saltonte	adverb
saltintan	adjective
saltontojn	noun
saltonta	adjective
saltontaj	adjective
saltanton	noun
saltonto	noun
saltantoj	noun
saltantajn	adjective
rolante	adverb
ridu	verb
promenis	verb
pretos	verb
pretas	verb
pretendus	verb
pretendu	verb
pretendis	verb
pretendante	adverb
premos	verb
preferas	verb
preferinta	adjective
preferis	verb
interesate	adverb
intimita	adjective
intimite	adverb
intimu	verb
kombis	verb
lutite	adverb
lutu	verb
malsekigantaj	adjective
malsekigantan	adjective
malsekigas	verb
malsekigos	verb
malsekigintojn	noun
malsekigis	verb
malsekiganta	adjective
malsekigus	verb
malsekigante	adverb
malsekigantojn	noun
malsekiganton	noun
malsekigantoj	noun
malsekiganto	noun
malsekigonto	noun
malsekigonta	adjective
malsekigonte	adverb
malsekigonton	noun
malsekiginton	noun
malsekigintoj	noun
malsekigontajn	adjective
malsekigantajn	adjective
malsekigu	verb
malsekigontoj	noun
malsekigontaj	adjective
malsekigontojn	noun
malsekigontan	adjective
malsekiginto	noun
malsekigintaj	adjective
malsekiginta	adjective
malsekigintan	adjective
malsekiginte	adverb
malsekigintajn	adjective
meditis	verb
skandala	adjective
demonstracio	noun
nifo	noun
nifoj	noun
nifon	noun
nifojn	noun
arkitekto	noun
fumon	noun
jare	noun
aŭtografo	noun
negoci	verb
negocis	verb
raspite	verb
triangulite	adverb
burko	noun
foko	noun
pralino	noun
poplo	noun
pavon	noun
pozu	verb
pozon	noun
lozan	adjective
hoko	noun
mutacio	noun
rabas	verb
rabos	verb
rabus	verb
rabu	verb
robote	adverb
aŭtomate	adverb
aŭtomaton	noun
retiri	verb
retiris	verb
retirate	adverb
aranĝo	noun
lifton	noun
envii	verb
enviis	verb
envios	verb
barban	adjective
aŭtografio	noun
aŭtografi	verb
hermafrodito	noun
lesba	adjective
takon	noun
falsu	verb
baze	adverb
fakan	adjective
abolicio	noun
abolicion	noun
miron	noun
grandulon	noun
tuje	adverb
alklimatiĝi	verb
feliĉi	verb
feliĉiĝi	verb
malfeliĉiĝi	verb
feliĉigi	verb
malfeliĉigi	verb
pliverdiĝi	verb
malpliverdiĝi	verb
verdigi	verb
pliverdigi	verb
malpliverdigi	verb
tritonon	noun
tricio	noun
deŭterio	noun
psiĥa	adjective
pastra	adjective
pastran	adjective
jara	adjective
miaŭ	interjection
fuŝi	verb
aŭtografata	adjective
aŭtografate	adverb
aŭtografante	adverb
aŭtografato	noun
aŭtografos	verb
kremacia	adjective
larmi	verb
larman	adjective
groton	noun
vibris	verb
keran	adjective
fuŝas	verb
fuŝis	verb
fuŝos	verb
fuŝus	verb
fuŝu	verb
spesmilo	noun
ninĝo	noun
haŝo	noun
mariĥuano	noun
haŝon	noun
laux	preposition
gustaj	adjective
gustajn	adjective
mortan	adjective
postmorgaŭ	adverb
mikrofono	noun
lumigi	verb
lumigas	verb
lumigis	verb
lumigos	verb
lumigus	verb
lumigu	verb
lumiganta	adjective
lumiginta	adjective
lumigonta	adjective
lumigantaj	adjective
lumigintaj	adjective
lumigontaj	adjective
lumigantan	adjective
lumigintan	adjective
lumigontan	adjective
lumigantajn	adjective
lumigintajn	adjective
lumigontajn	adjective
lumiganto	noun
lumiginto	noun
lumigonto	noun
lumigantoj	noun
lumigintoj	noun
lumigontoj	noun
lumiganton	noun
lumiginton	noun
lumigonton	noun
lumigantojn	noun
lumigintojn	noun
lumigontojn	noun
lumigante	adverb
lumiginte	adverb
lumigonte	adverb
intence	adverb
piĝino	noun
viŝilo	noun
viŝi	verb
vilo	noun
vilon	noun
veŝto	noun
vagu	verb
urno	noun
reagoj	noun
veŝtojn	noun
veŝtoj	noun
veŝton	noun
hardu	verb
samon	noun
raspis	verb
sikan	adjective
ŝli	pronoun
cia	determiner
cilindre	adverb
mezpunkto	noun
pseŭdoscience	adverb
genian	adjective
maroka	adjective
marokan	adjective
skio	noun
ŝtala	adjective
linĉi	verb
transmigri	verb
glitumu	verb
sketis	verb
ŝtalan	adjective
transmigris	verb
aligi	verb
aliĝi	verb
manao	noun
halala	adjective
gorĝa	adjective
gorĝan	adjective
intui	verb
intuicio	noun
malama	adjective
intuicion	noun
viĉano	noun
viĉan	adjective
mikroskope	adverb
sorĉi	verb
sorĉas	verb
sorĉu	verb
aŭguro	noun
aŭguri	verb
aŭguras	verb
aŭguris	verb
aŭguros	verb
aŭgurus	verb
atenan	adjective
ĉesu	verb
ĉesas	verb
atenan	adjective
improvize	adverb
inhali	verb
inhalis	verb
rememori	verb
rememoris	verb
muĝi	verb
muĝas	verb
muĝis	verb
muĝus	verb
muĝu	verb
paralizis	verb
multu	verb
aeronaŭtika	adjective
luko	noun
novico	noun
fuĝas	verb
fuĝis	verb
fuĝos	verb
fuĝu	verb
fuĝanto	noun
fuĝante	adverb
maniko	noun
transportis	verb
transporti	verb
asociigo	noun
asociigoj	noun
asociigon	noun
asociigojn	noun
asociiĝo	noun
asociiĝoj	noun
asociiĝon	noun
asociiĝojn	noun
loĝata	adjective
loĝita	adjective
loĝota	adjective
loĝataj	adjective
loĝitaj	adjective
loĝotaj	adjective
loĝatan	adjective
loĝitan	adjective
loĝotan	adjective
loĝatajn	adjective
loĝitajn	adjective
loĝotajn	adjective
loĝato	noun
loĝito	noun
loĝoto	noun
loĝatoj	noun
loĝitoj	noun
loĝotoj	noun
loĝaton	noun
loĝiton	noun
loĝoton	noun
loĝatojn	noun
loĝitojn	noun
loĝotojn	noun
loĝate	adverb
loĝite	adverb
loĝote	adverb
ambicion	noun
mordon	noun
pepon	noun
etna	adjective
charman	adjective
tigran	adjective
kunigi	verb
psiĥologie	adverb
dueto	noun
ŝoka	adjective
ŝokan	adjective
ŝoke	adverb
burgo	noun
laŭreato	noun
gangreno	noun
ĉieo	noun
ĉiama	adjective
gasti	verb
sviso	noun
kaŝe	adverb
fablon	noun
deklinacio	noun
plaĉo	noun
plaĉojn	noun
plaĉon	noun
plaĉoj	noun
tonsuro	noun
patronate	adverb
feŭda	adjective
allogo	noun
termon	noun
kunigas	verb
kunigis	verb
kunigos	verb
kunigus	verb
kunigu	verb
kuniganta	adjective
kuniginta	adjective
kunigonta	adjective
kunigantaj	adjective
kunigintaj	adjective
kunigontaj	adjective
kunigantan	adjective
kunigintan	adjective
kunigontan	adjective
kunigantajn	adjective
kunigintajn	adjective
kunigontajn	adjective
kuniganto	noun
kuniginto	noun
kunigonto	noun
kunigantoj	noun
kunigintoj	noun
kunigontoj	noun
kuniganton	noun
kuniginton	noun
kunigonton	noun
kunigantojn	noun
kunigintojn	noun
kunigontojn	noun
kunigante	adverb
kuniginte	adverb
kunigonte	adverb
venadas	verb
kurba	adjective
gulo	noun
racio	noun
racionala	adjective
racion	noun
rasaj	adjective
paralele	adverb
vidigi	verb
kuŝigi	verb
tion	pronoun
tuberon	noun
ciaj	adjective
ciajn	adjective
generacion	noun
profete	adverb
pekli	verb
fraŭdo	noun
fraŭdon	noun
fraŭdoj	noun
fraŭdojn	noun
adverba	adjective
dekoracio	noun
ŝterno	noun
tutaĵo	noun
kronu	verb
fraŭdi	verb
maraj	adjective
biblio	noun
puriĝi	verb
brajlo	noun
aĝio	noun
akcio	noun
aldo	noun
aleksandro	noun
aleksandron	noun
puriĝas	verb
puriĝonte	adverb
puriĝonta	adjective
puriĝontoj	noun
puriĝonto	noun
puriĝontojn	noun
puriĝonton	noun
puriĝanto	noun
puriĝinte	adverb
puriĝinta	adjective
puriĝinto	noun
puriĝintan	adjective
puriĝante	adverb
puriĝintaj	adjective
puriĝanta	adjective
puriĝus	verb
puriĝantajn	adjective
puriĝintoj	noun
puriĝu	verb
puriĝinton	noun
puriĝintajn	adjective
puriĝantan	adjective
puriĝontajn	adjective
puriĝantaj	adjective
puriĝantojn	noun
puriĝantoj	noun
puriĝanton	noun
puriĝis	verb
puriĝontan	adjective
puriĝontaj	adjective
puriĝos	verb
puriĝintojn	noun
ŝarĝus	verb
ŝarĝata	adjective
ŝarĝato	noun
ŝarĝis	verb
ŝarĝas	verb
ŝarĝos	verb
ŝarĝu	verb
ŝatanton	noun
ŝatonto	noun
ŝatantoj	noun
ŝatonta	adjective
ŝatontajn	adjective
ŝatonte	adverb
ŝatintojn	noun
ŝatantan	adjective
ŝatontojn	noun
ŝatantaj	adjective
ŝatinton	noun
ŝatintoj	noun
ŝatintan	adjective
ŝatintaj	adjective
ŝatante	adverb
ŝatontan	adjective
ŝatinto	noun
ŝatanta	adjective
ŝatontaj	adjective
ŝatinte	adverb
ŝatanto	noun
ŝatinta	adjective
ŝatantojn	noun
ŝatonton	noun
ŝatantajn	adjective
ŝatontoj	noun
ŝatintajn	adjective
sciiĝis	verb
sciiĝos	verb
sciiĝante	adverb
sciiĝanta	adjective
sciiĝantoj	noun
sciiĝanto	noun
sciiĝantojn	noun
sciiĝanton	noun
sciiĝus	verb
sciiĝonto	noun
sciiĝontoj	noun
sciiĝonte	adverb
sciiĝonta	adjective
sciiĝintoj	noun
sciiĝinton	noun
sciiĝontajn	adjective
sciiĝonton	noun
sciiĝu	verb
sciiĝontan	adjective
sciiĝinto	noun
sciiĝontaj	adjective
sciiĝontojn	noun
sciiĝinte	adverb
sciiĝintajn	adjective
sciiĝintan	adjective
sciiĝinta	adjective
sciiĝintaj	adjective
sciiĝantajn	adjective
sciiĝantan	adjective
sciiĝantaj	adjective
sciiĝintojn	noun
sciiĝas	verb
soldatiĝus	verb
soldatiĝanta	adjective
soldatiĝinto	noun
soldatiĝante	adverb
soldatiĝantaj	adjective
soldatiĝinta	adjective
soldatiĝanto	noun
soldatiĝantan	adjective
soldatiĝinte	adverb
soldatiĝonton	noun
soldatiĝontoj	noun
soldatiĝintajn	adjective
soldatiĝanton	noun
soldatiĝu	verb
soldatiĝantoj	noun
soldatiĝintaj	adjective
soldatiĝintojn	noun
soldatiĝantajn	adjective
soldatiĝintan	adjective
soldatiĝonto	noun
soldatiĝontaj	adjective
soldatiĝonta	adjective
soldatiĝontan	adjective
soldatiĝonte	adverb
soldatiĝontajn	adjective
soldatiĝas	verb
soldatiĝinton	noun
soldatiĝantojn	noun
soldatiĝis	verb
soldatiĝintoj	noun
soldatiĝos	verb
soldatiĝontojn	noun
ŝparato	noun
ŝparata	adjective
ŝparante	adverb
ŝparus	verb
ŝparate	adverb
ŝparito	noun
ŝparita	adjective
ŝparas	verb
ŝparite	adverb
ŝparu	verb
ŝparos	verb
ŝparis	verb
ŝvelante	adverb
ŝvitante	adverb
verŝato	noun
verŝata	adjective
verŝos	verb
verŝanto	noun
verŝante	adverb
verŝas	verb
verŝonta	adjective
verŝis	verb
verŝu	verb
verŝus	verb
verŝate	adverb
verŝito	noun
voĉanto	noun
voĉante	adverb
voĉita	adjective
voĉato	noun
voĉata	adjective
voĉate	adverb
voĉito	noun
plaĉante	adverb
plaĉinta	adjective
plaĉanto	noun
plaĉinte	adverb
plaĉas	verb
paŝintan	adjective
paŝus	verb
paŝintaj	adjective
paŝato	noun
paŝanton	noun
paŝantoj	noun
paŝintojn	noun
paŝoto	noun
paŝata	adjective
paŝaton	noun
paŝantan	adjective
paŝotan	adjective
paŝontojn	noun
paŝantaj	adjective
paŝotaj	adjective
paŝantajn	adjective
paŝinte	adverb
paŝanto	noun
paŝinta	adjective
paŝotajn	adjective
paŝante	adverb
paŝinto	noun
paŝanta	adjective
paŝatoj	noun
paŝoton	noun
paŝontajn	adjective
paŝatajn	adjective
paŝate	adverb
paŝitojn	noun
paŝintajn	adjective
paŝotojn	noun
paŝontan	adjective
paŝotoj	noun
paŝontaj	adjective
paŝita	adjective
paŝote	adverb
paŝite	adverb
paŝota	adjective
paŝas	verb
paŝonton	noun
paŝu	verb
paŝontoj	noun
paŝitajn	adjective
paŝiton	noun
paŝinton	noun
paŝonta	adjective
paŝitoj	noun
paŝintoj	noun
paŝonte	adverb
paŝitan	adjective
paŝonto	noun
paŝitaj	adjective
paŝatojn	noun
paŝatan	adjective
paŝantojn	noun
paŝataj	adjective
paŝos	verb
paŝito	noun
paŝis	verb
neniiĝu	verb
neniiĝas	verb
neniiĝintan	adjective
neniiĝintaj	adjective
neniiĝanton	noun
neniiĝantoj	noun
neniiĝontojn	noun
neniiĝus	verb
neniiĝonte	adverb
neniiĝantan	adjective
neniiĝonta	adjective
neniiĝantaj	adjective
neniiĝonto	noun
neniiĝinton	noun
neniiĝintoj	noun
neniiĝintojn	noun
neniiĝantojn	noun
neniiĝontan	adjective
neniiĝontaj	adjective
neniiĝantajn	adjective
neniiĝanta	adjective
neniiĝis	verb
neniiĝos	verb
neniiĝintajn	adjective
neniiĝinta	adjective
neniiĝonton	noun
neniiĝinte	adverb
neniiĝanto	noun
neniiĝontoj	noun
neniiĝontajn	adjective
neniiĝante	adverb
neniiĝinto	noun
nestiĝintajn	adjective
nestiĝontojn	noun
nestiĝonton	noun
nestiĝontoj	noun
nestiĝantojn	noun
nestiĝonta	adjective
nestiĝintojn	noun
nestiĝinto	noun
nestiĝante	adverb
nestiĝontan	adjective
nestiĝanta	adjective
nestiĝontaj	adjective
nestiĝanto	noun
nestiĝinte	adverb
nestiĝinta	adjective
nestiĝinton	noun
nestiĝintoj	noun
nestiĝantan	adjective
nestiĝantaj	adjective
nestiĝontajn	adjective
nestiĝanton	noun
nestiĝonto	noun
nestiĝantoj	noun
nestiĝantajn	adjective
nestiĝintan	adjective
nestiĝonte	adverb
nestiĝintaj	adjective
malŝatinta	adjective
malŝatinte	adverb
malŝatis	verb
malŝatu	verb
malŝatinto	noun
malŝatantoj	noun
malŝatus	verb
malŝatanton	noun
malŝatonte	adverb
malŝatontaj	adjective
malŝatontoj	noun
malŝatantaj	adjective
malŝatintajn	adjective
malŝatantan	adjective
malŝatonta	adjective
malŝatontan	adjective
malŝatintojn	noun
malŝatonton	noun
malŝatontojn	noun
malŝatantajn	adjective
malŝatontajn	adjective
malŝatanta	adjective
malŝatantojn	noun
malŝatas	verb
malŝatintoj	noun
malŝatanto	noun
malŝatante	adverb
malŝatinton	noun
malŝatintaj	adjective
malŝatonto	noun
malŝatintan	adjective
malŝatos	verb
malĝojiĝontaj	adjective
malĝojiĝus	verb
malĝojiĝanton	noun
malĝojiĝantojn	noun
malĝojiĝantoj	noun
malĝojiĝinto	noun
malĝojiĝontojn	noun
malĝojiĝanto	noun
malĝojiĝontajn	adjective
malĝojiĝantajn	adjective
malĝojiĝintan	adjective
malĝojiĝintaj	adjective
malĝojiĝinton	noun
malĝojiĝintoj	noun
malĝojiĝis	verb
malĝojiĝintajn	adjective
malĝojiĝinta	adjective
malĝojiĝos	verb
malĝojiĝinte	adverb
malĝojiĝonto	noun
malĝojiĝas	verb
malĝojiĝante	adverb
malĝojiĝonton	noun
malĝojiĝonte	adverb
malĝojiĝonta	adjective
malĝojiĝu	verb
malĝojiĝanta	adjective
malĝojiĝontoj	noun
malĝojiĝontan	adjective
malĝojiĝintojn	noun
malĝojiĝantan	adjective
malĝojiĝantaj	adjective
maĉu	verb
maĉanta	adjective
maĉante	adverb
maĉos	verb
maĉis	verb
maĉas	verb
lumiĝontajn	adjective
lumiĝanton	noun
lumiĝantoj	noun
lumiĝintan	adjective
lumiĝintaj	adjective
lumiĝas	verb
lumiĝinton	noun
lumiĝonte	adverb
lumiĝintoj	noun
lumiĝu	verb
lumiĝonton	noun
lumiĝante	adverb
lumiĝinto	noun
lumiĝontoj	noun
lumiĝanta	adjective
lumiĝinte	adverb
lumiĝanto	noun
lumiĝinta	adjective
lumiĝantajn	adjective
lumiĝis	verb
lumiĝos	verb
lumiĝantojn	noun
lumiĝontan	adjective
lumiĝontaj	adjective
lumiĝintojn	noun
lumiĝantan	adjective
lumiĝantaj	adjective
lumiĝonto	noun
lumiĝonta	adjective
lumiĝontojn	noun
lumiĝintajn	adjective
lumiĝus	verb
ĉesante	adverb
edziĝontaj	adjective
edziĝonta	adjective
edziĝantaj	adjective
edziĝas	verb
edziĝintaj	adjective
edziĝis	verb
edziĝinta	adjective
edziĝos	verb
edziĝanta	adjective
edziĝintojn	noun
edziĝus	verb
edziĝinto	noun
edziĝu	verb
edziĝinton	noun
edziĝintoj	noun
forĝis	verb
forĝas	verb
forĝata	adjective
ĝustonta	adjective
ĝustonte	adverb
ĝustus	verb
ĝustintaj	adjective
ĝustintan	adjective
ĝustintajn	adjective
ĝustanta	adjective
ĝustante	adverb
ĝustanton	noun
ĝustontojn	noun
ĝustantojn	noun
ĝustantoj	noun
ĝustanto	noun
ĝustos	verb
ĝustis	verb
ĝustonton	noun
ĝustas	verb
ĝustontoj	noun
ĝustontajn	adjective
ĝustontaj	adjective
ĝustontan	adjective
ĝustu	verb
ĝustantajn	adjective
ĝustonto	noun
ĝustinton	noun
ĝustintojn	noun
ĝustintoj	noun
ĝustinto	noun
ĝustinta	adjective
ĝustinte	adverb
ĝustantaj	adjective
ĝustantan	adjective
kraĉu	verb
kraŝu	verb
kraŝota	adjective
kraŝas	verb
mokus	verb
mokos	verb
mokas	verb
paŝtas	verb
paŝtos	verb
paŝtis	verb
paŝtus	verb
paŝtu	verb
nestigonto	noun
nestiginton	noun
nestigintoj	noun
nestigonte	adverb
nestigonta	adjective
nestigantojn	noun
nestigintan	adjective
nestiginto	noun
nestigintaj	adjective
nestiganton	noun
nestigantoj	noun
nestigintojn	noun
nestigantan	adjective
nestigontojn	noun
nestigantaj	adjective
nestiganta	adjective
nestigante	adverb
nestiginta	adjective
nestiginte	adverb
nestiganto	noun
nestigontajn	adjective
nestigintajn	adjective
nestigontan	adjective
nestigontaj	adjective
nestigonton	noun
nestigantajn	adjective
nestigontoj	noun
realiĝantojn	noun
realiĝantoj	noun
realiĝus	verb
realiĝanton	noun
realiĝanto	noun
realiĝonton	noun
realiĝantan	adjective
realiĝontajn	adjective
realiĝontojn	noun
realiĝantajn	adjective
realiĝintaj	adjective
realiĝonte	adverb
realiĝintan	adjective
realiĝintoj	noun
realiĝinton	noun
realiĝinto	noun
realiĝis	verb
realiĝinte	adverb
realiĝintajn	adjective
realiĝinta	adjective
realiĝos	verb
realiĝanta	adjective
realiĝonta	adjective
realiĝas	verb
realiĝante	adverb
realiĝontoj	noun
realiĝu	verb
realiĝontaj	adjective
realiĝintojn	noun
realiĝonto	noun
realiĝantaj	adjective
realiĝontan	adjective
subaĉetate	adverb
busaj	adjective
busan	adjective
busajn	adjective
ofendoj	noun
kepo	noun
trufo	noun
kovu	verb
sirian	adjective
paralelepipedo	noun
unun	determiner
sudanon	noun
ŝato	noun
trulo	noun
anheli	verb
estadi	verb
estadis	verb
ŭo	noun
gruvi	verb
bigoton	noun
ranca	adjective
artan	adjective
taŭono	noun
kataron	noun
ameti	verb
lobon	noun
reganto	noun
banoj	noun
hetoj	noun
seron	noun
ĉukĉa	adjective
edzigi	verb
edzigas	verb
edzigis	verb
edzigos	verb
edzigus	verb
edzigu	verb
edziganta	adjective
edzigantaj	adjective
edziginta	adjective
edzigintaj	adjective
edzigonta	adjective
edzigontaj	adjective
humiligi	verb
malajan	adjective
jakto	noun
prefere	adverb
anĉo	noun
anĉon	noun
arkta	adjective
arkta	adjective
arktaj	adjective
arktaj	adjective
arktan	adjective
arktan	adjective
arktajn	adjective
arktajn	adjective
bito	noun
biton	noun
ĉasio	noun
ĥino	noun
defias	verb
drivi	verb
etno	noun
eŭfemismo	noun
farĉi	verb
farĉis	verb
frustris	verb
genoj	noun
genon	noun
genojn	noun
glisi	verb
ofendi	verb
digamo	noun
zeto	noun
muo	noun
kopo	noun
taŭo	noun
ĥio	noun
heto	noun
sozo	noun
preteriras	verb
depresion	noun
bardon	noun
agla	adjective
interligo	noun
citilo	noun
atolon	noun
dank' al	preposition
darmon	noun
ŝario	noun
gamon	noun
aviada	adjective
eriko	noun
konsultas	verb
konsultis	verb
konsultos	verb
konsultus	verb
kontinua	adjective
junipero	noun
kanarioj	noun
ŝedo	noun
ŝedon	noun
edziginto	noun
edzigintoj	noun
edziginton	noun
edzigintojn	noun
filion	noun
ĝermoj	noun
ĝermi	verb
ĝermas	noun
ĝermis	noun
ĝustigi	verb
ekiri	verb
reteni	verb
ĵuri	verb
perdon	noun
gravedigi	verb
aĝa	adjective
aĝan	adjective
stumpo	noun
postaĵo	noun
postaĵoj	noun
postaĵon	noun
postaĵojn	noun
kaĉo	noun
kaĉon	noun
kaĝo	noun
kaĝon	noun
milon	noun
truaj	adjective
frostiĝi	verb
voko	noun
oriolo	noun
produkto	noun
saĝe	adverb
kuŝiĝi	verb
kolere	adverb
juĝoj	noun
juĝon	noun
juĝojn	noun
sfinkso	noun
sfinksoj	noun
sfinkson	noun
sfinksojn	noun
sfinksoj	noun
sfinkson	noun
sfinksojn	noun
erao	noun
kokso	noun
kokson	noun
solena	adjective
angio	noun
ĉi-jare	adverb
fokon	noun
jungu	verb
esperantidoj	noun
esperantidon	noun
esperantidojn	noun
esperantido	noun
esperantidoj	noun
esperantidon	noun
esperantidojn	noun
latinon	noun
somera	adjective
glora	adjective
koiton	noun
jam temp' está	phrase
jam temp' esta'	phrase
s-ro	noun
s-ino	noun
d-ro	noun
d-ino	noun
zamenhofa	adjective
zamenhofaj	adjective
zamenhofan	adjective
zamenhofajn	adjective
ŭaŭ	interjection
vegana	adjective
grincas	verb
akĉento	noun
akĉentoj	noun
akĉenton	noun
akĉentojn	noun
inaŭguri	verb
inaŭguro	noun
sieĝo	noun
vilao	noun
citon	noun
advento	noun
gluo	noun
stepo	noun
alofono	noun
automobilo	noun
veturo	noun
lipido	noun
akre	adverb
ŝarĝo	noun
ŝarĝon	noun
gooj	noun
goojn	noun
kopoj	noun
kaŭri	verb
ĝentile	adverb
sumon	noun
sidigi	verb
postan	adjective
pleje	adverb
patran	adjective
foriĝi	verb
abundi	verb
abundis	verb
abundos	verb
ŝirmi	verb
ĝis la	interjection
pleniĝi	verb
larĝe	adverb
kontentiĝi	verb
ioma	adjective
ĝemi	verb
venĝi	verb
dank'al	preposition
reputacio	noun
reputacion	noun
ĥine	adverb
ŝanhaja	adjective
ĥore	adverb
antikriston	noun
antikristo	noun
antikriston	noun
sankte	adverb
dekdua	adjective
dekduaj	adjective
dekduan	adjective
dekduajn	adjective
meĥanike	adverb
usonan	adjective
dekunu	numeral
dekdu	numeral
dektri	numeral
dekkvar	numeral
dekkvin	numeral
dekses	numeral
deksep	numeral
dekok	numeral
deknaŭ	numeral
dudekunu	numeral
dudekdu	numeral
dudektri	numeral
dudekkvar	numeral
dudekkvin	numeral
dudekses	numeral
dudeksep	numeral
dudekok	numeral
dudeknaŭ	numeral
tridekunu	numeral
tridekdu	numeral
tridektri	numeral
tridekkvar	numeral
tridekkvin	numeral
tridekses	numeral
trideksep	numeral
tridekok	numeral
trideknaŭ	numeral
kvardekunu	numeral
kvardekdu	numeral
kvardektri	numeral
kvardekkvar	numeral
kvardekkvin	numeral
kvardekses	numeral
kvardeksep	numeral
kvardekok	numeral
kvardeknaŭ	numeral
kvindekunu	numeral
kvindekdu	numeral
kvindektri	numeral
kvindekkvar	numeral
kvindekkvin	numeral
kvindekses	numeral
kvindeksep	numeral
kvindekok	numeral
kvindeknaŭ	numeral
sesdekunu	numeral
sesdekdu	numeral
sesdektri	numeral
sesdekkvar	numeral
sesdekkvin	numeral
sesdekses	numeral
sesdeksep	numeral
sesdekok	numeral
sesdeknaŭ	numeral
sepdekunu	numeral
sepdekdu	numeral
sepdektri	numeral
sepdekkvar	numeral
sepdekkvin	numeral
sepdekses	numeral
sepdeksep	numeral
sepdekok	numeral
sepdeknaŭ	numeral
okdekunu	numeral
okdekdu	numeral
okdektri	numeral
okdekkvar	numeral
okdekkvin	numeral
okdekses	numeral
okdeksep	numeral
okdekok	numeral
okdeknaŭ	numeral
naŭdekunu	numeral
naŭdekdu	numeral
naŭdektri	numeral
naŭdekkvar	numeral
naŭdekkvin	numeral
naŭdekses	numeral
naŭdeksep	numeral
naŭdekok	numeral
naŭdeknaŭ	numeral
nean	adjective
jenon	noun
nepiva	adjective
nepivajn	adjective
nepivan	adjective
nepivaj	adjective
nepiva	adjective
nepivaj	adjective
nepivan	adjective
nepivajn	adjective
menuo	noun
kristnaskoj	noun
kristnaskojn	noun
ĉi-foje	adverb
ĉifoje	adverb
futo	noun
kaso	noun
kompare	adverb
feino	noun
dediĉo	noun
disertacion	noun
etoj	noun
figuron	noun
heton	noun
heĝon	noun
kazon	noun
kodon	noun
mutacion	noun
nederlandaninoj	noun
nederlandaninon	noun
nederlandaninojn	noun
nederlandanoj	noun
nederlandanon	noun
nederlandanojn	noun
nifoj	noun
nifon	noun
nifojn	noun
raboj	noun
rabon	noun
riskon	noun
salton	noun
sampion	noun
sigmon	noun
siroj	noun
supozoj	noun
taŭon	noun
teton	noun
tolon	noun
turton	noun
zeton	noun
ĥion	noun
dozo	noun
disvastigi	verb
aŭdigi	verb
spezi	verb
pushi	verb
antibiotika	adjective
likis	verb
likos	verb
likus	verb
animala	adjective
norden	adverb
kruta	adjective
kauzo	noun
mosko	noun
teksas	verb
chio	pronoun
iraĉi	verb
aktivo	noun
koniĝi	verb
icha	adjective
piku	verb
bolido	noun
kunan	adjective
tanas	verb
instrukcio	noun
porcio	noun
porcion	noun
ĉaro	noun
ĉaroj	noun
ĉaron	noun
ĉarojn	noun
ĉareto	noun
ĉareton	noun
aorto	noun
aŭditorio	noun
aŭditorion	noun
ŝargi	verb
ŝlimo	noun
peticio	noun
peticion	noun
abonoj	noun
tirana	adjective
tanos	verb
ruinos	verb
mo-on	noun
no-on	noun
ĝo-ojn	noun
ĝo-on	noun
ĝo-oj	noun
ĉo-ojn	noun
ĉo-oj	noun
ĉo-on	noun
pigreco	noun
pinĉi	verb
ĉilia	adjective
postulis	verb
fraŭde	adverb
fraŭda	adjective
kroni	verb
nedankinde	interjection
felo	noun
kashas	verb
ĥano	noun
ĥanoj	noun
ananasa	adjective
akcenta	adjective
chesi	verb
luli	verb
ento	noun
poŭpo	noun
mencio	noun
norde	adverb
esperantisto	noun
cxi	particle
lieno	noun
monan	adjective
aeran	adjective
dieto	noun
ŝargo	noun
oficis	verb
a-on	noun
e-on	noun
i-on	noun
u-on	noun
i-oj	noun
i-ojn	noun
bo-on	noun
co-on	noun
co-oj	noun
co-ojn	noun
do-on	noun
fo-on	noun
go-on	noun
go-oj	noun
go-ojn	noun
ho-on	noun
ho-oj	noun
ho-ojn	noun
ĥo-on	noun
ĥo-oj	noun
ĥo-ojn	noun
jo-on	noun
jo-oj	noun
jo-ojn	noun
ĵo-on	noun
ĵo-oj	noun
ĵo-ojn	noun
ko-on	noun
lo-on	noun
po-on	noun
ro-on	noun
so-on	noun
so-oj	noun
so-ojn	noun
ŝo-on	noun
ŝo-oj	noun
ŝo-ojn	noun
to-on	noun
vo-on	noun
zo-on	noun
zo-oj	noun
zo-ojn	noun
fileton	noun
ĝuo	noun
ĝuon	noun
permesos	verb
reŭmatismo	noun
ĵuras	verb
ĵuris	verb
ĵuros	verb
ĵurus	verb
ĵuru	verb
fiŝa	adjective
hotela	adjective
leĝa	adjective
leĝan	adjective
venĝas	verb
venĝis	verb
dudekkvina	adjective
dudekkvinan	adjective
dudekkvinaj	adjective
dudekkvinajn	adjective
dudekkvara	adjective
dudekkvaran	adjective
dudekkvaraj	adjective
dudekkvarajn	adjective
dudektria	adjective
dudektrian	adjective
dudektriaj	adjective
dudektriajn	adjective
dudekdua	adjective
dudekduan	adjective
dudekduaj	adjective
dudekduajn	adjective
dudekunua	adjective
dudekunuan	adjective
dudekunuaj	adjective
dudekunuajn	adjective
deknaŭa	adjective
deknaŭan	adjective
deknaŭaj	adjective
deknaŭajn	adjective
dekoka	adjective
dekokan	adjective
dekokaj	adjective
dekokajn	adjective
deksepa	adjective
deksepan	adjective
deksepaj	adjective
deksepajn	adjective
deksesa	adjective
deksesan	adjective
deksesaj	adjective
deksesajn	adjective
dekkvina	adjective
dekkvinan	adjective
dekkvinaj	adjective
dekkvinajn	adjective
dekkvara	adjective
dekkvaran	adjective
dekkvaraj	adjective
dekkvarajn	adjective
dektria	adjective
dektrian	adjective
dektriaj	adjective
dektriajn	adjective
estimon	noun
malsaniĝi	verb
maltrankviliĝi	verb
vilaĝa	adjective
vilaĝan	adjective
pikis	verb
pikus	verb
aprobo	noun
rapidu	verb
pekaj	adjective
havaĵo	noun
havaĵon	noun
ĝemo	noun
ĝemon	noun
ĝemoj	noun
ĝemojn	noun
ĵuro	noun
ĵuron	noun
biblion	noun
biblioj	noun
bibliojn	noun
nanan	adjective
opcio	noun
opcion	noun
ŝerce	adverb
altaĵo	noun
brue	adverb
saĝo	noun
saĝon	noun
saĝoj	noun
saĝojn	noun
edzinigi	verb
kateni	verb
klariĝi	verb
pado	noun
satano	noun
satanon	noun
silentiĝi	verb
aspekte	adverb
certiĝi	verb
almenau	adverb
ambau	determiner
ankorau	adverb
ankorau ne	adverb
ankau	adverb
tostu	verb
anstatau	preposition
antauhierau	adverb
antau	preposition
apenau	adverb
baldau	adverb
kovi	verb
gumo	noun
kaliko	noun
vinko	noun
hierau	adverb
hodiau	adverb
kontrau	preposition
kvazau	conjunction
morgau	adverb
preskau	adverb
chiu	pronoun
chiu	determiner
anstataŭulo	noun
anstataŭulon	noun
anstataŭulojn	noun
anstataŭuloj	noun
anstatauulon	noun
anstatauulojn	noun
anstatauuloj	noun
anstatauulo	noun
shipo	noun
hipodromo	noun
ŝmaci	verb
borago	noun
aĥi	verb
j.	noun
aĉi	verb
omaĝe	adverb
georgian	adjective
suoma	adjective
kompleto	noun
orfiĉo	noun
praa	adjective
freŝe	adverb
iĉa	adjective
icxo	noun
icho	noun
alklimatiĝu	verb
alklimatiĝus	verb
alklimatiĝos	verb
alklimatiĝis	verb
alklimatiĝas	verb
mi sangas	phrase
gumoj	noun
kastrato	noun
vinan	adjective
frosta	adjective
froste	adverb
fraulo	noun
fraulino	noun
tokipona	adjective
ondan	adjective
ĵaro	noun
fabriki	verb
usonajn	adjective
usonaj	adjective
paton	noun
rughan	adjective
kronos	verb
kuŝigas	verb
kuŝiĝas	verb
kuŝigis	verb
kuŝiĝis	verb
kuŝigos	verb
kuŝiĝos	verb
kuŝigus	verb
kuŝiĝus	verb
kuŝigu	verb
kuŝiĝu	verb
muko	noun
literaturaĵo	noun
mistiko	noun
shia	determiner
kontrabando	noun
sahara	adjective
galopi	verb
kason	noun
iberia	adjective
ambli	verb
tapeto	noun
amnezia	adjective
antaŭenigi	verb
antaŭeniĝi	verb
lacigi	verb
necesaĵo	adjective
idolon	noun
diri	verb
voris	verb
vorota	adjective
noca	adjective
turnus	verb
kurbiĝi	verb
pretiĝi	verb
tonelo	noun
pufa	adjective
ruze	adverb
ĉiĉerono	noun
junko	noun
razeno	noun
ĝiri	verb
vaki	verb
ĝiris	verb
ĝiros	verb
ĝirus	verb
ĝiru	verb
piĵamo	noun
fraulinon	noun
fraulinoj	noun
fraulinojn	noun
fraulon	noun
frauloj	noun
fraulojn	noun
adiau	interjection
s-inoj	noun
automobilon	noun
automobiloj	noun
automobilojn	noun
esperantiston	noun
esperantistoj	noun
esperantistojn	noun
postmorgau	adverb
ajho	noun
saŭno	noun
vorto-speco	noun
vortospeco	noun
vorto-specoj	noun
vortospecoj	noun
glat	noun
kataluna	adjective
ulno	noun
britaj	adjective
britajn	adjective
tetrao	noun
svati	verb
ndk	phrase
hida	adjective
incitis	verb
regeneri	verb
malinda	adjective
peklas	verb
regeneris	verb
gojo	noun
aplaŭdo	noun
d-rino	noun
d-rino	noun
doktoro	noun
hoso	noun
plachu	verb
poshto	noun
opoj	noun
bikolano	noun
niĉo	noun
mns	phrase
alfaros	verb
dabi	verb
aizoon	noun
ŝalupo	noun
ĥimon	noun
