δημοκρατία	noun	δημοκρᾰτῐ́ᾱ
μία	numeral	εἷς
γραμματική	adjective	γρᾰμμᾰτῐκός
ἰουδαία	adjective	Ῐ̓ουδαῖος
ταχύ	adjective	ταχύς
λύω	verb	λῡ́ω
πρῶτον	adjective	πρῶτος
εὐθέως	adjective	εὐθύς
ἄρχομαι	verb	ἄρχω
ἥμισυ	adjective	ἥμισυς
τοῦ	pronoun	τίς
αὐτοῦ	pronoun	αὐτός
ὅπλα	noun	ὅπλον
ἀνδρός	noun	ἀνήρ
λύομεν	verb	λῡ́ω
λύετε	verb	λῡ́ω
λύουσι	verb	λῡ́ω
λύουσιν	verb	λῡ́ω
λύῃς	verb	λῡ́ω
λύῃ	verb	λῡ́ω
λύωμεν	verb	λῡ́ω
λύητε	verb	λῡ́ω
λύωσι	verb	λῡ́ω
λύωσιν	verb	λῡ́ω
ὁδοῦ	noun	ὁδός
θεά	noun	θεή
ἀνθρώπου	noun	ᾰ̓́νθρωπος
θεοῦ	noun	θεός
ψυχῆς	noun	ψῡχή
μοίρας	noun	μοῖρᾰ
νεώ	noun	νεώς
ναοῦ	noun	ναός
ἀληθείας	noun	ᾰ̓λήθειᾰ
στροφῆς	noun	στροφή
ἀγγέλου	noun	ἄγγελος
κοινή	adjective	κοινός
αἰγάγρου	noun	αἴγαγρος
σοφίας	noun	σοφῐ́ᾱ
μίαν	numeral	εἷς
βασιλεία	adjective	βᾰσῐ́λειος
σου	pronoun	σύ
ἕλληνες	noun	Ἕλλην
με	pronoun	ἐγώ
ἵππου	noun	ῐ̔́ππος
ἰδία	adjective	ῐ̓́δῐος
ἴδιον	adjective	ῐ̓́δῐος
σε	pronoun	σύ
ἄκρα	adjective	ᾰ̓́κρος
σοφόν	adjective	σοφός
ἄθεοι	adjective	ἄθεος
ἄρκτου	noun	ᾰ̓́ρκτος
βάρεος	noun	βᾰ́ρος
ἀγάπης	noun	ἀγάπη
ἀγνοίας	noun	ἄγνοια
ἀγροῦ	noun	ἀγρός
ἀδελφῆς	noun	ἀδελφή
ἀδύτου	noun	ἄδυτον
αἵματος	noun	αἷμα
αἰνίγματος	noun	αἴνιγμα
αἰσθήσεως	noun	αἴσθησις
ἀκακίας	noun	ἀκακία
ἀκάνθου	noun	ἄκανθος
ἀκῆς	noun	ᾰ̓κή
ἀναρχίας	noun	ᾰ̓νᾰρχῐ́ᾱ
ἄνθους	noun	ᾰ̓́νθος
ἀνθρακιᾶς	noun	ᾰ̓νθρᾰκῐᾱ́
ἀποκαλύψεως	noun	ᾰ̓ποκᾰ́λῠψῐς
λυκία	adjective	Λύκιος
ἀρμενία	adjective	Ἀρμένιος
ἀθηναία	adjective	Ἀθηναῖος
ἁγνή	adjective	ἁγνός
ἁγία	adjective	ἅγιος
λακωνική	adjective	Λᾰκωνῐκός
νίκης	noun	νίκη
οὐρανοῦ	noun	οὐρανός
ἐστί	verb	εἰμί
πλατεία	adjective	πλᾰτύς
πόλεων	noun	πόλῐς
ὄζον	noun	ὄζος
νέων	adjective	νέος
πέρνα	verb	πέρνημι
λεία	adjective	λεῖος
μητρός	noun	μήτηρ
ἀμύνομαι	verb	ᾰ̓μῡ́νω
εἶ	verb	εἰμί
εἶ	verb	εἶμι
στρογγύλη	adjective	στρογγῠ́λος
ξῖ	noun	ξεῖ
ζῶον	noun	ζῷον
ξενία	adjective	ξένῐος
ἔντερα	noun	ἔντερον
μονοπώλια	noun	μονοπώλῐον
θεία	adjective	θεῖος
κέρασος	noun	κερᾰσός
ὀστοῦν	noun	ὀστέον
μῆδος	noun	μήδεα
ἐμοῦ	pronoun	ἐγώ
ἱστορίας	noun	ῐ̔στορῐ́ᾱ
ψυχῇ	noun	ψῡχή
σοῦ	pronoun	σύ
σοῦ	adjective	σός
ὀνείρων	noun	ὄνειρος
ὀνείρων	noun	ὄνειρον
ᾧ	pronoun	ὅς
εἶναι	verb	εἰμί
πᾶν	determiner	πᾶς
βαρεία	adjective	βᾰρῠ́ς
βαρεία	noun	βᾰρεῖᾰ
τι	pronoun	τις
πλατεῖα	adjective	πλατύς
ὄργια	noun	ὄργιον
ἕξω	verb	ἔχω
πλάκα	noun	πλᾰ́ξ
νίκῃ	noun	νίκη
νικῶν	noun	νίκη
πολύ	adjective	πολῠ́ς
κυρία	adjective	κῡ́ριος
κακή	adjective	κακός
ἀξία	adjective	ἄξιος
γένη	noun	γένος
λευκή	adjective	λευκός
λευκούς	adjective	λευκός
ζύθων	noun	ζῦθος
ὑποθέσει	noun	ὑπόθεσις
χρόνια	adjective	χρόνῐος
μόνου	adjective	μόνος
μόνη	adjective	μόνος
μόνης	adjective	μόνος
μόνοι	adjective	μόνος
μόνους	adjective	μόνος
μόνων	adjective	μόνος
μόνα	adjective	μόνος
πρώτα	adjective	πρῶτος
μάχης	noun	μᾰ́χη
κτήματος	noun	κτῆμᾰ
κτήματα	noun	κτῆμᾰ
κτημάτων	noun	κτῆμᾰ
κυρίου	adjective	κῡ́ριος
κυρίων	adjective	κῡ́ριος
κυρίους	adjective	κῡ́ριος
κυρίους	noun	κῡ́ριος
κύριε	adjective	κῡ́ριος
κεφαλαία	adjective	κεφάλαιος
κεφάλαια	noun	κεφάλαιος
κεφάλαια	adjective	κεφάλαιος
φίλων	adjective	φίλος
βαρβάρου	adjective	βάρβαρος
βαρβάρων	adjective	βάρβᾰρος
βαρβάρους	adjective	βάρβᾰρος
ξένη	adjective	ξένος
ξένων	adjective	ξένος
ξένων	noun	ξένος
ξένης	adjective	ξένος
ξένης	noun	ξένη
ποικίλων	adjective	ποικῐ́λος
ποικίλους	adjective	ποικῐ́λος
ψιλή	adjective	ψῑλός
κακά	adjective	κακός
πιστά	adjective	πῐστός
φιλοσοφική	adjective	φῐλοσοφῐκός
διπλάσια	adjective	διπλάσιος
παλαιάς	adjective	πᾰλαιός
ἔρις	noun	ἶρῐς
δουλείας	noun	δουλεία
ὦ	verb	εἰμί
κύρια	adjective	κῡ́ριος
κυρίας	adjective	κῡ́ριος
κυρίας	noun	κῡρίᾱ
τί	pronoun	τίς
τί	pronoun	τις
οὗ	pronoun	ὅς
οὗ	adjective	ὅς
οὗ	verb	ἵημι
ταχεία	adjective	ταχύς
μυρίοι	adjective	μῡρῐ́ος
κυμίνου	noun	κύμινον
εὐφορίας	noun	εὐφορία
θέρμης	noun	θέρμη
μεῖον	adjective	μείων
μισθοῦ	noun	μισθός
οἴα	adjective	οἶος
οὐράς	noun	οὐρά
πολιτικῇ	adjective	πολῑτικός
φαίδρα	adjective	φαιδρός
ἀληθές	adjective	ᾰ̓ληθής
ἀποθήκης	noun	ἀποθήκη
ἀμύλου	noun	ἀμύλος
ἀμύλου	noun	ἄμυλον
ἄξια	adjective	ἄξιος
ἄρσεως	noun	ἄρσις
ἐνεργείας	noun	ἐνέργεια
ἐπιστήμης	noun	ἐπιστήμη
ὀπτική	adjective	ὀπτικός
ἠθική	adjective	ἠθικός
πλείων	adjective	πολύς
ῥυτίδα	noun	ῥῠτῐ́ς
σταφυλῆς	noun	σταφυλή
φοβερά	adjective	φοβερός
τετάρτη	adjective	τέταρτος
ἕκτη	adjective	ἕκτος
ἑβδόμῃ	adjective	ἕβδομος
ὀγδόη	adjective	ὄγδοος
ἐνάτη	adjective	ἔνατος
δεκάτη	adjective	δέκατος
ἑνδεκάτη	adjective	ἑνδέκατος
δωδεκάτη	adjective	δωδέκατος
ἑκατοστή	adjective	ἑκατοστός
ἀρχῆς	noun	ἀρχή
ἀβύσσου	noun	ἄβυσσος
ἡμέρας	noun	ἡμέρα
ἕν	numeral	εἷς
καιροῦ	noun	καιρος
μέγα	adjective	μέγας
ἔλασσον	adjective	ἐλάσσων
πετεινοῦ	noun	πετεινόν
χλόης	noun	χλόη
βάλετε	verb	βάλλω
βάλε	verb	βάλλω
ἀνέμου	noun	ἄνεμος
ἀνέμῳ	noun	ἄνεμος
ἀνέμω	noun	ἄνεμος
ἄνεμε	noun	ἄνεμος
ἄνεμοι	noun	ἄνεμος
ἀνέμων	noun	ἄνεμος
ἀνέμους	noun	ἄνεμος
ἄβακα	noun	ἄβαξ
ἄβακες	noun	ἄβαξ
ἀβάκων	noun	ἄβαξ
ἄβακας	noun	ἄβαξ
ἀβακίσκῳ	noun	ἀβακίσκος
ἀβακίσκω	noun	ἀβακίσκος
ἀγῶνα	noun	ἀγών
ἀγῶνες	noun	ἀγών
ἀγώνων	noun	ἀγών
ἀγῶνας	noun	ἀγών
ἡρωίνης	noun	ἡρωίνη
ἡρωΐνη	noun	ἡρωίνη
ὑλικοῦ	adjective	ὑλικός
ὑλική	adjective	ὑλικός
ὑλικῷ	adjective	ὑλικός
ὑλικέ	adjective	ὑλικός
ὑλικῆς	adjective	ὑλικός
ὑλικῇ	adjective	ὑλικός
ὑλικώ	adjective	ὑλικός
ὑλικά	adjective	ὑλικός
ὑλικοί	adjective	ὑλικός
ὑλικῶν	adjective	ὑλικός
ὑλικούς	adjective	ὑλικός
ἀκρίδες	noun	ᾰ̓κρῐ́ς
διδαχῆς	noun	δῐδᾰχή
ἕξεις	verb	ἔχω
ἕξεις	noun	ἕξῐς
ἀποκρίνομαι	verb	ἀποκρῑ́νω
ὑστέρα	adjective	ὕστερος
ἥρωες	noun	ἥρως
ἀπροσδοκήτου	adjective	ἀπροσδόκητος
πιθήκους	noun	πίθηκος
κάκα	noun	κάκη
ἀριθμοί	noun	ᾰ̓ρῐθμός
ὁμίχλη	noun	ὀμίχλη
ἥ	pronoun	ὅς
ἥ	pronoun	ὁ
ὅ	pronoun	ὅς
ᾗ	pronoun	ὅς
ᾗ	verb	ἵημι
ὥ	pronoun	ὅς
ἅ	pronoun	ὅς
καλῶς	adverb	καλός
ἴδε	verb	εἶδον
λέσβια	adjective	Λέσβιος
λεσβία	adjective	Λέσβῐος
καρτερώ	adjective	καρτερός
ἕτοιμος	adjective	ἑτοῖμος
ᾖ	verb	εἰμί
κόσμων	noun	κόσμος
νήσοι	verb	νέω
ἀγαθωσύνῃ	noun	ἀγαθωσύνη
μόραι	noun	μόρᾰ
μόρᾳ	noun	μόρᾰ
ἱστάς	verb	ἵστημι
τιμῶν	noun	τῑμή
ποιῶν	verb	ποιέω
δασεία	adjective	δᾰσῠ́ς
δασεία	noun	δᾰσεῖᾰ
γένῃ	verb	γίγνομαι
βαρεῖα	adjective	βᾰρῠ́ς
ὀξεῖα	adjective	ὀξῠ́ς
ὀξείας	adjective	ὀξῠ́ς
ὀξείας	noun	ὀξεῖᾰ
ὀξεῖαι	adjective	ὀξῠ́ς
ὀξεῖαι	noun	ὀξεῖᾰ
ὀξείᾳ	adjective	ὀξῠ́ς
ὀξείᾳ	noun	ὀξεῖᾰ
δασεῖα	adjective	δᾰσῠ́ς
βραχύ	adjective	βρᾰχύς
ἔχον	verb	ἔχω
τινά	pronoun	τις
γραμματικῶν	adjective	γρᾰμμᾰτῐκός
γραμματικῶν	noun	γρᾰμμᾰτῐκή
γραμματικῶν	noun	γρᾰμμᾰτῐκόν
γραμματικῶν	noun	γρᾰμμᾰτῐκός
βαρείᾳ	adjective	βᾰρῠ́ς
βαρείᾳ	noun	βᾰρεῖᾰ
διαφοράς	noun	διαφορᾱ́
κεράτια	noun	κερᾱ́τῐον
ὀνόματος	noun	ὄνομᾰ
ὀνόματι	noun	ὄνομᾰ
ὀνόματα	noun	ὄνομᾰ
ὀνομάτων	noun	ὄνομᾰ
αἰγίδες	noun	αἰγῐ́ς
ἀφαιρετική	adjective	ἀφαιρετικός
φωνῆεν	adjective	φωνήεις
διάλυτον	adjective	δῐᾰ́λῠτος
διαλυτόν	adjective	δῐᾰλῠτός
ἔριδα	noun	ἔρῐς
ἔριδας	noun	ἔρῐς
ἐρίδων	noun	ἔρῐς
ἔριδες	noun	ἔρῐς
διήρκεσα	verb	δῐᾰρκέω
κυριακή	adjective	κῡριακός
ἁλουργίδα	noun	ᾰ̔λουργῐ́ς
κύκλων	noun	κύκλος
παράβαλε	verb	πᾰρᾰβᾰ́λλω
παραβάλετε	verb	πᾰρᾰβᾰ́λλω
παραβάλλετε	verb	πᾰρᾰβᾰ́λλω
παράβαλλε	verb	πᾰρᾰβᾰ́λλω
οὔ	particle	οὐ
ἄραβες	noun	Ἄρᾰψ
βόλῳ	noun	βόλος
βόλω	noun	βόλος
θεσσαλικά	adjective	Θεσσᾰλῐκός
στηλῶν	noun	στήλη
γραπτῶν	adjective	γραπτός
ἑλληνικῆς	adjective	Ἑλληνῐκός
ἔστιν	verb	εἰμί
ζωγραφική	adjective	ζωγρᾰφῐκός
ζωγραφικῆς	adjective	ζωγρᾰφῐκός
ζωγραφικῆς	noun	ζωγρᾰφῐκή
ζῳγραφικός	adjective	ζωγρᾰφῐκός
ζῳγραφική	noun	ζωγρᾰφῐκή
ζῳγραφική	adjective	ζῳγρᾰφῐκός
ζῳγραφικῆς	adjective	ζῳγρᾰφῐκός
ζῳγραφικῆς	noun	ζῳγρᾰφῐκή
ἐφόρου	noun	ἔφορος
εὕρηκα	verb	εὑρίσκω
ζῳγραφία	noun	ζωγρᾰφῐ́ᾱ
ζωγραφίαι	noun	ζωγρᾰφῐ́ᾱ
ζῳγραφίαι	noun	ζῳγρᾰφῐ́ᾱ
ἔρευναι	noun	ἔρευνᾰ
σέ	pronoun	σύ
δοτική	adjective	δοτῐκός
ἑτέρα	adjective	ἕτερος
ἕτερα	adjective	ἕτερος
ἐμπειρική	adjective	ἐμπειρῐκός
κριταί	noun	κρῐτής
χθόνια	adjective	χθόνῐος
χθονίᾳ	adjective	χθόνιος
χθονίῳ	adjective	χθόνιος
χθονίω	adjective	χθόνιος
θρόνῳ	noun	θρόνος
θρόνω	noun	θρόνος
χρυσελεφαντίνῃ	adjective	χρυσελεφάντινος
χρυσελεφαντίνη	adjective	χρυσελεφάντινος
χρυσελεφαντίνω	adjective	χρῡσελεφᾰ́ντῐνος
χρυσελεφαντίνῳ	adjective	χρυσελεφάντινος
χρυσελεφαντίνα	adjective	χρῡσελεφᾰ́ντῐνος
χρυσελεφάντινα	adjective	χρυσελεφάντινος
ὑπογείου	adjective	ὑπόγειος
ὑπογείου	noun	ὑπόγειον
ὑπογείω	adjective	ῠ̔πόγειος
ὑπογείω	noun	ῠ̔πόγειον
ὑπόγεια	adjective	ῠ̔πόγειος
ὑπόγεια	noun	ῠ̔πόγειον
ὑπογείων	adjective	ὑπόγειος
ὑπογείων	noun	ὑπόγειον
ὑπογείους	adjective	ὑπόγειος
ὑπογείῳ	adjective	ὑπόγειος
ὑπογείῳ	noun	ὑπόγειον
ὑπόγειε	adjective	ῠ̔πόγειος
ὑπόγειοι	adjective	ὑπόγειος
ἐκεῖνα	pronoun	ἐκεῖνος
ληθαργία	noun	ληθᾱργῐ́ᾱ
ληθαργίᾳ	noun	ληθᾰργῐ́ᾱ
ἐκδόσεως	noun	ἔκδοσῐς
ἐκδόσεις	noun	ἔκδοσῐς
ἐκδόσεων	noun	ἔκδοσῐς
ἐκδόσις	noun	ἔκδοσῐς
ὁδούς	noun	ὁδός
θεάς	noun	θεά
ἀπροσδοκήτῳ	adjective	ἀπροσδόκητος
ἀπροσδόκητε	adjective	ἀπροσδόκητος
ἀπροσδοκήτω	adjective	ἀπροσδόκητος
ἀπροσδόκητοι	adjective	ἀπροσδόκητος
ἀπροσδόκητα	adjective	ἀπροσδόκητος
ἀπροσδοκήτων	adjective	ἀπροσδόκητος
ἀπροσδοκήτους	adjective	ἀπροσδόκητος
ἦ	verb	εἰμί
ἦ	verb	ἠμί
ἡμῶν	pronoun	ἡμεῖς
ἕ	pronoun	οὗ
πείσω	verb	πείθω
ἦν	verb	εἰμί
εἶσι	verb	εἶμι
εἶσιν	verb	εἶμι
καλῶ	verb	καλέω
αὐτή	verb	αὐτός
αὐτό	verb	αὐτός
αὕτη	pronoun	οὗτος
αὑτή	pronoun	αὐτός
τοῦτο	pronoun	οὗτος
ἴα	verb	εἷς
ἴα	noun	ῐ̓́ον
ἄστεα	noun	ἄστυ
βατή	adjective	βᾰτός
τιμῆς	noun	τῑμή
τίνες	pronoun	τῐ́ς
ἱερέας	noun	ἱερεύς
ταχεῖα	adjective	ταχύς
γνώσεις	noun	γνῶσῐς
κούρα	noun	κούρη
τούτου	adjective	οὗτος
ἑτέρᾳ	adjective	ἕτερος
ἐκείνα	adjective	ἐκεῖνος
ζωγραφίᾳ	noun	ζωγρᾰφῐ́ᾱ
ζῳγραφίᾳ	noun	ζῳγρᾰφῐ́ᾱ
ὀλιγαρχία	noun	ὀλιγαρχία
ᾖς	verb	εἰμί
εἶτε	verb	εἰμί
ἐσχάριῳ	noun	ἐσχάριον
ἐσχάριω	noun	ἐσχάριον
ὀλιγαρχίᾳ	noun	ὀλιγαρχία
δημοκρατίᾳ	noun	δημοκρᾰτῐ́ᾱ
δημοκρατίαιν	noun	δημοκρᾰτῐ́ᾱ
δημοκρατιῶν	noun	δημοκρᾰτῐ́ᾱ
ζῦθοι	noun	ζῦθος
ζῦθε	noun	ζῦθος
ζῦθον	noun	ζῦθος
ζυθῶν	noun	ζῦθος
ἄτης	noun	ἄτη
δικαιαδίκῳ	adjective	δικαιάδικος
δικαιαδίκω	adjective	δικαιάδικος
θεῷ	noun	θεός
οἵ	pronoun	ὅς
οἵ	adjective	ὅς
ἵππους	noun	ἵππος
νῆας	noun	νηῦς
ἄλλοι	adjective	ἄλλος
αὐτῷ	pronoun	αὐτός
τρῶας	noun	Τρῶες
ὅν	pronoun	ὅς
ὅν	adjective	ὅς
αἵ	pronoun	ὅς
αἵ	adjective	ὅς
σοι	pronoun	σύ
σοί	pronoun	σύ
σοί	adjective	σός
ἔργα	noun	ἔργον
πᾶσα	determiner	πᾶς
τέ	pronoun	τύ
ἀρρυθμίας	noun	ἀρρυθμίᾱ
ἄλλων	adjective	ἄλλος
ἵπποι	noun	ἵππος
δῶρα	noun	δῶρον
ἀντίον	adjective	ἀντίος
ἄνδρα	noun	ἀνήρ
αὔδα	verb	αὐδάω
αὐδᾷ	verb	αὐδάω
βίους	noun	βίος
βίοι	noun	βίος
κηφῆνας	noun	κηφήν
κηφῆνες	noun	κηφήν
κηφῆνα	noun	κηφήν
ἔρεσθαι	verb	ἔρομαι
ἐρέσθαι	verb	ἔρομαι
φορεῖ	verb	φορέω
φόρει	verb	φορέω
εἰσί	verb	εἰμῐ́
εἰσίν	verb	εἰμί
ἐστίν	verb	εἰμί
ἔστε	verb	εἰμί
κέρασι	noun	κέρας
εἶπε	verb	εἶπον
βιῶ	verb	βιόω
βιώ	noun	βιός
βίω	noun	βίος
βιοῖς	verb	βιόω
βιοῖ	verb	βιόω
βιοί	noun	βιός
βιοῦ	verb	βιόω
βιούς	noun	βιός
βίον	noun	βίος
βιόν	noun	βιός
γένεα	noun	γένος
δῖον	adjective	δῖος
ἥν	pronoun	ὅς
ἥν	adjective	ὅς
ἐστιν	verb	εἰμί
ἄλλο	adjective	ἄλλος
δία	adjective	δῖος
δίᾳ	adjective	δῖος
ἴδον	verb	εἶδον
ἑ	pronoun	οὗ
λύοις	verb	λῡ́ω
ἔστι	verb	εἰμί
ἐστι	verb	εἰμί
ἐσσι	verb	εἰμί
ἐσσί	verb	εἰμί
ἄλλα	adjective	ἄλλος
γυιόν	adjective	γυιός
γυῖα	noun	γυῖον
γυιά	adjective	γυιός
ἥκιστα	adjective	ἥκιστος
δόμον	noun	δόμος
ἀγνῶτος	adjective	ἀγνώς
ἄγνωτα	adjective	ἄγνωτος
ἀγνῶτα	adjective	ἀγνώς
ἀγνῶτε	adjective	ἀγνώς
ἄγνωτε	adjective	ἄγνωτος
ἀγνώτῳ	adjective	ἄγνωτος
ἀγνώτω	adjective	ἄγνωτος
κρινῶ	verb	κρῑ́νω
μενῶ	verb	μένω
οὕς	pronoun	ὅς
οὕς	adjective	ὅς
ξενῶν	noun	ξένη
θεῖα	adjective	θεῖος
ὀξέϊ	adjective	ὀξύς
ὀξεῖ	adjective	ὀξύς
ἅλα	noun	ἅλς
ἑνί	numeral	εἷς
τελευταία	adjective	τελευταῖος
πόσιν	noun	πόσις
γυναῖκας	noun	γυνή
ἧς	pronoun	ὅς
ἧς	adjective	ὅς
ἀγῶν	noun	ᾰ̓́γος
ὠμῶν	adjective	ὠμός
ἰδέ	verb	ὁράω
ὦμον	noun	ὦμος
ὠμόν	adjective	ὠμός
νῆσοι	noun	νῆσος
ἅς	pronoun	ὅς
ἅς	adjective	ὅς
ἅγια	adjective	ἅγιος
ἀγορᾶς	noun	ᾰ̓γορᾱ́
ἠχοῦς	noun	ἠχώ
ἄνδρε	noun	ᾰ̓νήρ
μῆτερ	noun	μήτηρ
ὅσσα	adjective	ὅσσος
σῷ	adjective	σός
σῷ	adjective	σῶς
ᾖε	verb	εἶμι
λέγομεν	verb	λέγω
ἴχνους	noun	ῐ̓́χνος
ποίει	verb	ποιέω
θές	verb	τῐ́θημῐ
λαβέ	verb	λᾰμβᾰ́νω
βοήθει	verb	βοηθέω
ἕς	verb	ἵημῐ
σκόπει	verb	σκοπέω
βάλλε	verb	βᾰ́λλω
μιᾷ	numeral	εἷς
μιᾷ	verb	μιαίνω
ὀνομαστική	adjective	ὀνομᾰστῐκός
σή	adjective	σός
ἱκανώ	adjective	ἱκανός
ἱκανῷ	adjective	ἱκανός
ἱκανῶ	verb	ἱκανόω
ἥδε	pronoun	ὅδε
ἐθναρχῶν	noun	ἐθνάρχης
ἐθνάρχαι	noun	ἐθνάρχης
ἐθνάρχας	noun	ἐθνάρχης
ἀγορῶν	noun	ᾰ̓γορᾱ́
ἀγοράς	noun	ᾰ̓γορᾱ́
ἆρον	verb	αἴρω
ὑποδήματος	noun	ῠ̔πόδημᾰ
ὑποδήματα	noun	ῠ̔πόδημᾰ
ὑποδημάτων	noun	ῠ̔πόδημᾰ
μνημῶν	noun	μνήμη
τεχνολογιῶν	noun	τεχνολογῐ́ᾱ
πίθων	noun	πῐ́θος
πίθον	noun	πῐ́θος
ποικίλον	adjective	ποικῐ́λος
ποικίλαι	adjective	ποικῐ́λος
γονυπετοῦς	adjective	γονῠπετής
γονυπετῆ	adjective	γονῠπετής
γονυπετεῖς	adjective	γονῠπετής
γονυπετεῖς	verb	γονῠπετῶ
γονυπετῶν	adjective	γονῠπετής
γονυπετεῖ	adjective	γονῠπετής
γονυπετεῖ	verb	γονῠπετῶ
γονυπετῶς	adverb	γονῠπετής
ἐγέρθητι	verb	ἐγείρω
ἐγέρθητε	verb	ἐγείρω
ἐγερθήτω	verb	ἐγείρω
παρακειμένου	noun	πᾰρᾰκείμενος
παρακειμένων	noun	πᾰρᾰκείμενος
παρακειμένους	noun	πᾰρᾰκείμενος
παρακειμένῳ	noun	πᾰρᾰκείμενος
παρακείμενον	noun	πᾰρᾰκείμενος
παρακειμένω	noun	πᾰρᾰκείμενος
παρακειμένοιν	noun	πᾰρᾰκείμενος
παρακειμένοις	noun	πᾰρᾰκείμενος
ἐνίκησα	verb	νικάω
πομφόλυγες	noun	πομφόλῠξ
περιοδικόν	adjective	περῐοδῐκός
περιοδική	adjective	περῐοδῐκός
περιοδικῇ	adjective	περῐοδῐκός
περιοδικῆς	adjective	περῐοδῐκός
περιοδικῶν	adjective	περῐοδῐκός
περιοδικῷ	adjective	περῐοδῐκός
περιοδικοῖν	adjective	περῐοδῐκός
περιοδικαῖν	adjective	περῐοδῐκός
περιοδικοῖς	adjective	περῐοδῐκός
περιοδικαῖς	adjective	περῐοδῐκός
περιοδικώ	adjective	περῐοδῐκός
περιοδικοῦ	adjective	περῐοδῐκός
λύσετε	verb	λῡ́ω
λυθῶ	verb	λῡ́ω
λυθεῖτε	verb	λῡ́ω
ἔλυσα	verb	λῡ́ω
ἔλυσας	verb	λῡ́ω
ἔλυσε	verb	λῡ́ω
ἐλύσατε	verb	λῡ́ω
ἔλυσαν	verb	λῡ́ω
λύσῃ	verb	λῡ́ω
εὐσεβείας	noun	εὐσέβειᾰ
εὐσεβειῶν	noun	εὐσέβειᾰ
ἀσεβείας	noun	ᾰ̓σέβειᾰ
ἀσεβειῶν	noun	ᾰ̓σέβειᾰ
εὐσεβοῦς	adjective	εὐσεβής
εὐσεβεῖ	adjective	εὐσεβής
εὐσεβῆ	adjective	εὐσεβής
εὐσεβές	adjective	εὐσεβής
εὐσεβεῖς	adjective	εὐσεβής
εὐσεβῶν	adjective	εὐσεβής
ἀῶ	verb	ἀάω
ἀάσθω	verb	ἀάω
ἄασας	verb	ἀάω
ἄασαν	verb	ἀάω
ἀάσθης	verb	ἀάω
ἀάσθη	verb	ἀάω
ἀάσθητον	verb	ἀάω
ἀάσθητε	verb	ἀάω
ἀασθῶ	verb	ἀάω
ἀασθῇς	verb	ἀάω
ἀασθῇ	verb	ἀάω
ἀασθῆτον	verb	ἀάω
ἀασθῆτε	verb	ἀάω
ἀάσας	verb	ἀάω
ἀᾶσαν	verb	ᾰ̓ᾱ́σᾱς
ἀγαθοεργεῖ	verb	ἀγαθοεργέω
ἀγαθοέργει	verb	ἀγαθοεργέω
λύετον	verb	
λύητον	verb	λῡ́ω
λύοι	verb	λῡ́ω
λύοιτον	verb	λῡ́ω
λυοίτην	verb	λῡ́ω
λύοιμεν	verb	λῡ́ω
λύοιτε	verb	λῡ́ω
λύοιεν	verb	λῡ́ω
λυέτων	verb	λῡω
ἀγαθοποιεῖ	verb	ἀγαθοποιέω
ἀγαθοποίει	verb	ἀγαθοποιέω
ἔχεις	verb	ἔχω
εἶχες	verb	ἔχω
εἶχε	verb	ἔχω
ἁγίας	adjective	ᾰ̔́γῐος
κοιτίδος	noun	κοιτῐ́ς
κοιτίδες	noun	κοιτῐ́ς
ἐρρίνου	noun	ἔρρῑνον
ἐρρίνων	noun	ἔρρῑνον
ἔρρινα	noun	ἔρρῑνον
ἀγαπῶ	verb	ἀγαπάω
ἀγγελοῦ	verb	ᾰ̓γγέλλω
ἤγειρε	verb	ᾰ̓γείρω
ἤγειρε	verb	ἐγείρω
ἤγειρα	verb	ᾰ̓γείρω
ἤγειρα	verb	ἐγείρω
ἤγειρας	verb	ᾰ̓γείρω
ἤγειρας	verb	ἐγείρω
ἤγειραν	verb	ᾰ̓γείρω
ἤγειραν	verb	ἐγείρω
ἠγειράσθην	verb	ᾰ̓γείρω
ἠγειράσθην	verb	ἐγείρω
ἠγέρθησαν	verb	ᾰ̓γείρω
ἠγέρθησαν	verb	ἐγείρω
ὀφιοειδοῦς	adjective	ὀφῐοειδής
ὀφιοειδῆ	adjective	ὀφῐοειδής
ὀφιοειδές	adjective	ὀφῐοειδής
ὀφιοειδεῖς	adjective	ὀφῐοειδής
ὀφιοειδῶν	adjective	ὀφῐοειδής
λευκοῦ	adjective	λευκός
λευκῷ	adjective	λευκός
λευκώ	adjective	λευκός
λευκόν	adjective	λευκός
λευκῆς	adjective	λευκός
λευκῇ	adjective	λευκός
λευκήν	adjective	λευκός
λευκοῖν	adjective	λευκός
λευκαῖν	adjective	λευκός
λευκῶν	adjective	λευκός
λευκοῖς	adjective	λευκός
λευκαί	adjective	λευκός
λευκαῖς	adjective	λευκός
λευκάς	adjective	λευκός
ἡροδότου	noun	Ἡρόδοτος
ἡρόδοτε	noun	Ἡρόδοτος
σοφοῦ	adjective	σοφός
σοφῷ	adjective	σοφός
σοφώ	adjective	σοφός
σοφῆς	adjective	σοφός
σοφῇ	adjective	σοφός
σοφήν	adjective	σοφός
σοφοῖν	adjective	σοφός
σοφαῖν	adjective	σοφός
σοφῶν	adjective	σοφός
σοφοῖς	adjective	σοφός
σοφούς	adjective	σοφός
σοφαί	adjective	σοφός
σοφαῖς	adjective	σοφός
πόλιος	noun	πόλις
ἀρετῶν	noun	ᾰ̓ρετή
τυράννων	noun	τῠ́ρᾰννος
τυράννων	adjective	τῠ́ρᾰννος
προτέρῳ	adjective	πρότερος
σπεῖρα	noun	σπεῖρον
χειλῶν	noun	χεῖλος
-ποιήσεως	noun	-ποίησις
-ποιήσεις	noun	-ποίησις
-ποιήσεων	noun	-ποίησις
ζώων	noun	ζῶον
φυτικοῦ	adjective	φῠτῐκός
φυτικῷ	adjective	φῠτῐκός
φυτικόν	adjective	φῠτῐκός
φυτική	adjective	φῠτῐκός
φυτικῆς	adjective	φῠτῐκός
φυτικῇ	adjective	φῠτῐκός
φυτικώ	adjective	φῠτῐκός
φυτικοῖν	adjective	φῠτῐκός
φυτικαῖν	adjective	φῠτῐκός
φυτικῶν	adjective	φῠτῐκός
φυτικοῖς	adjective	φῠτῐκός
φυτικαῖς	adjective	φῠτῐκός
εὔχεται	verb	εὔχομαι
κυήματος	noun	κῠ́ημᾰ
κυήματι	noun	κῠ́ημᾰ
κυήματα	noun	κῠ́ημᾰ
κυημάτων	noun	κῠ́ημᾰ
κυήμασι	noun	κῠ́ημᾰ
κυήμασιν	noun	κῠ́ημᾰ
ἀποκυήματος	noun	ᾰ̓ποκῠ́ημᾰ
ἀποκυήματα	noun	ᾰ̓ποκῠ́ημᾰ
ἐξήρθην	verb	ἐξαίρω
ἐξετέλεσα	verb	εκτελέω
ἐξετελέσθην	verb	εκτελέω
ἀποκλείομαι	verb	ᾰ̓ποκλείω
ἀπέκλεισα	verb	ᾰ̓ποκλείω
ἀποκλείεται	verb	ᾰ̓ποκλείω
ἀποκλείετε	verb	ᾰ̓ποκλείω
ἐγκλείομαι	verb	ἐγκλείω
ἐνέκλεισα	verb	ἐγκλείω
ἐμπερικλείομαι	verb	ἐμπερῐκλείω
ἐμπεριέκλεισα	verb	ἐμπερῐκλείω
ἔσεισα	verb	σείω
ἀποσείομαι	verb	ᾰ̓ποσείω
ἀπέσεισα	verb	ᾰ̓ποσείω
ἐπισείομαι	verb	ἐπῐσείω
ἐπέσεισα	verb	ἐπῐσείω
ἔκρουσα	verb	κρούω
ἀνέκρουσα	verb	ἀνακρούω
ἀνακρούομαι	verb	ᾰ̓νᾰκρούω
ἀντικρούομαι	verb	ᾰ̓ντῐκρούω
ἀντέκρουσα	verb	ἀντικρούω
ἀποκρούομαι	verb	ᾰ̓ποκρούω
ἀπέκρουσα	verb	ᾰ̓ποκρούω
ἐκκρούομαι	verb	ἐκκρούω
ἐξέκρουσα	verb	ἐκκρούω
ἑλκύομαι	verb	ἑλκύω
εἵλκυσα	verb	ἕλκω
ἕλκομαι	verb	ἕλκω
εἰσακούομαι	verb	εἰσᾰκούω
ἀνελκύομαι	verb	ἀνελκῠ́ω
ἀπεκλείσθη	verb	ᾰ̓ποκλείω
τειχεσιπλῆτα	noun	τειχεσιπλήτης
ἐνέπνευσα	verb	ἐμπνέω
ἐμπνέομαι	verb	ἐμπνέω
εἰσέπνευσα	verb	εἰσπνέω
εἰσπνέομαι	verb	εἰσπνέω
ἀνέπνευσα	verb	ἀναπνέω
ἀπέπνευσα	verb	ᾰ̓ποπνέω
ἔπνευσα	verb	πνέω
ἀνέπλευσα	verb	ᾰ̓νᾰπλέω
ἐπέπλευσα	verb	ἐπῐπλέω
ἔπλευσα	verb	πλέω
ἔρρευσα	verb	ῥέω
εἰσέρρευσα	verb	εἰσρέω
ἐξέπλευσα	verb	ἐκπλέω
εἰσέπλευσα	verb	εἰσπλέω
ἔκλεισα	verb	κλείω
ἱδρύομαι	verb	ἱδρύω
ἵδρυσα	verb	ῐ̔δρύω
ἀπολύομαι	verb	ᾰ̓πολῡ́ω
ἀπέλυσα	verb	ἀπολῡ́ω
παραβύστω	adjective	πᾰρᾰ́βυστος
παραβύστῳ	adjective	πᾰρᾰ́βυστος
παραβύστοιν	adjective	πᾰρᾰ́βυστος
παραβύστοις	adjective	πᾰρᾰ́βυστος
κωλύομεν	verb	κωλῡ́ω
δῶ	verb	δέω
δῶ	verb	δίδωμι
λάβε	verb	λαμβάνω
προτέρω	adjective	πρότερος
σεῦ	pronoun	σύ
οἷς	pronoun	ὅς
οἷς	determiner	ὅς
ἀνίδρυσα	verb	ᾰ̓νῐδρῡ́ω
ἀνιδρύομαι	verb	ᾰ̓νῐδρῡ́ω
ἐγκαθιδρύομαι	verb	ἐγκᾰθῐδρῡ́ω
ἐγγράφομαι	verb	ἐγγρᾰ́φω
οὖτα	verb	οὐτάω
οὔτα	verb	οὐτάω
οὐτᾷ	verb	οὐτάω
σοφίαιν	noun	σοφῐ́ᾱ
οὐδεμία	pronoun	οὐδείς
οὐδεμιᾷ	pronoun	οὐδείς
ἄρχοντα	noun	ᾰ̓́ρχων
ἀπῆλθον	verb	ᾰ̓πέρχομαι
τινάς	pronoun	τῐς
τῳ	pronoun	τῐς
ἔτει	noun	ἔτος
χίων	adjective	Χῖος
χῖοι	adjective	Χῖος
χῖον	adjective	Χῖος
οἶα	adjective	οἶος
κίον	verb	κίω
οἷα	determiner	οἷος
ἄρχοντες	noun	ᾰ̓́ρχων
ἔφραξα	verb	φρᾰ́σσω
ἀπέσταξα	verb	ᾰ̓ποστάζω
ἔσταξα	verb	στάζω
πάτρια	adjective	πᾰ́τρῐος
ἐᾶν	verb	ἐᾰ́ω
αὑτῷ	pronoun	αὑτοῦ
ἴσαι	adjective	ῐ̓́σος
ἤπια	adjective	ἤπῐος
ἑορτάζομαι	verb	ἑορτᾰ́ζω
ἐξελέγην	verb	ἐκλέγω
ἐκλέγομαι	verb	ἐκλέγω
ἐξέλεξα	verb	ἐκλέγω
ἀναγκάζομαι	verb	ᾰ̓νᾰγκᾰ́ζω
ἐξαναγκάζομαι	verb	ἐξᾰνᾰγκᾰ́ζω
ἐθαύμασα	verb	θαυμᾰ́ζω
νεός	noun	νηῦς
ἀπέδειξα	verb	ᾰ̓ποδείκνῡμῐ
ἀπέδειξα	verb	ᾰ̓ποδεικνῠ́ω
ἀπεδείχθη	verb	ἀποδείκνῡμῐ
ἀποδείξεις	noun	ᾰ̓πόδειξῐς
ἀποδείξεις	verb	ᾰ̓ποδείκνῡμι
ἀποδείξεις	verb	ᾰ̓ποδεικνῠ́ω
ἀπεδείχθησαν	verb	ἀποδείκνῡμῐ
ἀπέδειξε	verb	ἀποδείκνῡμι
ἀπέδειξε	verb	ἀποδεικνῠ́ω
θοάς	adjective	θοός
ζωόν	adjective	ζωός
υἷος	noun	υἱός
ἰῷ	noun	ῑ̓ός
ἰῷ	adjective	ῐ̓ός
πατρία	adjective	πᾰ́τρῐος
γεωγραφικόν	adjective	γεωγρᾰφῐκός
υἷε	noun	υἱός
οἴω	adjective	οἶος
οἴῳ	adjective	οἶος
σῇ	adjective	σός
ζωῷ	adjective	ζωός
ζῴῳ	noun	ζῷον
ζώῳ	noun	ζῶον
ἔπεμψα	verb	πέμπω
ἔτερψα	verb	τέρπω
δόμων	noun	δόμος
ἀπέπεμψα	verb	ᾰ̓ποπέμπω
ἀποπέμπομαι	verb	ᾰ̓ποπέμπω
ἔδρεψα	verb	δρέπω
ἔλειψα	verb	λείπω
ἐκλείψεις	noun	ἔκλειψῐς
ἐκλείψεις	verb	ἐκλείπω
ἔτρεψα	verb	τρέπω
ἐτράπην	verb	τρέπω
ἀνέτρεψα	verb	ᾰ̓νᾰτρέπω
ἀνατρέπομαι	verb	ᾰ̓νᾰτρέπω
ἀνετράπην	verb	ᾰ̓νᾰτρέπω
ἀπέτρεψα	verb	ᾰ̓ποτρέπω
ἀποτρέπομαι	verb	ᾰ̓ποτρέπω
ἀπετράπην	verb	ᾰ̓ποτρέπω
ἐπέτρεψα	verb	ἐπῐτρέπω
ἐπιτρέπομαι	verb	ἐπῐτρέπω
ἐπετράπην	verb	ἐπῐτρέπω
ἐπιτρέπετε	verb	ἐπῐτρέπω
ἐπιτρέπεται	verb	ἐπῐτρέπω
ἐξέτρεψα	verb	ἐκτρέπω
ἐκτρέπομαι	verb	ἐκτρέπω
ἐξετράπην	verb	ἐκτρέπω
ἐφάπτομαι	verb	ἐφᾰ́πτω
ἠελίοιο	noun	Ἠέλῐος
ἀνέκαμψα	verb	ᾰ̓νᾰκάμπτω
ἐνέσκηψα	verb	ἐνσκήπτω
πολέων	adjective	πολύς
μέσῳ	adjective	μέσος
κρατός	noun	κάρη
ὑπέκρυψα	verb	ῠ̔ποκρύπτω
ἀνεκάλυψα	verb	ᾰ̓νᾰκᾰλῠ́πτω
ἀνακαλύπτομαι	verb	ᾰ̓νᾰκᾰλῠ́πτω
ἀνεκαλύφθην	verb	ᾰ̓νᾰκᾰλῠ́πτω
ἀνακαλύψεις	noun	ᾰ̓νᾰκᾰ́λῠψῐς
ἀνακαλύψεις	verb	ᾰ̓νᾰκᾰλῠ́πτω
ἀπέκρυψα	verb	ᾰ̓ποκρῠ́πτω
βλάπτει	verb	βλάπτω
βλάπτῃ	verb	βλάπτω
ἔκαμψα	verb	κάμπτω
ἀπεκάλυψα	verb	ᾰ̓ποκᾰλῠ́πτω
ἀποκαλύπτομαι	verb	ᾰ̓ποκᾰλῠ́πτω
ἀπεκαλύφθην	verb	ᾰ̓ποκᾰλῠ́πτω
ἀποκαλύψεις	noun	ᾰ̓ποκᾰ́λῠψῐς
ἀποκαλύψεις	verb	ᾰ̓ποκᾰλῠ́πτω
ἀπέρριψα	verb	ᾰπορρῐ́πτω
ἀπορρίπτομαι	verb	ᾰπορρῐ́πτω
ἀπερρίφθην	verb	ᾰπορρῐ́πτω
ἀπορρίψεις	noun	ἀπόρρῐψῐς
ἀπορρίψεις	verb	ἀπορρῐ́πτω
ἐκκολάψεις	noun	ἐκκόλαψῐς
ἐκκολάψεις	verb	ἐκκολᾰ́πτω
ἀνεσκάφην	verb	ᾰ̓νᾰσκᾰ́πτω
ἀνέσκαψα	verb	ᾰ̓νᾰσκᾰ́πτω
ἀνασκάπτομαι	verb	ᾰ̓νᾰσκᾰ́πτω
ἀνέκοψα	verb	ᾰ̓νᾰκόπτω
ἀνακόπτομαι	verb	ᾰ̓νᾰκόπτω
ἀνεκόπην	verb	ᾰ̓νᾰκόπτω
ἀπέκοψα	verb	ᾰ̓ποκόπτω
ἀποκόπτομαι	verb	ᾰ̓ποκόπτω
ἀπεκόπην	verb	ᾰ̓ποκόπτω
ἀγόν	noun	ἀγός
ἔγχει	noun	ἔγχος
θινός	noun	Θῖνα
ἀνανήψεις	noun	ᾰ̓νᾰνηψῐς
ἀνανήψεις	verb	ᾰ̓νᾰνήφω
ἔστεψα	verb	στέφω
ἐστέφθην	verb	στέφω
συγγραφεῖς	noun	σῠγγρᾰφεύς
ἀναγράφομαι	verb	ᾰ̓νᾰγρᾰ́φω
ἀνέγραψα	verb	ᾰ̓νᾰγρᾰ́φω
ἀνεγράφην	verb	ᾰ̓νᾰγρᾰ́φω
καταγραφεῖς	noun	κᾰτᾰγρᾰφεύς
λιπῶν	noun	λῐ́πος
ὑπογράφομαι	verb	ῠ̔πογρᾰ́φω
ὑπογράφεις	verb	ῠ̔πογρᾰ́φω
ὑπογραφεῖς	noun	ῠ̔πογρᾰφεύς
ὑπογράφει	verb	ῠ̔πογρᾰ́φω
ἀναστρέφομαι	verb	ᾰ̓νᾰστρέφω
ἐπιστρέφομαι	verb	ἐπῐστρέφω
ἐπέστρεψα	verb	ἐπῐστρέφω
ἔστρεψα	verb	στρέφω
συγγραφεῖ	noun	σῠγγρᾰφεύς
συγγράφεις	verb	σῠγγρᾰ́φω
συγγραφῆς	noun	σῠγγρᾰφεύς
συγγραφῆς	noun	σῠγγρᾰφή
συγγραφῆς	verb	σῠγγρᾰ́φω
συγγράφῃς	verb	σῠγγρᾰ́φω
συγγραφῇς	verb	σῠγγρᾰ́φω
συγγράφει	verb	σῠγγρᾰ́φω
συγγράφῃ	verb	σῠγγρᾰ́φω
συγγραφῇ	noun	σῠγγρᾰφή
συγγραφῇ	verb	σῠγγρᾰ́φω
συγγραφῆ	noun	σῠγγρᾰφεύς
ἀπείρων	adjective	ἄπειρος
ἀπείρων	noun	ἄπειρος
τιτᾶνες	noun	Τῑτᾱ́ν
τιτάνων	noun	Τῑτᾱ́ν
τιτᾶνα	noun	Τῑτᾱ́ν
δαίμονι	noun	δαίμων
χῖε	adjective	Χῖος
ψῆφε	noun	ψῆφος
ψῆφοι	noun	ψῆφος
παρέγραψα	verb	πᾰρᾰγρᾰ́φω
ἔκλεψα	verb	κλέπτω
ἐκλάπην	verb	κλέπτω
ἐτάφην	verb	θᾰ́πτω
ἔρραψα	verb	ῥᾰ́πτω
ἐνδιέτριψα	verb	ἐνδῐᾰτρῑ́βω
ἀνετράπη	verb	ᾰ̓νᾰτρέπω
ἀνετράπησαν	verb	ᾰ̓νᾰτρέπω
ἀπετράπη	verb	ᾰ̓ποτρέπω
ἀπετράπησαν	verb	ᾰ̓ποτρέπω
ἐπετράπη	verb	ἐπῐτρέπω
ἐπετράπησαν	verb	ἐπῐτρέπω
ἐνεγράφη	verb	ἐγγρᾰ́φω
ἐνεγράφησαν	verb	ἐγγρᾰ́φω
σῆς	adjective	σός
ἀναδείξεις	noun	ᾰ̓νᾰ́δειξῐς
ἀναδείξεις	verb	ᾰ̓νᾰδείκνῡμῐ
ἀναδείξεις	verb	ᾰ̓νᾰδεικνῠ́ω
πλαγίασα	verb	πλᾰγιάζω
ἱκέτευσα	verb	ῐ̔κετεύω
ἐπιγράφομαι	verb	ἐπῐγρᾰ́φω
ἐπέγραψα	verb	ἐπῐγρᾰ́φω
ἐπαρχίας	noun	ἐπᾰρχῐ́ᾱ
ἐπαρχιῶν	noun	ἐπᾰρχῐ́ᾱ
ἔφθασα	verb	φθᾱ́νω
χορεύομεν	verb	χορεύω
ἐκινδύνευσα	verb	κῐνδῡνεύω
ἐκινδύνευσε	verb	κῐνδῡνεύω
ἐκινδύνευε	verb	κῐνδῡνεύω
ἐκινδύνευεν	verb	κῐνδῡνεύω
μύλαι	noun	μύλη
ποταμῶν	noun	ποτᾰμός
δοῦλοι	adjective	δοῦλος
δοῦλοι	noun	δοῦλος
ἰσχυροί	adjective	ἰσχῡρός
ἀγγεῖα	noun	ἀγγεῖον
μαντεῖα	noun	μαντεῖον
πιστεύομεν	verb	πιστεύω
μναῖ	noun	μνᾶ
ἐπροφήτευσα	verb	προφητεύω
στερήσεις	noun	στέρησῐς
στερήσεις	verb	στερέω
στεροῦμεν	verb	στερῶ
ὑστέρησα	verb	ῠ̔στερέω
ὑστερῶ	verb	ῠ̔στερέω
οἶκοι	noun	οἶκος
βάλλετε	verb	βᾰ́λλω
ἔβαλλον	verb	βᾰ́λλω
ἔβαλεν	verb	βᾰ́λλω
βάλλεται	verb	βᾰ́λλω
παρέβαλλον	verb	πᾰρᾰβᾰ́λλω
παραβάλλεται	verb	πᾰρᾰβᾰ́λλω
ἁλί	noun	ἅλς
ἀποβάλλομαι	verb	ᾰ̓ποβᾰ́λλω
ἀποβάλω	verb	ᾰ̓ποβᾰ́λλω
ἀπέβαλον	verb	ᾰ̓ποβᾰ́λλω
ἀπέβαλλον	verb	ᾰ̓ποβᾰ́λλω
ἀποβάλλετε	verb	ᾰ̓ποβᾰ́λλω
ἀποβάλετε	verb	ᾰ̓ποβᾰ́λλω
ἀπόβαλλε	verb	ᾰ̓ποβᾰ́λλω
ἀπόβαλε	verb	ᾰ̓ποβᾰ́λλω
καταβάλω	verb	κᾰτᾰβᾰ́λλω
κατέβαλον	verb	κᾰτᾰβᾰ́λλω
κατέβαλλον	verb	κᾰτᾰβᾰ́λλω
καταβάλλετε	verb	κᾰτᾰβᾰ́λλω
καταβάλετε	verb	κᾰτᾰβᾰ́λλω
κατάβαλλε	verb	κᾰτᾰβᾰ́λλω
κατάβαλε	verb	κᾰτᾰβᾰ́λλω
κατέβαλε	verb	κᾰτᾰβᾰ́λλω
κατέβαλεν	verb	κᾰτᾰβᾰ́λλω
κατέβαλλεν	verb	κᾰτᾰβᾰ́λλω
κατέβαλλε	verb	κᾰτᾰβᾰ́λλω
ἠῶ	noun	ἠώς
ἔτεινα	verb	τείνω
τείνομεν	verb	τείνω
ἀνέτεινα	verb	ᾰ̓νᾰτείνω
ἀνατείνομαι	verb	ᾰ̓νᾰτείνω
ἀνατείνομεν	verb	ᾰ̓νᾰτείνω
κρίνομεν	verb	κρῑ́νω
ἔκρινα	verb	κρῑ́νω
ἀνέκρινα	verb	ᾰ̓νᾰκρῑ́νω
ἀνακρίνομαι	verb	ᾰ̓νᾰκρῑ́νω
ἀνακρίνομεν	verb	ᾰ̓νᾰκρῑ́νω
ἀπέκρινα	verb	ἀποκρῑ́νω
ἔκλινα	verb	κλῑ́νω
μεταφέρομεν	verb	μετᾰφέρω
ἐμπόρια	noun	ἐμπόρῐον
ἔπαυσα	verb	παύω
δῆλοι	adjective	δῆλος
συνάπτομεν	verb	σῠνᾰ́πτω
συνῆψα	verb	σῠνᾰ́πτω
ξένια	adjective	ξένῐος
ξένια	noun	ξένῐον
ἐπισυνάπτομαι	verb	ἐπῐσῠνᾰ́πτω
ἐπισυνάπτομεν	verb	ἐπῐσῠνᾰ́πτω
ἐπισυνήφθην	verb	ἐπῐσῠνᾰ́πτω
ἐπισυνήφθη	verb	ἐπῐσῠνᾰ́πτω
ἐπισυνήφθησαν	verb	ἐπῐσῠνᾰ́πτω
ἐπισυνῆψα	verb	ἐπῐσῠνᾰ́πτω
περιπλέκομεν	verb	περῐπλέκω
ἐγείρομαι	verb	ἐγείρω
ἐγείρομεν	verb	ἐγείρω
παλαιᾶς	adjective	πᾰλαιός
ἔξυσα	verb	ξῡ́ω
ἐκλήθην	verb	καλέω
ἐκλήθη	verb	καλέω
ἐκλήθησαν	verb	καλέω
μετρίᾳ	adjective	μέτρῐος
μετρία	adjective	μέτρῐος
κοσμοπολίτῃ	noun	κοσμοπολῑ́της
κοσμοπολίτα	noun	κοσμοπολίτᾱς
κοσμοπολίτᾳ	noun	κοσμοπολῑ́τᾱς
κοσμοπολίταν	noun	κοσμοπολῑ́τᾱς
κοσμοπολιτᾶν	noun	κοσμοπολῑ́τᾱς
κοσμοπολιτῶν	noun	κοσμοπολῑ́της
κοσμοπολῖτα	noun	κοσμοπολῑ́της
ἄρχε	verb	ἄρχω
ἀρχέ	noun	ἀρχός
ἕκτα	adjective	ἕκτος
ἐφημερίδα	noun	ἐφημερῐ́ς
ἐφημερίδες	noun	ἐφημερῐ́ς
ἐφημερίδας	noun	ἐφημερῐ́ς
ἐφημερίδων	noun	ἐφημερῐ́ς
ἠρώτησα	verb	ἐρωτᾰ́ω
ἐρωτῶμαι	verb	ἐρωτῶ
ἐρωτῶ	verb	ἐρωτᾰ́ω
τέκον	verb	τίκτω
νεῦρα	noun	νεῦρον
δημῷ	noun	δημός
ὑποδεέστερα	adjective	ὑποδεέστερος
ὑποδεεστέρα	adjective	ὑποδεέστερος
διπλασία	adjective	διπλάσῐος
φανερᾶς	adjective	φᾰνερός
φανεράς	adjective	φᾰνερός
ἐνδεεστέρα	adjective	ἐνδεέστερος
ἐνδεέστερα	adjective	ἐνδεέστερος
ἐνδεεστέρᾳ	adjective	ἐνδεέστερος
δοιῷ	adjective	δοιός
δοιώ	adjective	δοιός
αὐτώ	pronoun	αὐτός
χρονίᾳ	adjective	χρόνῐος
χρονία	adjective	χρόνῐος
ἔρυσσαν	verb	ἐρύω
ἴωνας	noun	Ἴων
βασίλειαι	adjective	βασίλειος
βασιλεῖαι	noun	βασιλείᾱ
οἴκων	noun	οἶκος
ζῴων	noun	ζῷον
ἀλφάβητον	noun	ἀλφάβητος
ἀλφαβήτου	noun	ἀλφάβητος
ἀλφαβήτου	noun	ἀλφάβητον
ἀλφαβήτων	noun	ἀλφάβητος
ἀλφαβήτων	noun	ἀλφάβητον
ἀλφάβητα	noun	ἀλφάβητον
ἀλφάβητοι	noun	ἀλφάβητος
ἀλφαβήτους	noun	ἀλφάβητος
ὕστερα	adjective	ῠ̔́στερος
τελευταῖα	adjective	τελευταῖος
μεταμωνία	adjective	μεταμώνιος
μεταμώνια	adjective	μεταμώνιος
ἀτολμοτέρα	adjective	ἀτολμότερος
ἀτολμότερα	adjective	ἀτολμότερος
ἔτεϊ	noun	ἔτος
καθίστασαν	verb	καθίστημι
γνωτόν	adjective	γνωτός
γνωτόν	noun	γνωτός
διαφανῶν	adjective	δῐᾰφᾰνής
ὅμοιον	adjective	ὅμοιος
ὁμοῖον	adjective	ὁμοῖος
πολεμία	adjective	πολέμιος
πολέμια	adjective	πολέμιος
ἀποφάσεως	noun	ἀπόφασις#Etymology_1
ἀποφάσεως	noun	ἀπόφασις#Etymology_2
ἔπεϊ	noun	ἔπος
ἔπει	noun	ἔπος
ψαλμοί	noun	ψᾰλμός
δόμοι	noun	δόμος
δόμῳ	noun	δόμος
καλοῦ	adjective	κᾱλός
καλοῦ	adjective	κᾰλός
καλῷ	adjective	κᾱλός
καλῷ	adjective	κᾰλός
κατάλογον	noun	κᾰτᾰ́λογος
γνώσει	noun	γνῶσῐς
γνῶσι	noun	γνῶσῐς
ἐφελκύσει	noun	ἐφέλκῠσῐς
ἐφελκύσι	noun	ἐφέλκῠσῐς
ἐφέλκυσι	noun	ἐφέλκῠσῐς
ἐφελκύσεις	noun	ἐφέλκῠσῐς
ἐφελκύσις	noun	ἐφέλκῠσῐς
εἶδες	verb	ὁράω
ἀρχαία	adjective	ἀρχαῖος
ἀρχαῖα	adjective	ἀρχαῖος
ἴω	noun	ἴον
ὁδηγοῦ	noun	ὁδηγός
ὁδηγοί	noun	ὁδηγός
ὁδηγῷ	noun	ὁδηγός
ὁδηγόν	noun	ὁδηγός
ὁδηγῶν	noun	ὁδηγός
ὁδηγούς	noun	ὁδηγός
ὁδηγέ	noun	ὁδηγός
συγκλήτῳ	adjective	σῠ́γκλητος
συγκλήτῳ	noun	σῠ́γκλητος
σύγκλητον	adjective	σῠ́γκλητος
σύγκλητον	noun	σῠ́γκλητος
συγκλήτων	adjective	σῠ́γκλητος
συγκλήτων	noun	σῠ́γκλητος
συγκαλῶ	verb	σῠγκᾰλέω
συγκαλοῦμαι	verb	σῠγκᾰλέω
συγκλητικοῦ	adjective	σῠγκλητῐκός
συγκλητικοῦ	noun	σῠγκλητῐκός
συγκλητική	adjective	σῠγκλητῐκός
συγκλητικῷ	adjective	σῠγκλητῐκός
συγκλητικῷ	noun	σῠγκλητῐκός
συγκλητικόν	adjective	σῠγκλητῐκός
συγκλητικόν	noun	σῠγκλητῐκός
συγκλητικοί	adjective	σῠγκλητῐκός
συγκλητικοί	noun	σῠγκλητῐκός
συγκλητικέ	adjective	σῠγκλητῐκός
συγκλητικέ	noun	σῠγκλητῐκός
συγκλητικῆς	adjective	σῠγκλητῐκός
συγκλητικῶν	adjective	σῠγκλητῐκός
συγκλητικῶν	noun	σῠγκλητῐκός
συγκλητικοῖς	adjective	σῠγκλητῐκός
συγκλητικοῖς	noun	σῠγκλητῐκός
συγκλητικαί	adjective	σῠγκλητῐκός
συγκλητικαῖς	adjective	σῠγκλητῐκός
συγκλητικῇ	adjective	σῠγκλητῐκός
